PLAYER_ID,PLAYER_NAME,TEAM_ID,TEAM_ABBREVIATION,GP,W,L,MIN,OREB,OREB_CONTEST,OREB_UNCONTEST,OREB_CONTEST_PCT,OREB_CHANCES,OREB_CHANCE_PCT,OREB_CHANCE_DEFER,OREB_CHANCE_PCT_ADJ,AVG_OREB_DIST,DREB,DREB_CONTEST,DREB_UNCONTEST,DREB_CONTEST_PCT,DREB_CHANCES,DREB_CHANCE_PCT,DREB_CHANCE_DEFER,DREB_CHANCE_PCT_ADJ,AVG_DREB_DIST,REB,REB_CONTEST,REB_UNCONTEST,REB_CONTEST_PCT,REB_CHANCES,REB_CHANCE_PCT,REB_CHANCE_DEFER,REB_CHANCE_PCT_ADJ,AVG_REB_DIST,Year,Season_type
201985,AJ Price,1610612750,MIN,8,6,2,50.0,1,0,1,0.0,5,0.2,0,0.2,27.2,9,1,9,0.111,11,0.818,0,0.818,12.9,10,1,10,0.1,16,0.625,0,0.625,14.2,2013-14,Regular%20Season
201166,Aaron Brooks,1610612743,DEN,56,30,26,1390.0,43,14,29,0.326,130,0.331,8,0.352,13.1,97,14,87,0.144,233,0.416,24,0.464,11.2,140,28,116,0.2,363,0.386,32,0.423,11.8,2013-14,Regular%20Season
201189,Aaron Gray,1610612758,SAC,31,10,21,335.0,41,27,13,0.659,97,0.423,5,0.446,5.0,68,24,44,0.353,120,0.567,13,0.636,5.2,109,51,57,0.468,217,0.502,18,0.548,5.2,2013-14,Regular%20Season
203519,Adonis Thomas,1610612755,PHI,2,1,1,18.0,0,0,0,0.0,1,0.0,0,0.0,0.0,3,0,3,0.0,3,1.0,0,1.0,10.7,3,0,3,0.0,4,0.75,0,0.75,10.7,2013-14,Regular%20Season
1733,Al Harrington,1610612764,WAS,29,18,11,459.0,15,8,6,0.533,49,0.306,6,0.349,7.3,63,15,48,0.238,115,0.548,10,0.6,7.3,78,23,54,0.295,164,0.476,16,0.527,7.3,2013-14,Regular%20Season
201143,Al Horford,1610612737,ATL,29,16,13,958.0,66,35,29,0.53,132,0.5,5,0.52,7.5,178,66,105,0.371,301,0.591,24,0.643,6.1,244,101,134,0.414,433,0.564,29,0.604,6.5,2013-14,Regular%20Season
2744,Al Jefferson,1610612766,CHA,72,37,35,2517.0,156,88,68,0.564,341,0.457,4,0.463,7.9,626,204,420,0.326,996,0.629,82,0.685,4.2,782,292,488,0.373,1337,0.585,86,0.625,4.9,2013-14,Regular%20Season
202329,Al-Farouq Aminu,1610612740,NOP,78,33,45,2010.0,129,70,55,0.543,314,0.411,15,0.431,7.1,367,106,254,0.289,587,0.625,40,0.671,6.1,496,176,309,0.355,901,0.55,55,0.586,6.4,2013-14,Regular%20Season
101187,Alan Anderson,1610612751,BKN,65,35,30,1581.0,40,18,19,0.45,131,0.305,3,0.313,10.6,134,30,101,0.224,278,0.482,29,0.538,8.7,174,48,120,0.276,409,0.425,32,0.462,9.2,2013-14,Regular%20Season
202692,Alec Burks,1610612762,UTA,75,23,52,2127.0,59,34,24,0.576,228,0.259,10,0.271,11.1,198,45,156,0.227,384,0.516,25,0.552,7.2,257,79,180,0.307,612,0.42,35,0.445,8.0,2013-14,Regular%20Season
203458,Alex Len,1610612756,PHX,34,22,12,339.0,39,25,12,0.641,93,0.419,3,0.433,5.3,60,26,34,0.433,121,0.496,5,0.517,3.8,99,51,46,0.515,214,0.463,8,0.481,4.4,2013-14,Regular%20Season
203144,Alexey Shved,1610612750,MIN,42,21,21,546.0,21,9,12,0.429,69,0.304,2,0.313,8.9,60,16,45,0.267,90,0.667,10,0.75,8.5,81,25,57,0.309,159,0.509,12,0.551,8.6,2013-14,Regular%20Season
201582,Alexis Ajinca,1610612740,NOP,54,21,33,944.0,94,60,35,0.638,231,0.407,5,0.416,6.3,183,59,124,0.322,302,0.606,33,0.68,4.3,277,119,159,0.43,533,0.52,38,0.56,5.0,2013-14,Regular%20Season
203459,Allen Crabbe,1610612757,POR,4,2,2,52.0,1,0,1,0.0,5,0.2,0,0.2,6.8,8,1,7,0.125,10,0.8,0,0.8,6.5,9,1,8,0.111,15,0.6,0,0.6,6.5,2013-14,Regular%20Season
202087,Alonzo Gee,1610612739,CLE,52,23,29,897.0,35,15,21,0.429,110,0.318,4,0.33,9.4,114,18,95,0.158,198,0.576,15,0.623,8.1,149,33,116,0.221,308,0.484,19,0.516,8.4,2013-14,Regular%20Season
2405,Amar'e Stoudemire,1610612752,NYK,65,26,39,1466.0,112,71,37,0.634,299,0.375,12,0.39,6.6,208,93,116,0.447,425,0.489,36,0.535,4.5,320,164,153,0.513,724,0.442,48,0.473,5.2,2013-14,Regular%20Season
101161,Amir Johnson,1610612761,TOR,76,42,34,2181.0,167,122,37,0.731,463,0.361,19,0.376,5.0,330,137,188,0.415,689,0.479,67,0.531,4.9,497,259,225,0.521,1152,0.431,86,0.466,5.0,2013-14,Regular%20Season
2760,Anderson Varejao,1610612739,CLE,65,25,40,1800.0,187,110,73,0.588,483,0.387,5,0.391,6.7,442,152,285,0.344,754,0.586,70,0.646,4.3,629,262,358,0.417,1237,0.508,75,0.541,5.0,2013-14,Regular%20Season
101154,Andray Blatche,1610612751,BKN,71,39,32,1575.0,114,75,39,0.658,248,0.46,6,0.471,6.8,262,108,146,0.412,463,0.566,54,0.641,4.8,376,183,185,0.487,711,0.529,60,0.578,5.4,2013-14,Regular%20Season
203083,Andre Drummond,1610612765,DET,81,29,52,2619.0,440,315,106,0.716,805,0.547,19,0.56,4.7,631,207,418,0.328,953,0.662,68,0.713,4.0,1071,522,524,0.487,1758,0.609,87,0.641,4.3,2013-14,Regular%20Season
2738,Andre Iguodala,1610612744,GSW,62,40,22,2022.0,53,21,31,0.396,158,0.335,4,0.344,11.2,240,35,201,0.146,420,0.571,39,0.63,8.6,293,56,232,0.191,578,0.507,43,0.548,9.0,2013-14,Regular%20Season
1889,Andre Miller,1610612764,WAS,52,30,22,906.0,28,16,12,0.571,109,0.257,6,0.272,11.7,101,14,87,0.139,190,0.532,18,0.587,8.6,129,30,99,0.233,299,0.431,24,0.469,9.2,2013-14,Regular%20Season
203460,Andre Roberson,1610612760,OKC,31,22,9,369.0,36,17,17,0.472,82,0.439,4,0.462,7.0,58,12,46,0.207,106,0.547,9,0.598,6.1,94,29,63,0.309,188,0.5,13,0.537,6.5,2013-14,Regular%20Season
200745,Andrea Bargnani,1610612752,NYK,42,15,27,1257.0,69,34,34,0.493,171,0.404,7,0.421,9.3,153,51,103,0.333,307,0.498,33,0.558,5.4,222,85,137,0.383,478,0.464,40,0.507,6.6,2013-14,Regular%20Season
1905,Andrei Kirilenko,1610612751,BKN,43,28,15,829.0,53,27,26,0.509,154,0.344,7,0.361,7.8,89,15,72,0.169,150,0.593,13,0.65,6.6,142,42,98,0.296,304,0.467,20,0.5,7.1,2013-14,Regular%20Season
101106,Andrew Bogut,1610612744,GSW,66,39,27,1745.0,180,120,60,0.667,364,0.495,7,0.504,5.3,479,196,278,0.409,802,0.597,58,0.644,3.9,659,316,338,0.48,1166,0.565,65,0.599,4.3,2013-14,Regular%20Season
101115,Andrew Bynum,1610612754,IND,26,11,15,516.0,53,42,10,0.792,104,0.51,1,0.515,4.9,92,45,47,0.489,162,0.568,12,0.613,4.5,145,87,57,0.6,266,0.545,13,0.573,4.6,2013-14,Regular%20Season
203094,Andrew Nicholson,1610612753,ORL,66,18,48,1109.0,53,31,23,0.585,116,0.457,3,0.469,7.8,202,83,119,0.411,392,0.515,48,0.587,5.1,255,114,142,0.447,508,0.502,51,0.558,5.6,2013-14,Regular%20Season
2740,Andris Biedrins,1610612762,UTA,5,0,5,40.0,2,1,1,0.5,8,0.25,1,0.286,7.3,15,3,12,0.2,22,0.682,0,0.682,3.7,17,4,13,0.235,30,0.567,1,0.586,4.1,2013-14,Regular%20Season
1712,Antawn Jamison,1610612746,LAC,20,13,7,231.0,9,7,2,0.778,31,0.29,1,0.3,4.8,46,16,29,0.348,85,0.541,3,0.561,5.5,55,23,31,0.418,116,0.474,4,0.491,5.4,2013-14,Regular%20Season
203461,Anthony Bennett,1610612739,CLE,43,16,27,602.0,49,27,20,0.551,129,0.38,4,0.392,8.0,106,36,70,0.34,198,0.535,10,0.564,5.7,155,63,90,0.406,327,0.474,14,0.495,6.4,2013-14,Regular%20Season
203076,Anthony Davis,1610612740,NOP,66,28,38,2354.0,207,128,77,0.618,415,0.499,5,0.505,6.2,466,171,296,0.367,691,0.674,50,0.727,5.0,673,299,373,0.444,1106,0.608,55,0.64,5.4,2013-14,Regular%20Season
201627,Anthony Morrow,1610612740,NOP,62,23,39,1221.0,29,11,18,0.379,89,0.326,7,0.354,11.8,111,30,81,0.27,201,0.552,15,0.597,9.3,140,41,99,0.293,290,0.483,22,0.522,9.8,2013-14,Regular%20Season
201576,Anthony Randolph,1610612743,DEN,36,12,24,499.0,19,13,5,0.684,61,0.311,2,0.322,5.4,102,27,76,0.265,166,0.614,12,0.662,5.6,121,40,81,0.331,227,0.533,14,0.568,5.6,2013-14,Regular%20Season
201229,Anthony Tolliver,1610612766,CHA,56,30,26,1191.0,33,7,22,0.212,80,0.413,2,0.423,12.8,134,36,99,0.269,255,0.525,27,0.588,7.4,167,43,121,0.257,335,0.499,29,0.546,8.4,2013-14,Regular%20Season
203462,Archie Goodwin,1610612756,PHX,38,22,16,479.0,24,14,11,0.583,77,0.312,5,0.333,8.9,62,13,49,0.21,113,0.549,10,0.602,7.1,86,27,60,0.314,190,0.453,15,0.491,7.6,2013-14,Regular%20Season
202620,Arinze Onuaku,1610612739,CLE,3,0,3,29.0,2,2,0,1.0,4,0.5,0,0.5,4.9,6,1,5,0.167,8,0.75,1,0.857,5.3,8,3,5,0.375,12,0.667,1,0.727,5.2,2013-14,Regular%20Season
203102,Arnett Moultrie,1610612755,PHI,10,0,10,164.0,11,4,7,0.364,32,0.344,2,0.367,8.0,24,7,17,0.292,45,0.533,4,0.585,5.3,35,11,24,0.314,77,0.455,6,0.493,6.1,2013-14,Regular%20Season
203382,Aron Baynes,1610612759,SAS,41,29,12,436.0,57,38,18,0.667,134,0.425,1,0.429,5.4,88,40,47,0.455,126,0.698,9,0.752,5.0,145,78,65,0.538,260,0.558,10,0.58,5.2,2013-14,Regular%20Season
201167,Arron Afflalo,1610612753,ORL,71,20,51,2495.0,32,11,24,0.344,188,0.17,4,0.174,13.4,230,27,203,0.117,432,0.532,37,0.582,8.7,262,38,227,0.145,620,0.423,41,0.453,9.3,2013-14,Regular%20Season
201948,Austin Daye,1610612759,SAS,14,9,5,133.0,5,3,2,0.6,11,0.455,0,0.455,3.2,22,10,13,0.455,36,0.611,3,0.667,6.0,27,13,15,0.481,47,0.574,3,0.614,5.5,2013-14,Regular%20Season
203085,Austin Rivers,1610612740,NOP,53,21,32,1135.0,26,10,16,0.385,104,0.25,3,0.257,11.8,103,19,84,0.184,236,0.436,26,0.49,8.0,129,29,100,0.225,340,0.379,29,0.415,8.8,2013-14,Regular%20Season
202340,Avery Bradley,1610612738,BOS,57,18,39,1775.0,48,20,29,0.417,168,0.286,5,0.294,9.3,178,33,148,0.185,345,0.516,35,0.574,7.2,226,53,177,0.235,513,0.441,40,0.478,7.6,2013-14,Regular%20Season
2732,Ben Gordon,1610612766,CHA,16,8,8,253.0,3,2,2,0.667,24,0.125,0,0.125,13.6,24,6,18,0.25,47,0.511,4,0.558,8.6,27,8,20,0.296,71,0.38,4,0.403,9.3,2013-14,Regular%20Season
203463,Ben McLemore,1610612758,SAC,73,25,48,2017.0,53,13,40,0.245,179,0.296,9,0.312,14.3,182,28,152,0.154,434,0.419,60,0.487,8.6,235,41,192,0.174,613,0.383,69,0.432,9.9,2013-14,Regular%20Season
2757,Beno Udrih,1610612763,MEM,25,9,16,534.0,10,3,8,0.3,37,0.27,6,0.323,16.6,49,9,40,0.184,97,0.505,6,0.538,10.4,59,12,48,0.203,134,0.44,12,0.484,11.4,2013-14,Regular%20Season
203108,Bernard James,1610612742,DAL,18,9,9,114.0,15,13,2,0.867,34,0.441,0,0.441,5.4,27,15,12,0.556,49,0.551,1,0.563,3.4,42,28,14,0.667,83,0.506,1,0.512,4.1,2013-14,Regular%20Season
202687,Bismack Biyombo,1610612766,CHA,73,38,35,1032.0,103,71,30,0.689,282,0.365,5,0.372,5.8,260,100,157,0.385,459,0.566,43,0.625,4.6,363,171,187,0.471,741,0.49,48,0.524,4.9,2013-14,Regular%20Season
201933,Blake Griffin,1610612746,LAC,80,56,24,2863.0,192,120,64,0.625,510,0.376,23,0.394,6.6,565,204,357,0.361,964,0.586,75,0.636,4.9,757,324,421,0.428,1474,0.514,98,0.55,5.3,2013-14,Regular%20Season
2564,Boris Diaw,1610612759,SAS,77,58,19,1936.0,73,44,28,0.603,222,0.329,10,0.344,7.6,252,86,166,0.341,517,0.487,52,0.542,6.1,325,130,194,0.4,739,0.44,62,0.48,6.4,2013-14,Regular%20Season
203078,Bradley Beal,1610612764,WAS,70,39,31,2427.0,54,18,37,0.333,172,0.314,5,0.323,14.7,216,40,176,0.185,414,0.522,40,0.578,7.7,270,58,213,0.215,586,0.461,45,0.499,9.2,2013-14,Regular%20Season
201148,Brandan Wright,1610612742,DAL,56,36,20,1057.0,102,64,36,0.627,203,0.502,6,0.518,7.2,142,53,90,0.373,277,0.513,30,0.575,5.2,244,117,126,0.48,480,0.508,36,0.55,6.0,2013-14,Regular%20Season
101138,Brandon Bass,1610612738,BOS,81,24,57,2251.0,161,86,74,0.534,355,0.454,6,0.461,8.3,309,91,218,0.294,576,0.536,52,0.59,6.2,470,177,292,0.377,931,0.505,58,0.538,6.9,2013-14,Regular%20Season
203561,Brandon Davies,1610612755,PHI,43,9,34,502.0,38,25,13,0.658,123,0.309,2,0.314,5.7,71,19,53,0.268,132,0.538,11,0.587,6.6,109,44,66,0.404,255,0.427,13,0.45,6.4,2013-14,Regular%20Season
201943,Brandon Jennings,1610612765,DET,75,27,48,2578.0,59,24,39,0.407,212,0.278,7,0.288,13.6,185,13,175,0.07,355,0.521,24,0.559,10.7,244,37,214,0.152,567,0.43,31,0.455,11.4,2013-14,Regular%20Season
202688,Brandon Knight,1610612749,MIL,65,12,53,2210.0,46,15,28,0.326,188,0.245,21,0.275,14.5,209,37,167,0.177,417,0.501,40,0.554,9.1,255,52,195,0.204,605,0.421,61,0.469,10.0,2013-14,Regular%20Season
201575,Brandon Rush,1610612762,UTA,27,7,20,342.0,5,2,3,0.4,26,0.192,0,0.192,16.1,39,12,27,0.308,70,0.557,7,0.619,7.0,44,14,30,0.318,96,0.458,7,0.494,8.0,2013-14,Regular%20Season
203148,Brian Roberts,1610612740,NOP,60,22,38,1434.0,17,4,13,0.235,89,0.191,6,0.205,17.8,119,13,106,0.109,211,0.564,16,0.61,11.2,136,17,119,0.125,300,0.453,22,0.489,12.0,2013-14,Regular%20Season
201572,Brook Lopez,1610612751,BKN,17,7,10,533.0,39,26,11,0.667,95,0.411,2,0.419,5.9,63,27,34,0.429,143,0.441,23,0.525,5.8,102,53,45,0.52,238,0.429,25,0.479,5.8,2013-14,Regular%20Season
201957,Byron Mullens,1610612755,PHI,33,12,21,367.0,24,14,10,0.583,50,0.48,0,0.48,7.5,68,16,51,0.235,109,0.624,13,0.708,4.4,92,30,61,0.326,159,0.579,13,0.63,5.2,2013-14,Regular%20Season
201228,C.J. Watson,1610612754,IND,52,39,13,1000.0,18,4,14,0.222,58,0.31,3,0.327,15.7,82,13,71,0.159,157,0.522,10,0.558,9.7,100,17,85,0.17,215,0.465,13,0.495,10.7,2013-14,Regular%20Season
203468,CJ McCollum,1610612757,POR,26,16,10,390.0,7,1,6,0.143,31,0.226,1,0.233,12.7,41,11,30,0.268,80,0.513,7,0.562,8.9,48,12,36,0.25,111,0.432,8,0.466,9.5,2013-14,Regular%20Season
101139,CJ Miles,1610612739,CLE,41,19,22,865.0,18,6,13,0.333,61,0.295,1,0.3,16.8,85,19,67,0.224,158,0.538,12,0.582,8.7,103,25,80,0.243,219,0.47,13,0.5,10.1,2013-14,Regular%20Season
201171,Carl Landry,1610612758,SAC,17,5,12,223.0,15,8,5,0.533,57,0.263,3,0.278,9.9,42,9,34,0.214,79,0.532,8,0.592,7.2,57,17,39,0.298,136,0.419,11,0.456,7.9,2013-14,Regular%20Season
2430,Carlos Boozer,1610612741,CHI,76,43,33,2141.0,137,70,66,0.511,349,0.393,15,0.41,7.8,495,163,322,0.329,742,0.667,50,0.715,4.9,632,233,388,0.369,1091,0.579,65,0.616,5.5,2013-14,Regular%20Season
2546,Carmelo Anthony,1610612752,NYK,77,35,42,2982.0,145,103,34,0.71,349,0.415,6,0.423,6.1,477,121,350,0.254,744,0.641,43,0.68,5.4,622,224,384,0.36,1093,0.569,49,0.596,5.6,2013-14,Regular%20Season
2406,Caron Butler,1610612760,OKC,55,21,34,1394.0,21,13,10,0.619,94,0.223,4,0.233,9.6,202,54,150,0.267,358,0.564,29,0.614,6.2,223,67,160,0.3,452,0.493,33,0.532,6.6,2013-14,Regular%20Season
203467,Carrick Felix,1610612739,CLE,4,1,3,24.0,1,1,0,1.0,3,0.333,0,0.333,13.9,5,1,4,0.2,8,0.625,1,0.714,8.0,6,2,4,0.333,11,0.545,1,0.6,9.0,2013-14,Regular%20Season
201858,Cartier Martin,1610612737,ATL,43,18,25,764.0,13,8,4,0.615,56,0.232,0,0.232,10.8,96,22,73,0.229,173,0.555,20,0.627,7.4,109,30,77,0.275,229,0.476,20,0.522,7.8,2013-14,Regular%20Season
203810,Casper Ware,1610612755,PHI,6,3,3,83.0,0,0,0,0.0,5,0.0,1,0.0,0.0,9,1,8,0.111,19,0.474,1,0.5,10.4,9,1,8,0.111,24,0.375,2,0.409,10.4,2013-14,Regular%20Season
202718,Chandler Parsons,1610612745,HOU,73,49,24,2763.0,69,27,38,0.391,288,0.24,10,0.248,9.6,340,58,283,0.171,580,0.586,49,0.64,8.8,409,85,321,0.208,868,0.471,59,0.506,8.9,2013-14,Regular%20Season
101112,Channing Frye,1610612756,PHX,81,48,33,2289.0,73,49,23,0.671,186,0.392,13,0.422,7.3,343,125,210,0.364,678,0.506,53,0.549,5.0,416,174,233,0.418,864,0.481,66,0.521,5.4,2013-14,Regular%20Season
101111,Charlie Villanueva,1610612765,DET,16,5,11,159.0,6,5,1,0.833,23,0.261,1,0.273,8.9,28,11,17,0.393,47,0.596,4,0.651,4.4,34,16,18,0.471,70,0.486,5,0.523,5.2,2013-14,Regular%20Season
201978,Chase Budinger,1610612750,MIN,37,20,17,715.0,19,8,10,0.421,55,0.345,3,0.365,9.9,84,20,63,0.238,122,0.689,5,0.718,5.9,103,28,73,0.272,177,0.582,8,0.609,6.6,2013-14,Regular%20Season
1497,Chauncey Billups,1610612765,DET,13,7,6,224.0,3,2,1,0.667,9,0.333,0,0.333,8.7,24,2,22,0.083,42,0.571,4,0.632,8.0,27,4,23,0.148,51,0.529,4,0.574,8.1,2013-14,Regular%20Season
2365,Chris Andersen,1610612748,MIA,70,48,22,1369.0,129,82,43,0.636,334,0.386,8,0.396,5.2,250,103,149,0.412,515,0.485,50,0.538,4.2,379,185,192,0.488,849,0.446,58,0.479,4.5,2013-14,Regular%20Season
203569,Chris Babb,1610612738,BOS,10,3,7,121.0,4,1,3,0.25,10,0.4,1,0.444,11.4,13,5,8,0.385,27,0.481,2,0.52,6.0,17,6,11,0.353,37,0.459,3,0.5,7.2,2013-14,Regular%20Season
2547,Chris Bosh,1610612748,MIA,78,52,26,2505.0,98,54,41,0.551,240,0.408,5,0.417,7.9,424,159,267,0.375,789,0.537,56,0.578,5.2,522,213,308,0.408,1029,0.507,61,0.539,5.7,2013-14,Regular%20Season
203142,Chris Copeland,1610612754,IND,19,12,7,171.0,7,2,5,0.286,20,0.35,0,0.35,15.7,25,9,17,0.36,45,0.556,4,0.61,6.3,32,11,22,0.344,65,0.492,4,0.525,8.3,2013-14,Regular%20Season
201604,Chris Douglas-Roberts,1610612766,CHA,41,22,19,904.0,15,4,10,0.267,59,0.254,0,0.254,15.4,101,29,72,0.287,169,0.598,18,0.669,7.8,116,33,82,0.284,228,0.509,18,0.552,8.7,2013-14,Regular%20Season
203187,Chris Johnson,1610612738,BOS,35,9,26,737.0,31,16,14,0.516,95,0.326,1,0.33,8.4,66,14,52,0.212,141,0.468,16,0.528,6.7,97,30,66,0.309,236,0.411,17,0.443,7.2,2013-14,Regular%20Season
2549,Chris Kaman,1610612747,LAL,38,12,26,732.0,54,35,17,0.648,140,0.386,9,0.412,6.7,175,65,110,0.371,308,0.568,29,0.627,4.1,229,100,127,0.437,448,0.511,38,0.559,4.7,2013-14,Regular%20Season
101108,Chris Paul,1610612746,LAC,59,41,18,2062.0,37,10,29,0.27,157,0.236,9,0.25,15.9,230,36,197,0.157,445,0.517,30,0.554,9.9,267,46,226,0.172,602,0.444,39,0.474,10.7,2013-14,Regular%20Season
202698,Chris Singleton,1610612764,WAS,18,9,9,238.0,18,9,8,0.5,53,0.34,3,0.36,7.1,37,7,30,0.189,69,0.536,8,0.607,7.2,55,16,38,0.291,122,0.451,11,0.495,7.2,2013-14,Regular%20Season
202874,Chris Wright,1610612749,MIL,6,1,5,108.0,10,5,4,0.5,18,0.556,0,0.556,6.4,10,5,5,0.5,30,0.333,2,0.357,6.8,20,10,9,0.5,48,0.417,2,0.435,6.6,2013-14,Regular%20Season
101236,Chuck Hayes,1610612761,TOR,50,27,23,685.0,68,46,20,0.676,170,0.4,9,0.422,5.8,137,46,90,0.336,231,0.593,27,0.672,5.0,205,92,110,0.449,401,0.511,36,0.562,5.3,2013-14,Regular%20Season
203469,Cody Zeller,1610612766,CHA,79,42,37,1388.0,115,66,43,0.574,313,0.367,9,0.378,5.8,231,72,158,0.312,446,0.518,40,0.569,5.2,346,138,201,0.399,759,0.456,49,0.487,5.4,2013-14,Regular%20Season
202332,Cole Aldrich,1610612752,NYK,31,19,12,304.0,37,22,15,0.595,71,0.521,2,0.536,6.9,92,30,62,0.326,138,0.667,8,0.708,4.0,129,52,77,0.403,209,0.617,10,0.648,4.8,2013-14,Regular%20Season
201147,Corey Brewer,1610612750,MIN,70,35,35,2320.0,63,20,38,0.317,227,0.278,7,0.286,12.1,144,26,116,0.181,247,0.583,20,0.634,9.5,207,46,154,0.222,474,0.437,27,0.463,10.3,2013-14,Regular%20Season
202709,Cory Joseph,1610612759,SAS,47,34,13,847.0,32,17,14,0.531,79,0.405,1,0.41,10.8,75,19,57,0.253,156,0.481,13,0.524,9.3,107,36,71,0.336,235,0.455,14,0.484,9.7,2013-14,Regular%20Season
201584,Courtney Lee,1610612763,MEM,69,42,27,1799.0,29,9,19,0.31,101,0.287,2,0.293,14.3,158,28,129,0.177,291,0.543,22,0.587,8.5,187,37,148,0.198,392,0.477,24,0.508,9.4,2013-14,Regular%20Season
201571,D.J. Augustin,1610612741,CHI,59,39,20,1709.0,15,6,10,0.4,146,0.103,5,0.106,12.4,113,14,105,0.124,211,0.536,17,0.582,13.0,128,20,115,0.156,357,0.359,22,0.382,12.9,2013-14,Regular%20Season
203474,DJ Stephens,1610612749,MIL,2,0,2,14.0,1,1,0,1.0,4,0.25,0,0.25,7.7,4,0,4,0.0,6,0.667,0,0.667,9.2,5,1,4,0.2,10,0.5,0,0.5,8.9,2013-14,Regular%20Season
201591,DJ White,1610612766,CHA,2,2,0,10.0,0,0,0,0.0,1,0.0,0,0.0,0.0,2,0,2,0.0,2,1.0,0,1.0,8.1,2,0,2,0.0,3,0.667,0,0.667,8.1,2013-14,Regular%20Season
203081,Damian Lillard,1610612757,POR,77,51,26,2792.0,35,11,24,0.314,233,0.15,10,0.157,14.9,253,44,214,0.174,575,0.44,63,0.494,8.4,288,55,238,0.191,808,0.356,73,0.392,9.2,2013-14,Regular%20Season
202345,Damion James,1610612759,SAS,3,0,3,38.0,1,0,1,0.0,1,1.0,0,1.0,6.2,11,3,8,0.273,17,0.647,2,0.733,7.1,12,3,9,0.25,18,0.667,2,0.75,7.0,2013-14,Regular%20Season
202350,Daniel Orton,1610612755,PHI,20,6,14,246.0,16,10,5,0.625,58,0.276,3,0.291,5.4,45,18,26,0.4,73,0.616,7,0.682,5.4,61,28,31,0.459,131,0.466,10,0.504,5.4,2013-14,Regular%20Season
101122,Danny Granger,1610612746,LAC,40,30,10,832.0,30,19,10,0.633,124,0.242,4,0.25,7.5,102,23,77,0.225,197,0.518,21,0.58,6.4,132,42,87,0.318,321,0.411,25,0.446,6.7,2013-14,Regular%20Season
201980,Danny Green,1610612759,SAS,62,50,12,1547.0,25,9,16,0.36,101,0.248,5,0.26,12.3,204,53,152,0.26,398,0.513,40,0.57,6.2,229,62,168,0.271,499,0.459,45,0.504,6.9,2013-14,Regular%20Season
201967,Dante Cunningham,1610612750,MIN,80,39,41,1627.0,112,51,61,0.455,272,0.412,9,0.426,8.8,218,65,151,0.298,456,0.478,50,0.537,5.2,330,116,212,0.352,728,0.453,59,0.493,6.5,2013-14,Regular%20Season
203130,Darius Johnson-Odom,1610612755,PHI,1,0,1,10.0,0,0,0,0.0,0,0.0,0,0.0,0.0,2,0,2,0.0,3,0.667,0,0.667,6.7,2,0,2,0.0,3,0.667,0,0.667,6.7,2013-14,Regular%20Season
203121,Darius Miller,1610612740,NOP,27,11,16,524.0,9,2,6,0.222,31,0.29,0,0.29,17.5,43,10,34,0.233,81,0.531,9,0.597,9.9,52,12,40,0.231,112,0.464,9,0.505,11.1,2013-14,Regular%20Season
202721,Darius Morris,1610612763,MEM,16,10,6,209.0,7,2,5,0.286,26,0.269,0,0.269,14.3,19,2,17,0.105,36,0.528,0,0.528,11.2,26,4,22,0.154,62,0.419,0,0.419,12.1,2013-14,Regular%20Season
201589,Darrell Arthur,1610612743,DEN,64,30,34,1125.0,52,28,22,0.538,135,0.385,6,0.403,7.9,158,49,111,0.31,359,0.44,36,0.489,6.2,210,77,133,0.367,494,0.425,42,0.465,6.6,2013-14,Regular%20Season
201954,Darren Collison,1610612746,LAC,74,53,21,1964.0,47,15,32,0.319,163,0.288,7,0.301,15.7,141,16,128,0.113,298,0.473,33,0.532,11.6,188,31,160,0.165,461,0.408,40,0.447,12.7,2013-14,Regular%20Season
101135,David Lee,1610612744,GSW,68,41,27,2253.0,179,97,74,0.542,476,0.376,17,0.39,6.7,460,146,306,0.317,764,0.602,81,0.673,5.0,639,243,380,0.38,1240,0.515,98,0.56,5.4,2013-14,Regular%20Season
2561,David West,1610612754,IND,80,54,26,2472.0,120,73,43,0.608,312,0.385,13,0.401,6.6,422,132,287,0.313,752,0.561,62,0.612,5.4,542,205,330,0.378,1064,0.509,75,0.548,5.7,2013-14,Regular%20Season
201599,DeAndre Jordan,1610612746,LAC,81,57,24,2869.0,331,219,98,0.662,615,0.538,18,0.554,5.6,783,271,506,0.346,1200,0.653,76,0.697,4.9,1114,490,604,0.44,1815,0.614,94,0.647,5.1,2013-14,Regular%20Season
202732,DeAndre Liggins,1610612748,MIA,1,1,0,1.0,1,0,1,0.0,1,1.0,0,1.0,1.4,0,0,0,0.0,0,0.0,0,0.0,0.0,1,0,1,0.0,1,1.0,0,1.0,1.4,2013-14,Regular%20Season
201971,DeJuan Blair,1610612742,DAL,71,44,27,1180.0,139,92,44,0.662,342,0.406,5,0.412,6.2,229,87,139,0.38,389,0.589,44,0.664,4.0,368,179,183,0.486,731,0.503,49,0.54,4.9,2013-14,Regular%20Season
201942,DeMar DeRozan,1610612761,TOR,74,43,31,2826.0,50,18,34,0.36,200,0.25,8,0.26,12.9,287,57,228,0.199,508,0.565,33,0.604,8.7,337,75,262,0.223,708,0.476,41,0.505,9.3,2013-14,Regular%20Season
202326,DeMarcus Cousins,1610612758,SAC,70,28,42,2277.0,217,136,70,0.627,538,0.403,19,0.418,5.7,608,193,406,0.317,891,0.682,66,0.737,4.4,825,329,476,0.399,1429,0.577,85,0.614,4.7,2013-14,Regular%20Season
201960,DeMarre Carroll,1610612737,ATL,73,37,36,2341.0,107,64,40,0.598,335,0.319,10,0.329,8.4,296,58,234,0.196,498,0.594,44,0.652,6.9,403,122,274,0.303,833,0.484,54,0.517,7.3,2013-14,Regular%20Season
203471,Dennis Schroder,1610612737,ATL,31,13,18,474.0,5,1,4,0.2,29,0.172,2,0.185,15.4,54,7,48,0.13,110,0.491,14,0.563,8.4,59,8,52,0.136,139,0.424,16,0.48,9.0,2013-14,Regular%20Season
965,Derek Fisher,1610612760,OKC,63,49,14,1129.0,11,4,7,0.364,51,0.216,0,0.216,15.9,110,24,86,0.218,188,0.585,10,0.618,10.6,121,28,93,0.231,239,0.506,10,0.528,11.1,2013-14,Regular%20Season
101114,Deron Williams,1610612751,BKN,58,36,22,1877.0,15,3,12,0.2,99,0.152,3,0.156,18.9,153,25,132,0.163,343,0.446,17,0.469,10.0,168,28,144,0.167,442,0.38,20,0.398,10.8,2013-14,Regular%20Season
202324,Derrick Favors,1610612762,UTA,73,25,48,2201.0,199,131,60,0.658,464,0.429,9,0.437,5.7,438,161,274,0.368,766,0.572,73,0.632,4.7,637,292,334,0.458,1230,0.518,82,0.555,5.0,2013-14,Regular%20Season
201565,Derrick Rose,1610612741,CHI,10,5,5,311.0,9,5,3,0.556,49,0.184,1,0.188,7.2,23,2,20,0.087,49,0.469,5,0.523,11.5,32,7,23,0.219,98,0.327,6,0.348,10.3,2013-14,Regular%20Season
202682,Derrick Williams,1610612758,SAC,71,26,45,1724.0,71,40,27,0.563,203,0.35,5,0.359,6.1,245,43,203,0.176,402,0.609,35,0.668,6.6,316,83,230,0.263,605,0.522,40,0.559,6.5,2013-14,Regular%20Season
2734,Devin Harris,1610612742,DAL,36,24,12,757.0,8,1,7,0.125,45,0.178,1,0.182,15.1,77,16,60,0.208,135,0.57,11,0.621,8.9,85,17,67,0.2,180,0.472,12,0.506,9.5,2013-14,Regular%20Season
203473,Dewayne Dedmon,1610612753,ORL,24,5,19,370.0,38,26,12,0.684,92,0.413,2,0.422,6.1,89,24,67,0.27,126,0.706,6,0.742,4.3,127,50,79,0.394,218,0.583,8,0.605,4.8,2013-14,Regular%20Season
202354,Dexter Pittman,1610612737,ATL,1,0,1,2.0,3,2,0,0.667,3,1.0,0,1.0,1.7,0,0,0,0.0,0,0.0,0,0.0,0.0,3,2,0,0.667,3,1.0,0,1.0,1.7,2013-14,Regular%20Season
203197,Diante Garrett,1610612762,UTA,46,15,31,697.0,10,4,7,0.4,31,0.323,0,0.323,9.4,86,9,76,0.105,130,0.662,10,0.717,8.8,96,13,83,0.135,161,0.596,10,0.636,9.0,2013-14,Regular%20Season
203079,Dion Waiters,1610612739,CLE,63,25,38,1896.0,32,10,23,0.313,149,0.215,2,0.218,13.0,163,33,128,0.202,302,0.54,26,0.591,9.0,195,43,151,0.221,451,0.432,28,0.461,9.7,2013-14,Regular%20Season
202091,Dionte Christmas,1610612756,PHX,17,4,13,142.0,13,5,8,0.385,27,0.481,0,0.481,10.3,25,6,19,0.24,36,0.694,6,0.833,6.8,38,11,27,0.289,63,0.603,6,0.667,8.0,2013-14,Regular%20Season
1717,Dirk Nowitzki,1610612742,DAL,80,48,32,2628.0,40,16,24,0.4,138,0.29,9,0.31,12.7,458,163,289,0.356,744,0.616,69,0.679,4.6,498,179,313,0.359,882,0.565,78,0.619,5.2,2013-14,Regular%20Season
202388,Donald Sloan,1610612754,IND,22,15,7,267.0,4,1,3,0.25,10,0.4,2,0.5,6.5,40,3,36,0.075,53,0.755,1,0.769,9.8,44,4,39,0.091,63,0.698,3,0.733,9.5,2013-14,Regular%20Season
202700,Donatas Motiejunas,1610612745,HOU,57,38,19,924.0,60,33,24,0.55,171,0.351,5,0.361,6.7,165,56,107,0.339,315,0.524,32,0.583,5.0,225,89,131,0.396,486,0.463,37,0.501,5.4,2013-14,Regular%20Season
2748,Dorell Wright,1610612757,POR,60,44,16,906.0,29,9,20,0.31,75,0.387,1,0.392,14.2,162,45,116,0.278,279,0.581,27,0.643,6.1,191,54,136,0.283,354,0.54,28,0.586,7.3,2013-14,Regular%20Season
203117,Doron Lamb,1610612753,ORL,28,7,21,443.0,8,1,7,0.125,26,0.308,0,0.308,17.3,41,11,30,0.268,70,0.586,2,0.603,10.5,49,12,37,0.245,96,0.51,2,0.521,11.6,2013-14,Regular%20Season
203110,Draymond Green,1610612744,GSW,80,49,31,1768.0,84,57,24,0.679,219,0.384,14,0.41,6.7,320,114,200,0.356,553,0.579,47,0.632,4.6,404,171,224,0.423,772,0.523,61,0.568,5.1,2013-14,Regular%20Season
2400,Drew Gooden,1610612764,WAS,21,12,9,377.0,35,18,18,0.514,80,0.438,2,0.449,7.6,71,20,50,0.282,131,0.542,13,0.602,4.5,106,38,68,0.358,211,0.502,15,0.541,5.5,2013-14,Regular%20Season
202779,Dwight Buycks,1610612761,TOR,10,3,7,132.0,4,2,2,0.5,19,0.211,0,0.211,9.1,19,1,18,0.053,35,0.543,2,0.576,8.9,23,3,20,0.13,54,0.426,2,0.442,8.9,2013-14,Regular%20Season
2730,Dwight Howard,1610612745,HOU,71,48,23,2396.0,231,162,59,0.701,549,0.421,13,0.431,4.9,635,244,384,0.384,1005,0.632,76,0.684,4.2,866,406,443,0.469,1554,0.557,89,0.591,4.4,2013-14,Regular%20Season
2548,Dwyane Wade,1610612748,MIA,53,36,17,1756.0,60,30,29,0.5,169,0.355,2,0.359,10.1,181,35,143,0.193,349,0.519,37,0.58,9.6,241,65,172,0.27,518,0.465,39,0.503,9.7,2013-14,Regular%20Season
202734,E'Twaun Moore,1610612753,ORL,60,17,43,1190.0,29,10,18,0.345,98,0.296,4,0.309,12.2,106,27,79,0.255,207,0.512,20,0.567,9.7,135,37,97,0.274,305,0.443,24,0.48,10.2,2013-14,Regular%20Season
201947,Earl Clark,1610612752,NYK,44,16,28,711.0,22,10,12,0.455,82,0.268,2,0.275,11.0,121,36,85,0.298,210,0.576,18,0.63,5.4,143,46,97,0.322,292,0.49,20,0.526,6.3,2013-14,Regular%20Season
2248,Earl Watson,1610612757,POR,10,7,3,66.0,5,2,3,0.4,6,0.833,0,0.833,14.6,10,0,10,0.0,20,0.5,0,0.5,11.4,15,2,13,0.133,26,0.577,0,0.577,12.4,2013-14,Regular%20Season
202334,Ed Davis,1610612763,MEM,59,35,24,941.0,92,58,32,0.63,257,0.358,11,0.374,5.5,168,67,102,0.399,310,0.542,27,0.594,4.4,260,125,134,0.481,567,0.459,38,0.491,4.8,2013-14,Regular%20Season
202327,Ekpe Udoh,1610612749,MIL,38,7,31,742.0,61,37,23,0.607,149,0.409,3,0.418,7.5,87,28,59,0.322,221,0.394,29,0.453,5.9,148,65,82,0.439,370,0.4,32,0.438,6.6,2013-14,Regular%20Season
203548,Elias Harris,1610612747,LAL,1,1,0,4.0,1,0,1,0.0,1,1.0,0,1.0,26.5,0,0,0,0.0,0,0.0,0,0.0,0.0,1,0,1,0.0,1,1.0,0,1.0,26.5,2013-14,Regular%20Season
202343,Elliot Williams,1610612755,PHI,58,10,48,1042.0,29,9,19,0.31,97,0.299,4,0.312,11.1,100,10,92,0.1,169,0.592,11,0.633,7.2,129,19,111,0.147,266,0.485,15,0.514,8.0,2013-14,Regular%20Season
1882,Elton Brand,1610612737,ATL,71,34,37,1379.0,97,61,35,0.629,244,0.398,9,0.413,6.9,260,110,148,0.423,467,0.557,41,0.61,4.8,357,171,183,0.479,711,0.502,50,0.54,5.4,2013-14,Regular%20Season
202683,Enes Freedom,1610612762,UTA,80,23,57,2138.0,222,162,52,0.73,555,0.4,15,0.411,4.9,376,155,223,0.412,696,0.54,70,0.601,4.5,598,317,275,0.53,1251,0.478,85,0.513,4.6,2013-14,Regular%20Season
202339,Eric Bledsoe,1610612756,PHX,42,28,14,1398.0,27,7,19,0.259,115,0.235,7,0.25,12.0,175,29,147,0.166,315,0.556,21,0.595,8.8,202,36,166,0.178,430,0.47,28,0.502,9.2,2013-14,Regular%20Season
201569,Eric Gordon,1610612740,NOP,57,25,32,1860.0,30,13,17,0.433,131,0.229,3,0.234,13.8,135,16,119,0.119,251,0.538,24,0.595,8.5,165,29,136,0.176,382,0.432,27,0.465,9.5,2013-14,Regular%20Season
201953,Eric Maynor,1610612755,PHI,20,7,13,246.0,9,2,7,0.222,24,0.375,2,0.409,18.1,30,3,27,0.1,44,0.682,4,0.75,8.7,39,5,34,0.128,68,0.574,6,0.629,10.9,2013-14,Regular%20Season
203513,Erik Murphy,1610612741,CHI,5,3,2,24.0,2,1,1,0.5,3,0.667,0,0.667,5.8,6,0,6,0.0,10,0.6,0,0.6,9.4,8,1,7,0.125,13,0.615,0,0.615,8.5,2013-14,Regular%20Season
101141,Ersan Ilyasova,1610612749,MIL,54,10,44,1455.0,105,67,37,0.638,248,0.423,8,0.438,5.3,233,89,141,0.382,412,0.566,28,0.607,4.8,338,156,178,0.462,660,0.512,36,0.542,5.0,2013-14,Regular%20Season
203095,Evan Fournier,1610612743,DEN,64,28,36,1390.0,34,13,21,0.382,144,0.236,10,0.254,10.2,168,34,134,0.202,307,0.547,20,0.585,8.2,202,47,155,0.233,451,0.448,30,0.48,8.6,2013-14,Regular%20Season
202323,Evan Turner,1610612754,IND,80,28,52,2434.0,62,28,32,0.452,266,0.233,8,0.24,12.4,346,66,278,0.191,581,0.596,51,0.653,6.5,408,94,310,0.23,847,0.482,59,0.518,7.4,2013-14,Regular%20Season
101128,Francisco Garcia,1610612745,HOU,48,29,19,1008.0,21,6,14,0.286,60,0.35,3,0.368,15.3,101,18,82,0.178,219,0.461,24,0.518,7.5,122,24,96,0.197,279,0.437,27,0.484,8.8,2013-14,Regular%20Season
203539,Gal Mekel,1610612742,DAL,16,8,8,204.0,5,3,2,0.6,19,0.263,1,0.278,9.6,22,0,22,0.0,37,0.595,2,0.629,10.8,27,3,24,0.111,56,0.482,3,0.509,10.6,2013-14,Regular%20Season
202066,Garrett Temple,1610612764,WAS,42,25,17,531.0,21,7,14,0.333,65,0.323,3,0.339,13.9,47,7,40,0.149,102,0.461,8,0.5,8.1,68,14,54,0.206,167,0.407,11,0.436,9.9,2013-14,Regular%20Season
202390,Gary Neal,1610612766,CHA,40,14,26,844.0,9,4,6,0.444,43,0.209,1,0.214,17.3,75,12,63,0.16,133,0.564,9,0.605,7.9,84,16,69,0.19,176,0.477,10,0.506,9.0,2013-14,Regular%20Season
201588,George Hill,1610612754,IND,72,47,25,2309.0,53,20,33,0.377,142,0.373,6,0.39,13.8,229,38,191,0.166,487,0.47,37,0.509,8.0,282,58,224,0.206,629,0.448,43,0.481,9.2,2013-14,Regular%20Season
101123,Gerald Green,1610612756,PHX,78,47,31,2239.0,48,16,31,0.333,146,0.329,5,0.34,11.5,227,51,173,0.225,420,0.54,28,0.579,7.8,275,67,204,0.244,566,0.486,33,0.516,8.5,2013-14,Regular%20Season
201945,Gerald Henderson,1610612766,CHA,74,39,35,2374.0,31,9,22,0.29,178,0.174,2,0.176,12.3,278,48,227,0.173,437,0.636,25,0.675,7.4,309,57,249,0.184,615,0.502,27,0.526,7.9,2013-14,Regular%20Season
2222,Gerald Wallace,1610612738,BOS,57,18,39,1398.0,36,24,11,0.667,135,0.267,4,0.275,5.6,176,41,136,0.233,298,0.591,26,0.647,6.5,212,65,147,0.307,433,0.49,30,0.526,6.4,2013-14,Regular%20Season
203507,Giannis Antetokounmpo,1610612749,MIL,71,13,58,1800.0,77,36,42,0.468,238,0.324,12,0.341,7.9,258,65,193,0.252,481,0.536,34,0.577,5.8,335,101,235,0.301,719,0.466,46,0.498,6.3,2013-14,Regular%20Season
203540,Gigi Datome,1610612765,DET,22,6,16,202.0,14,8,5,0.571,35,0.4,1,0.412,8.0,32,11,21,0.344,56,0.571,1,0.582,6.8,46,19,26,0.413,91,0.505,2,0.517,7.2,2013-14,Regular%20Season
201175,Glen Davis,1610612746,LAC,66,28,38,1655.0,108,64,41,0.593,259,0.417,7,0.429,6.9,243,101,140,0.416,478,0.508,58,0.579,5.1,351,165,181,0.47,737,0.476,65,0.522,5.7,2013-14,Regular%20Season
203318,Glen Rice,1610612764,WAS,7,1,6,100.0,4,1,3,0.25,11,0.364,1,0.4,22.5,16,4,12,0.25,20,0.8,0,0.8,10.6,20,5,15,0.25,31,0.645,1,0.667,13.0,2013-14,Regular%20Season
201609,Goran Dragic,1610612756,PHX,73,44,29,2557.0,69,24,45,0.348,229,0.301,18,0.327,13.7,176,22,156,0.125,394,0.447,27,0.48,11.0,245,46,201,0.188,623,0.393,45,0.424,11.9,2013-14,Regular%20Season
202330,Gordon Hayward,1610612762,UTA,75,23,52,2747.0,62,22,40,0.355,214,0.29,10,0.304,11.3,329,72,255,0.219,561,0.586,42,0.634,8.5,391,94,295,0.24,775,0.505,52,0.541,8.9,2013-14,Regular%20Season
203476,Gorgui Dieng,1610612750,MIN,51,26,25,780.0,103,71,29,0.689,245,0.42,4,0.427,5.7,197,73,122,0.371,291,0.677,18,0.722,4.4,300,144,151,0.48,536,0.56,22,0.584,4.8,2013-14,Regular%20Season
202328,Greg Monroe,1610612765,DET,82,29,53,2689.0,256,161,81,0.629,654,0.391,24,0.406,5.7,504,205,299,0.407,857,0.588,92,0.659,4.8,760,366,380,0.482,1511,0.503,116,0.545,5.1,2013-14,Regular%20Season
201141,Greg Oden,1610612748,MIA,20,14,6,197.0,23,13,10,0.565,52,0.442,1,0.451,10.3,31,9,22,0.29,68,0.456,6,0.5,5.4,54,22,32,0.407,120,0.45,7,0.478,7.5,2013-14,Regular%20Season
202962,Greg Smith,1610612745,HOU,9,5,4,95.0,11,8,3,0.727,27,0.407,1,0.423,4.0,16,4,12,0.25,32,0.5,3,0.552,5.1,27,12,15,0.444,59,0.458,4,0.491,4.6,2013-14,Regular%20Season
201880,Greg Stiemsma,1610612740,NOP,52,20,32,975.0,71,32,36,0.451,168,0.423,4,0.433,6.4,154,53,100,0.344,309,0.498,32,0.556,3.5,225,85,136,0.378,477,0.472,36,0.51,4.4,2013-14,Regular%20Season
202349,Greivis Vasquez,1610612761,TOR,63,35,28,1491.0,19,6,12,0.316,109,0.174,3,0.179,17.6,153,30,123,0.196,295,0.519,24,0.565,8.6,172,36,135,0.209,404,0.426,27,0.456,9.6,2013-14,Regular%20Season
202970,Gustavo Ayon,1610612737,ATL,23,11,12,399.0,40,22,17,0.55,104,0.385,3,0.396,5.9,82,33,48,0.402,144,0.569,12,0.621,4.2,122,55,65,0.451,248,0.492,15,0.524,4.7,2013-14,Regular%20Season
202380,Hamady Ndiaye,1610612758,SAC,9,2,7,63.0,4,2,1,0.5,16,0.25,1,0.267,3.9,13,4,9,0.308,19,0.684,3,0.813,5.7,17,6,10,0.353,35,0.486,4,0.548,5.4,2013-14,Regular%20Season
203084,Harrison Barnes,1610612744,GSW,71,44,27,2038.0,66,25,42,0.379,190,0.347,6,0.359,10.4,245,56,188,0.229,477,0.514,58,0.585,7.2,311,81,230,0.26,667,0.466,64,0.516,7.9,2013-14,Regular%20Season
201934,Hasheem Thabeet,1610612760,OKC,17,13,4,167.0,9,5,4,0.556,19,0.474,0,0.474,6.3,31,11,20,0.355,55,0.564,7,0.646,4.9,40,16,24,0.4,74,0.541,7,0.597,5.3,2013-14,Regular%20Season
2045,Hedo Turkoglu,1610612746,LAC,32,23,9,356.0,11,6,5,0.545,36,0.306,2,0.324,9.8,78,19,59,0.244,127,0.614,10,0.667,5.7,89,25,64,0.281,163,0.546,12,0.589,6.2,2013-14,Regular%20Season
203156,Henry Sims,1610612755,PHI,40,10,30,864.0,103,67,33,0.65,257,0.401,10,0.417,4.9,133,49,83,0.368,294,0.452,29,0.502,4.9,236,116,116,0.492,551,0.428,39,0.461,4.9,2013-14,Regular%20Season
200756,Hilton Armstrong,1610612744,GSW,10,7,3,93.0,19,17,2,0.895,33,0.576,2,0.613,5.0,28,15,13,0.536,39,0.718,2,0.757,3.9,47,32,15,0.681,72,0.653,4,0.691,4.4,2013-14,Regular%20Season
203138,Hollis Thompson,1610612755,PHI,73,15,58,1692.0,73,34,37,0.466,186,0.392,3,0.399,10.1,174,43,131,0.247,319,0.545,22,0.586,7.0,247,77,168,0.312,505,0.489,25,0.515,7.9,2013-14,Regular%20Season
203546,Ian Clark,1610612762,UTA,11,2,9,95.0,3,1,2,0.333,14,0.214,0,0.214,17.8,16,4,12,0.25,20,0.8,0,0.8,9.6,19,5,14,0.263,34,0.559,0,0.559,10.9,2013-14,Regular%20Season
101133,Ian Mahinmi,1610612754,IND,75,50,25,1227.0,107,72,33,0.673,296,0.361,7,0.37,6.0,150,64,86,0.427,375,0.4,39,0.446,5.6,257,136,119,0.529,671,0.383,46,0.411,5.8,2013-14,Regular%20Season
202697,Iman Shumpert,1610612752,NYK,70,34,36,1860.0,80,41,41,0.513,229,0.349,5,0.357,10.3,227,47,179,0.207,401,0.566,35,0.62,6.8,307,88,220,0.287,630,0.487,40,0.52,7.7,2013-14,Regular%20Season
203477,Isaiah Canaan,1610612745,HOU,14,7,7,218.0,7,3,4,0.429,26,0.269,3,0.304,16.2,17,2,15,0.118,33,0.515,4,0.586,9.4,24,5,19,0.208,59,0.407,7,0.462,11.4,2013-14,Regular%20Season
202738,Isaiah Thomas,1610612758,SAC,69,25,44,2422.0,44,15,30,0.341,194,0.227,11,0.24,13.5,161,17,147,0.106,389,0.414,30,0.448,11.9,205,32,177,0.156,583,0.352,41,0.378,12.3,2013-14,Regular%20Season
202397,Ish Smith,1610612756,PHX,45,25,20,804.0,31,14,17,0.452,92,0.337,7,0.365,9.0,98,19,79,0.194,182,0.538,18,0.598,7.6,129,33,96,0.256,274,0.471,25,0.518,7.9,2013-14,Regular%20Season
200826,J.J. Barea,1610612750,MIN,67,33,34,1249.0,16,5,11,0.313,120,0.133,9,0.144,13.3,138,14,125,0.101,250,0.552,18,0.595,9.1,154,19,136,0.123,370,0.416,27,0.449,9.5,2013-14,Regular%20Season
201581,JJ Hickson,1610612743,DEN,69,31,38,1859.0,206,119,79,0.578,463,0.445,9,0.454,6.3,426,134,292,0.315,673,0.633,56,0.69,5.6,632,253,371,0.4,1136,0.556,65,0.59,5.8,2013-14,Regular%20Season
200755,JJ Redick,1610612746,LAC,32,21,11,891.0,9,1,9,0.111,53,0.17,0,0.17,17.8,65,13,52,0.2,142,0.458,5,0.474,8.8,74,14,61,0.189,195,0.379,5,0.389,10.1,2013-14,Regular%20Season
2747,JR Smith,1610612752,NYK,70,31,39,2312.0,35,11,24,0.314,150,0.233,5,0.241,15.4,261,39,225,0.149,405,0.644,28,0.692,7.6,296,50,249,0.169,555,0.533,33,0.567,8.5,2013-14,Regular%20Season
201580,JaVale McGee,1610612743,DEN,5,1,4,79.0,10,2,8,0.2,21,0.476,1,0.5,7.0,7,4,3,0.571,24,0.292,7,0.412,4.4,17,6,11,0.353,45,0.378,8,0.459,5.9,2013-14,Regular%20Season
203109,Jae Crowder,1610612742,DAL,69,42,27,1179.0,46,28,18,0.609,115,0.4,6,0.422,8.9,148,31,116,0.209,291,0.509,31,0.569,6.6,194,59,134,0.304,406,0.478,37,0.526,7.1,2013-14,Regular%20Season
203479,Jamaal Franklin,1610612763,MEM,15,7,8,146.0,4,2,1,0.5,6,0.667,0,0.667,8.7,19,3,16,0.158,30,0.633,4,0.731,5.8,23,5,17,0.217,36,0.639,4,0.719,6.2,2013-14,Regular%20Season
2224,Jamaal Tinsley,1610612762,UTA,6,0,6,82.0,2,1,1,0.5,4,0.5,0,0.5,14.7,9,1,8,0.111,17,0.529,1,0.563,9.2,11,2,9,0.182,21,0.524,1,0.55,10.2,2013-14,Regular%20Season
2037,Jamal Crawford,1610612746,LAC,60,39,21,1846.0,34,10,23,0.294,95,0.358,6,0.382,14.9,124,8,118,0.065,229,0.541,7,0.559,12.2,158,18,141,0.114,324,0.488,13,0.508,12.8,2013-14,Regular%20Season
2749,Jameer Nelson,1610612753,ORL,66,20,46,2117.0,29,6,23,0.207,130,0.223,6,0.234,12.5,202,23,180,0.114,382,0.529,25,0.566,10.1,231,29,203,0.126,512,0.451,31,0.48,10.4,2013-14,Regular%20Season
202341,James Anderson,1610612755,PHI,75,18,57,2183.0,59,28,32,0.475,181,0.326,5,0.335,10.0,241,46,196,0.191,456,0.529,42,0.582,6.9,300,74,228,0.247,637,0.471,47,0.508,7.5,2013-14,Regular%20Season
201935,James Harden,1610612745,HOU,73,48,25,2777.0,61,22,40,0.361,230,0.265,9,0.276,11.2,283,60,226,0.212,531,0.533,41,0.578,8.9,344,82,266,0.238,761,0.452,50,0.484,9.4,2013-14,Regular%20Season
201949,James Johnson,1610612763,MEM,45,29,16,931.0,60,27,31,0.45,152,0.395,2,0.4,8.5,106,22,83,0.208,215,0.493,19,0.541,6.7,166,49,114,0.295,367,0.452,21,0.48,7.4,2013-14,Regular%20Season
2592,James Jones,1610612748,MIA,11,8,3,207.0,2,1,1,0.5,13,0.154,2,0.182,34.9,21,6,15,0.286,47,0.447,5,0.5,7.3,23,7,16,0.304,60,0.383,7,0.434,9.7,2013-14,Regular%20Season
203263,James Nunnally,1610612755,PHI,8,2,6,127.0,1,0,1,0.0,7,0.143,0,0.143,10.4,18,0,18,0.0,38,0.474,1,0.486,8.7,19,0,19,0.0,45,0.422,1,0.432,8.8,2013-14,Regular%20Season
203480,James Southerland,1610612740,NOP,3,1,2,27.0,0,0,0,0.0,3,0.0,0,0.0,0.0,8,1,7,0.125,13,0.615,0,0.615,6.1,8,1,7,0.125,16,0.5,0,0.5,6.1,2013-14,Regular%20Season
202686,Jan Vesely,1610612743,DEN,49,21,28,747.0,81,43,36,0.531,186,0.435,8,0.455,7.3,110,40,72,0.364,226,0.487,22,0.539,5.2,191,83,108,0.435,412,0.464,30,0.5,6.1,2013-14,Regular%20Season
2457,Jannero Pargo,1610612766,CHA,14,9,5,181.0,1,0,1,0.0,6,0.167,0,0.167,21.6,19,2,17,0.105,32,0.594,4,0.679,10.6,20,2,18,0.1,38,0.526,4,0.588,11.2,2013-14,Regular%20Season
203099,Jared Cunningham,1610612758,SAC,4,1,3,29.0,1,1,0,1.0,6,0.167,0,0.167,1.5,4,3,1,0.75,6,0.667,0,0.667,4.5,5,4,1,0.8,12,0.417,0,0.417,3.9,2013-14,Regular%20Season
201162,Jared Dudley,1610612746,LAC,63,46,17,1545.0,36,10,26,0.278,131,0.275,9,0.295,11.9,124,24,99,0.194,293,0.423,25,0.463,7.9,160,34,125,0.213,424,0.377,34,0.41,8.8,2013-14,Regular%20Season
203096,Jared Sullinger,1610612738,BOS,74,23,51,2041.0,241,179,54,0.743,510,0.473,13,0.485,4.9,360,155,203,0.431,644,0.559,44,0.6,4.3,601,334,257,0.556,1154,0.521,57,0.548,4.5,2013-14,Regular%20Season
101127,Jarrett Jack,1610612739,CLE,71,29,42,2058.0,22,4,19,0.182,115,0.191,3,0.196,17.3,201,23,178,0.114,391,0.514,31,0.558,9.1,223,27,197,0.121,506,0.441,34,0.472,10.0,2013-14,Regular%20Season
202363,Jarvis Varnado,1610612755,PHI,22,4,18,329.0,19,14,5,0.737,61,0.311,5,0.339,6.9,44,17,27,0.386,102,0.431,10,0.478,4.5,63,31,32,0.492,163,0.387,15,0.426,5.4,2013-14,Regular%20Season
2215,Jason Collins,1610612751,BKN,10,7,3,112.0,7,5,2,0.714,16,0.438,0,0.438,6.5,12,3,9,0.25,26,0.462,3,0.522,7.8,19,8,11,0.421,42,0.452,3,0.487,7.3,2013-14,Regular%20Season
101131,Jason Maxiell,1610612753,ORL,29,5,24,454.0,27,18,8,0.667,106,0.255,5,0.267,5.1,58,19,39,0.328,125,0.464,9,0.5,6.1,85,37,47,0.435,231,0.368,14,0.392,5.8,2013-14,Regular%20Season
201160,Jason Smith,1610612740,NOP,31,11,20,830.0,51,17,32,0.333,110,0.464,4,0.481,11.0,130,50,79,0.385,230,0.565,13,0.599,6.0,181,67,111,0.37,340,0.532,17,0.56,7.4,2013-14,Regular%20Season
1891,Jason Terry,1610612751,BKN,21,11,10,367.0,4,1,4,0.25,18,0.222,1,0.235,10.8,32,2,30,0.063,58,0.552,3,0.582,10.4,36,3,34,0.083,76,0.474,4,0.5,10.8,2013-14,Regular%20Season
201574,Jason Thompson,1610612758,SAC,78,28,50,1950.0,151,95,50,0.629,435,0.347,19,0.363,5.9,369,111,254,0.301,676,0.546,81,0.62,5.4,520,206,304,0.396,1111,0.468,100,0.514,5.5,2013-14,Regular%20Season
202399,Jeff Adrien,1610612749,MIL,49,15,34,952.0,102,75,26,0.735,250,0.408,9,0.423,4.1,204,70,131,0.343,333,0.613,20,0.652,4.1,306,145,157,0.474,583,0.525,29,0.552,4.1,2013-14,Regular%20Season
201965,Jeff Ayres,1610612759,SAS,67,50,17,921.0,88,51,33,0.58,201,0.438,5,0.449,5.8,169,59,109,0.349,334,0.506,41,0.577,3.9,257,110,142,0.428,535,0.48,46,0.526,4.6,2013-14,Regular%20Season
201145,Jeff Green,1610612738,BOS,82,25,57,2805.0,54,26,24,0.481,235,0.23,9,0.239,10.1,326,76,246,0.233,587,0.555,51,0.608,6.4,380,102,270,0.268,822,0.462,60,0.499,6.9,2013-14,Regular%20Season
201952,Jeff Teague,1610612737,ATL,68,29,39,2221.0,33,13,22,0.394,174,0.19,10,0.201,13.5,172,17,155,0.099,350,0.491,33,0.543,10.4,205,30,177,0.146,524,0.391,43,0.426,10.9,2013-14,Regular%20Season
203481,Jeff Withey,1610612740,NOP,47,15,32,649.0,49,27,19,0.551,129,0.38,7,0.402,5.1,101,42,58,0.416,220,0.459,19,0.502,4.4,150,69,77,0.46,349,0.43,26,0.464,4.6,2013-14,Regular%20Season
203106,Jeffery Taylor,1610612766,CHA,21,10,11,522.0,15,9,6,0.6,60,0.25,0,0.25,11.1,45,6,39,0.133,95,0.474,9,0.523,9.0,60,15,45,0.25,155,0.387,9,0.411,9.6,2013-14,Regular%20Season
202379,Jeremy Evans,1610612762,UTA,59,22,37,1148.0,119,75,42,0.63,254,0.469,8,0.484,6.4,190,54,132,0.284,369,0.515,46,0.588,5.2,309,129,174,0.417,623,0.496,54,0.543,5.7,2013-14,Regular%20Season
203087,Jeremy Lamb,1610612760,OKC,70,52,18,1450.0,27,10,15,0.37,115,0.235,5,0.245,10.3,162,39,123,0.241,317,0.511,26,0.557,5.5,189,49,138,0.259,432,0.438,31,0.471,6.2,2013-14,Regular%20Season
202391,Jeremy Lin,1610612745,HOU,64,42,22,1904.0,34,5,25,0.147,165,0.206,6,0.214,17.4,153,34,118,0.222,387,0.395,43,0.445,8.8,187,39,143,0.209,552,0.339,49,0.372,10.3,2013-14,Regular%20Season
202719,Jeremy Tyler,1610612752,NYK,32,14,18,375.0,38,24,14,0.632,95,0.4,3,0.413,6.1,71,35,35,0.493,126,0.563,10,0.612,4.7,109,59,49,0.541,221,0.493,13,0.524,5.2,2013-14,Regular%20Season
979,Jermaine O'Neal,1610612744,GSW,42,26,16,858.0,83,50,31,0.602,209,0.397,2,0.401,6.0,156,54,98,0.346,307,0.508,25,0.553,4.7,239,104,129,0.435,516,0.463,27,0.489,5.2,2013-14,Regular%20Season
201573,Jerryd Bayless,1610612738,BOS,64,22,42,1510.0,22,3,17,0.136,87,0.253,7,0.275,19.7,123,25,98,0.203,248,0.496,21,0.542,9.1,145,28,115,0.193,335,0.433,28,0.472,10.5,2013-14,Regular%20Season
202690,Jimmer Fredette,1610612741,CHI,26,11,15,337.0,8,4,3,0.5,25,0.32,2,0.348,14.1,44,1,43,0.023,70,0.629,5,0.677,11.1,52,5,46,0.096,95,0.547,7,0.591,11.5,2013-14,Regular%20Season
202710,Jimmy Butler,1610612741,CHI,66,43,23,2574.0,87,44,37,0.506,252,0.345,14,0.366,10.5,243,67,174,0.276,521,0.466,53,0.519,7.7,330,111,211,0.336,773,0.427,67,0.467,8.4,2013-14,Regular%20Season
201149,Joakim Noah,1610612741,CHI,80,48,32,2820.0,282,181,98,0.642,687,0.41,19,0.422,6.5,618,224,396,0.362,1110,0.557,87,0.604,4.0,900,405,494,0.45,1797,0.501,106,0.532,4.8,2013-14,Regular%20Season
201975,Jodie Meeks,1610612747,LAL,67,21,46,2250.0,29,10,20,0.345,134,0.216,6,0.227,14.0,164,23,142,0.14,309,0.531,16,0.56,10.9,193,33,162,0.171,443,0.436,22,0.458,11.4,2013-14,Regular%20Season
2207,Joe Johnson,1610612751,BKN,74,40,34,2420.0,46,27,19,0.587,146,0.315,7,0.331,10.4,220,48,174,0.218,383,0.574,20,0.606,8.2,266,75,193,0.282,529,0.503,27,0.53,8.6,2013-14,Regular%20Season
201202,Joel Anthony,1610612738,BOS,17,8,9,156.0,14,7,8,0.5,30,0.467,1,0.483,6.5,23,5,18,0.217,55,0.418,8,0.489,3.8,37,12,26,0.324,85,0.435,9,0.487,4.9,2013-14,Regular%20Season
200777,Joel Freeland,1610612757,POR,50,37,13,721.0,88,52,36,0.591,213,0.413,3,0.419,7.0,120,45,76,0.375,256,0.469,32,0.536,4.7,208,97,112,0.466,469,0.443,35,0.479,5.6,2013-14,Regular%20Season
203089,John Henson,1610612749,MIL,69,12,57,1832.0,170,101,63,0.594,347,0.49,4,0.496,6.6,324,133,187,0.41,577,0.562,33,0.596,4.7,494,234,250,0.474,924,0.535,37,0.557,5.4,2013-14,Regular%20Season
203098,John Jenkins,1610612737,ATL,9,5,4,141.0,3,2,2,0.667,12,0.25,0,0.25,6.3,19,3,16,0.158,40,0.475,7,0.576,7.9,22,5,18,0.227,52,0.423,7,0.489,8.0,2013-14,Regular%20Season
101249,John Lucas III,1610612762,UTA,21,4,17,393.0,12,2,11,0.167,18,0.667,1,0.706,18.5,27,2,25,0.074,55,0.491,1,0.5,12.2,39,4,36,0.103,73,0.534,2,0.549,14.3,2013-14,Regular%20Season
2422,John Salmons,1610612761,TOR,67,40,27,1510.0,20,5,14,0.25,80,0.25,1,0.253,15.4,140,32,109,0.229,288,0.486,20,0.522,7.1,160,37,123,0.231,368,0.435,21,0.461,8.1,2013-14,Regular%20Season
202322,John Wall,1610612764,WAS,80,43,37,2917.0,37,13,25,0.351,239,0.155,23,0.171,16.3,294,38,257,0.129,542,0.542,25,0.569,9.8,331,51,282,0.154,781,0.424,48,0.452,10.6,2013-14,Regular%20Season
202720,Jon Leuer,1610612763,MEM,40,20,20,604.0,37,21,18,0.568,111,0.333,1,0.336,6.2,120,37,82,0.308,195,0.615,19,0.682,4.7,157,58,100,0.369,306,0.513,20,0.549,5.1,2013-14,Regular%20Season
201973,Jonas Jerebko,1610612765,DET,47,15,32,648.0,51,36,13,0.706,124,0.411,7,0.436,7.1,123,37,86,0.301,201,0.612,16,0.665,6.1,174,73,99,0.42,325,0.535,23,0.576,6.4,2013-14,Regular%20Season
202685,Jonas Valanciunas,1610612761,TOR,80,46,34,2266.0,223,155,64,0.695,630,0.354,10,0.36,4.7,485,172,311,0.355,873,0.556,82,0.613,3.7,708,327,375,0.462,1503,0.471,92,0.502,4.0,2013-14,Regular%20Season
202348,Jordan Crawford,1610612744,GSW,70,34,36,1708.0,27,10,15,0.37,108,0.25,7,0.267,11.9,155,15,140,0.097,279,0.556,19,0.596,10.1,182,25,155,0.137,387,0.47,26,0.504,10.4,2013-14,Regular%20Season
200770,Jordan Farmar,1610612747,LAL,36,14,22,832.0,20,8,12,0.4,61,0.328,3,0.345,11.3,84,10,75,0.119,156,0.538,9,0.571,10.3,104,18,87,0.173,217,0.479,12,0.507,10.5,2013-14,Regular%20Season
202706,Jordan Hamilton,1610612745,HOU,52,26,26,958.0,32,16,17,0.5,101,0.317,3,0.327,15.0,162,35,125,0.216,303,0.535,33,0.6,5.8,194,51,142,0.263,404,0.48,36,0.527,7.4,2013-14,Regular%20Season
201941,Jordan Hill,1610612747,LAL,71,23,48,1494.0,194,148,45,0.763,516,0.376,13,0.386,5.4,340,129,208,0.379,602,0.565,49,0.615,4.3,534,277,253,0.519,1118,0.478,62,0.506,4.7,2013-14,Regular%20Season
203268,Jorge Gutierrez,1610612751,BKN,11,6,5,185.0,3,1,2,0.333,15,0.2,2,0.231,13.3,19,2,14,0.105,37,0.514,4,0.576,6.9,22,3,16,0.136,52,0.423,6,0.478,7.9,2013-14,Regular%20Season
101181,Jose Calderon,1610612742,DAL,72,44,28,2231.0,29,2,27,0.069,73,0.397,3,0.414,20.9,162,28,139,0.173,371,0.437,24,0.467,11.6,191,30,166,0.157,444,0.43,27,0.458,13.1,2013-14,Regular%20Season
2735,Josh Childress,1610612740,NOP,3,2,1,19.0,0,0,0,0.0,2,0.0,0,0.0,0.0,3,1,2,0.333,4,0.75,0,0.75,2.7,3,1,2,0.333,6,0.5,0,0.5,2.7,2013-14,Regular%20Season
202725,Josh Harrellson,1610612765,DET,23,8,15,273.0,30,16,11,0.533,55,0.545,3,0.577,5.8,46,18,25,0.391,85,0.541,8,0.597,4.6,76,34,36,0.447,140,0.543,11,0.589,5.1,2013-14,Regular%20Season
201177,Josh McRoberts,1610612766,CHA,77,38,39,2329.0,84,42,41,0.5,214,0.393,5,0.402,8.3,284,98,187,0.345,666,0.426,68,0.475,5.8,368,140,228,0.38,880,0.418,73,0.456,6.4,2013-14,Regular%20Season
2694,Josh Powell,1610612745,HOU,1,0,1,19.0,0,0,0,0.0,3,0.0,0,0.0,0.0,5,3,2,0.6,6,0.833,0,0.833,7.7,5,3,2,0.6,9,0.556,0,0.556,7.7,2013-14,Regular%20Season
2746,Josh Smith,1610612765,DET,75,27,48,2684.0,102,63,38,0.618,310,0.329,13,0.343,6.8,418,145,271,0.347,720,0.581,70,0.643,6.2,520,208,309,0.4,1030,0.505,83,0.549,6.3,2013-14,Regular%20Season
201950,Jrue Holiday,1610612740,NOP,32,14,18,1079.0,28,14,14,0.5,94,0.298,8,0.326,11.5,114,19,96,0.167,203,0.562,19,0.62,9.0,142,33,110,0.232,297,0.478,27,0.526,9.5,2013-14,Regular%20Season
202933,Julyan Stone,1610612761,TOR,9,5,4,85.0,2,2,0,1.0,7,0.286,0,0.286,6.7,18,1,17,0.056,25,0.72,1,0.75,6.1,20,3,17,0.15,32,0.625,1,0.645,6.2,2013-14,Regular%20Season
203120,Justin Hamilton,1610612748,MIA,4,2,2,50.0,4,3,0,0.75,9,0.444,0,0.444,6.3,3,2,1,0.667,12,0.25,3,0.333,5.6,7,5,1,0.714,21,0.333,3,0.389,5.9,2013-14,Regular%20Season
202695,Kawhi Leonard,1610612759,SAS,66,54,12,1923.0,76,50,23,0.658,173,0.439,4,0.45,8.1,336,102,233,0.304,545,0.617,45,0.672,6.4,412,152,256,0.369,718,0.574,49,0.616,6.7,2013-14,Regular%20Season
2586,Keith Bogans,1610612738,BOS,3,1,2,34.0,0,0,0,0.0,0,0.0,0,0.0,0.0,3,1,2,0.333,5,0.6,0,0.6,6.8,3,1,2,0.333,5,0.6,0,0.6,6.8,2013-14,Regular%20Season
203482,Kelly Olynyk,1610612738,BOS,69,18,51,1384.0,140,91,44,0.65,333,0.42,16,0.442,6.7,225,58,162,0.258,399,0.564,42,0.63,5.2,365,149,206,0.408,732,0.499,58,0.542,5.7,2013-14,Regular%20Season
202689,Kemba Walker,1610612766,CHA,70,35,35,2532.0,39,14,26,0.359,188,0.207,9,0.218,12.5,264,38,229,0.144,540,0.489,59,0.549,9.5,303,52,255,0.172,728,0.416,68,0.459,9.9,2013-14,Regular%20Season
203088,Kendall Marshall,1610612747,LAL,49,13,36,1475.0,15,4,10,0.267,75,0.2,1,0.203,11.9,140,16,126,0.114,260,0.538,13,0.567,11.7,155,20,136,0.129,335,0.463,14,0.483,11.8,2013-14,Regular%20Season
2570,Kendrick Perkins,1610612760,OKC,61,47,14,1202.0,82,58,23,0.707,220,0.373,6,0.383,5.1,223,57,165,0.256,398,0.56,36,0.616,4.6,305,115,188,0.377,618,0.494,42,0.53,4.7,2013-14,Regular%20Season
202702,Kenneth Faried,1610612743,DEN,79,36,43,2175.0,238,169,61,0.71,614,0.388,20,0.401,5.2,446,160,284,0.359,757,0.589,63,0.643,4.7,684,329,345,0.481,1371,0.499,83,0.531,4.9,2013-14,Regular%20Season
203145,Kent Bazemore,1610612747,LAL,39,22,17,756.0,10,4,6,0.4,54,0.185,4,0.2,9.6,107,22,85,0.206,203,0.527,18,0.578,7.2,117,26,91,0.222,257,0.455,22,0.498,7.4,2013-14,Regular%20Season
203484,Kentavious Caldwell-Pope,1610612765,DET,58,20,38,1345.0,38,16,20,0.421,115,0.33,5,0.345,10.5,118,17,101,0.144,215,0.549,21,0.608,8.3,156,33,121,0.212,330,0.473,26,0.513,8.8,2013-14,Regular%20Season
2030,Kenyon Martin,1610612752,NYK,29,12,17,608.0,36,24,12,0.667,71,0.507,3,0.529,5.7,98,37,61,0.378,168,0.583,17,0.649,6.1,134,61,73,0.455,239,0.561,20,0.612,6.0,2013-14,Regular%20Season
201142,Kevin Durant,1610612760,OKC,81,58,23,3122.0,58,25,31,0.431,172,0.337,8,0.354,13.9,540,116,419,0.215,748,0.722,33,0.755,6.9,598,141,450,0.236,920,0.65,41,0.68,7.6,2013-14,Regular%20Season
708,Kevin Garnett,1610612751,BKN,53,26,27,1090.0,60,30,28,0.5,108,0.556,4,0.577,8.0,295,95,198,0.322,449,0.657,28,0.701,4.5,355,125,226,0.352,557,0.637,32,0.676,5.1,2013-14,Regular%20Season
201567,Kevin Love,1610612750,MIN,77,39,38,2796.0,224,184,40,0.821,534,0.419,11,0.428,4.7,739,300,431,0.406,1109,0.666,75,0.715,3.9,963,484,471,0.503,1643,0.586,86,0.618,4.1,2013-14,Regular%20Season
2755,Kevin Martin,1610612750,MIN,65,31,34,2091.0,34,13,20,0.382,181,0.188,7,0.195,11.8,169,22,148,0.13,286,0.591,29,0.658,8.6,203,35,168,0.172,467,0.435,36,0.471,9.2,2013-14,Regular%20Season
202338,Kevin Seraphin,1610612764,WAS,42,17,25,542.0,53,37,16,0.698,137,0.387,7,0.408,6.8,75,28,47,0.373,164,0.457,20,0.521,5.0,128,65,63,0.508,301,0.425,27,0.467,5.8,2013-14,Regular%20Season
203114,Khris Middleton,1610612749,MIL,76,13,63,2342.0,60,31,29,0.517,190,0.316,6,0.326,11.8,248,54,194,0.218,450,0.551,31,0.592,7.3,308,85,223,0.276,640,0.481,37,0.511,8.2,2013-14,Regular%20Season
2550,Kirk Hinrich,1610612741,CHI,68,41,27,2000.0,31,10,24,0.323,139,0.223,7,0.235,17.6,159,17,141,0.107,332,0.479,35,0.535,9.8,190,27,165,0.142,471,0.403,42,0.443,11.3,2013-14,Regular%20Season
202691,Klay Thompson,1610612744,GSW,79,50,29,2787.0,38,15,19,0.395,166,0.229,10,0.244,13.0,209,35,175,0.167,458,0.456,53,0.516,8.3,247,50,194,0.202,624,0.396,63,0.44,8.9,2013-14,Regular%20Season
977,Kobe Bryant,1610612747,LAL,6,2,4,177.0,2,1,1,0.5,13,0.154,0,0.154,7.3,24,4,20,0.167,45,0.533,4,0.585,5.7,26,5,21,0.192,58,0.448,4,0.481,5.8,2013-14,Regular%20Season
201585,Kosta Koufos,1610612763,MEM,76,46,30,1313.0,160,98,63,0.613,359,0.446,18,0.469,5.7,258,103,152,0.399,455,0.567,40,0.622,4.1,418,201,215,0.481,814,0.514,58,0.553,4.7,2013-14,Regular%20Season
2743,Kris Humphries,1610612738,BOS,66,20,46,1359.0,127,83,40,0.654,349,0.364,11,0.376,7.1,282,107,174,0.379,493,0.572,32,0.612,4.6,409,190,214,0.465,842,0.486,43,0.512,5.4,2013-14,Regular%20Season
2594,Kyle Korver,1610612737,ATL,69,37,32,2354.0,22,4,17,0.182,109,0.202,2,0.206,19.6,260,67,193,0.258,540,0.481,53,0.534,6.5,282,71,210,0.252,649,0.435,55,0.475,7.5,2013-14,Regular%20Season
200768,Kyle Lowry,1610612761,TOR,77,44,33,2790.0,87,49,35,0.563,326,0.267,11,0.276,9.8,276,43,235,0.156,592,0.466,52,0.511,8.9,363,92,270,0.253,918,0.395,63,0.425,9.1,2013-14,Regular%20Season
203124,Kyle O'Quinn,1610612753,ORL,64,19,45,1168.0,100,62,32,0.62,197,0.508,5,0.521,6.5,264,92,168,0.348,467,0.565,35,0.611,4.3,364,154,200,0.423,664,0.548,40,0.583,4.9,2013-14,Regular%20Season
202713,Kyle Singler,1610612765,DET,76,27,49,2174.0,116,55,60,0.474,341,0.34,14,0.355,9.5,187,62,128,0.332,481,0.389,53,0.437,6.9,303,117,188,0.386,822,0.369,67,0.401,7.9,2013-14,Regular%20Season
202681,Kyrie Irving,1610612739,CLE,68,28,40,2409.0,52,17,34,0.327,229,0.227,7,0.234,13.9,207,36,175,0.174,433,0.478,35,0.52,10.7,259,53,209,0.205,662,0.391,42,0.418,11.3,2013-14,Regular%20Season
200746,LaMarcus Aldridge,1610612757,POR,69,46,23,2499.0,166,100,61,0.602,413,0.402,19,0.421,7.1,599,197,403,0.329,946,0.633,70,0.684,5.0,765,297,464,0.388,1359,0.563,89,0.602,5.4,2013-14,Regular%20Season
202362,Lance Stephenson,1610612754,IND,78,53,25,2752.0,95,46,48,0.484,286,0.332,8,0.342,8.5,463,91,370,0.197,744,0.622,48,0.665,6.3,558,137,418,0.246,1030,0.542,56,0.573,6.7,2013-14,Regular%20Season
202498,Lance Thomas,1610612740,NOP,4,2,2,38.0,2,2,0,1.0,12,0.167,0,0.167,6.4,5,2,3,0.4,8,0.625,1,0.714,4.2,7,4,3,0.571,20,0.35,1,0.368,4.8,2013-14,Regular%20Season
202361,Landry Fields,1610612761,TOR,16,7,9,250.0,14,8,5,0.571,46,0.304,3,0.326,7.5,40,6,32,0.15,55,0.727,6,0.816,7.1,54,14,37,0.259,101,0.535,9,0.587,7.2,2013-14,Regular%20Season
202336,Larry Sanders,1610612749,MIL,22,3,19,563.0,59,42,17,0.712,141,0.418,5,0.434,5.5,102,42,58,0.412,190,0.537,18,0.593,4.8,161,84,75,0.522,331,0.486,23,0.523,5.0,2013-14,Regular%20Season
202730,Lavoy Allen,1610612754,IND,59,18,41,1061.0,119,70,43,0.588,273,0.436,10,0.452,5.9,192,68,120,0.354,369,0.52,43,0.589,4.8,311,138,163,0.444,642,0.484,53,0.528,5.2,2013-14,Regular%20Season
2544,LeBron James,1610612748,MIA,77,52,25,2902.0,81,46,33,0.568,221,0.367,4,0.373,8.0,452,88,357,0.195,651,0.694,29,0.727,7.1,533,134,390,0.251,872,0.611,33,0.635,7.3,2013-14,Regular%20Season
2571,Leandro Barbosa,1610612756,PHX,18,10,8,337.0,5,2,3,0.4,21,0.238,3,0.278,14.6,31,6,24,0.194,44,0.705,2,0.738,9.8,36,8,27,0.222,65,0.554,5,0.6,10.5,2013-14,Regular%20Season
203485,Lorenzo Brown,1610612755,PHI,14,2,12,135.0,8,2,6,0.25,18,0.444,0,0.444,9.9,20,3,17,0.15,27,0.741,2,0.8,9.5,28,5,23,0.179,45,0.622,2,0.651,9.6,2013-14,Regular%20Season
200811,Lou Amundson,1610612741,CHI,15,8,7,157.0,28,21,8,0.75,55,0.509,1,0.519,7.1,27,6,20,0.222,53,0.509,4,0.551,7.2,55,27,28,0.491,108,0.509,5,0.534,7.1,2013-14,Regular%20Season
101150,Lou Williams,1610612737,ATL,46,20,26,1132.0,10,2,7,0.2,65,0.154,6,0.169,14.5,110,13,99,0.118,193,0.57,16,0.621,9.0,120,15,106,0.125,258,0.465,22,0.508,9.4,2013-14,Regular%20Season
201601,Luc Mbah a Moute,1610612750,MIN,52,22,30,931.0,56,42,11,0.75,144,0.389,6,0.406,5.4,90,32,58,0.356,179,0.503,17,0.556,6.3,146,74,69,0.507,323,0.452,23,0.487,6.0,2013-14,Regular%20Season
2449,Luis Scola,1610612754,IND,81,56,25,1383.0,86,50,36,0.581,271,0.317,9,0.328,6.8,305,90,212,0.295,512,0.596,51,0.662,4.4,391,140,248,0.358,783,0.499,60,0.541,5.0,2013-14,Regular%20Season
202337,Luke Babbitt,1610612740,NOP,27,9,18,473.0,18,11,6,0.611,53,0.34,2,0.353,6.7,70,18,52,0.257,135,0.519,19,0.603,5.1,88,29,58,0.33,188,0.468,21,0.527,5.4,2013-14,Regular%20Season
2557,Luke Ridnour,1610612766,CHA,45,17,28,920.0,23,6,16,0.261,51,0.451,3,0.479,13.2,74,12,63,0.162,133,0.556,5,0.578,10.1,97,18,79,0.186,184,0.527,8,0.551,10.8,2013-14,Regular%20Season
2736,Luol Deng,1610612739,CLE,63,29,34,2213.0,99,52,46,0.525,310,0.319,9,0.329,9.7,262,62,199,0.237,434,0.604,28,0.645,7.5,361,114,245,0.316,744,0.485,37,0.511,8.1,2013-14,Regular%20Season
203146,Maalik Wayns,1610612746,LAC,1,1,0,6.0,0,0,0,0.0,0,0.0,0,0.0,0.0,2,0,2,0.0,3,0.667,0,0.667,13.0,2,0,2,0.0,3,0.667,0,0.667,13.0,2013-14,Regular%20Season
202952,Malcolm Thomas,1610612762,UTA,6,2,4,59.0,5,2,3,0.4,7,0.714,0,0.714,4.6,16,2,14,0.125,26,0.615,1,0.64,6.3,21,4,17,0.19,33,0.636,1,0.656,5.9,2013-14,Regular%20Season
202412,Manny Harris,1610612747,LAL,8,2,6,160.0,7,4,3,0.571,30,0.233,0,0.233,9.6,27,6,21,0.222,44,0.614,5,0.692,7.4,34,10,24,0.294,74,0.459,5,0.493,7.8,2013-14,Regular%20Season
1938,Manu Ginobili,1610612759,SAS,65,49,16,1483.0,30,17,13,0.567,118,0.254,5,0.265,8.6,172,38,134,0.221,326,0.528,25,0.571,7.0,202,55,147,0.272,444,0.455,30,0.488,7.2,2013-14,Regular%20Season
202705,MarShon Brooks,1610612747,LAL,24,8,16,277.0,10,7,3,0.7,40,0.25,0,0.25,4.6,44,8,36,0.182,61,0.721,5,0.786,8.1,54,15,39,0.278,101,0.535,5,0.563,7.4,2013-14,Regular%20Season
201188,Marc Gasol,1610612763,MEM,59,40,19,1970.0,84,42,38,0.5,207,0.406,6,0.418,7.7,340,140,198,0.412,593,0.573,57,0.634,5.0,424,182,236,0.429,800,0.53,63,0.575,5.5,2013-14,Regular%20Season
101162,Marcin Gortat,1610612764,WAS,80,44,36,2620.0,201,112,84,0.557,547,0.367,14,0.377,6.1,556,187,364,0.336,1017,0.547,116,0.617,4.3,757,299,448,0.395,1564,0.484,130,0.528,4.8,2013-14,Regular%20Season
201158,Marco Belinelli,1610612759,SAS,74,57,17,1901.0,18,6,12,0.333,93,0.194,6,0.207,10.8,208,31,176,0.149,402,0.517,31,0.561,7.2,226,37,188,0.164,495,0.457,37,0.493,7.5,2013-14,Regular%20Season
202694,Marcus Morris Sr.,1610612756,PHX,79,46,33,1757.0,84,47,37,0.56,204,0.412,8,0.429,8.2,235,70,162,0.298,431,0.545,43,0.606,5.3,319,117,199,0.367,635,0.502,51,0.546,6.0,2013-14,Regular%20Season
201977,Marcus Thornton,1610612751,BKN,63,29,34,1548.0,57,24,32,0.421,165,0.345,12,0.373,10.1,141,20,122,0.142,270,0.522,27,0.58,8.9,198,44,154,0.222,435,0.455,39,0.5,9.3,2013-14,Regular%20Season
201596,Mario Chalmers,1610612748,MIA,68,45,23,2058.0,41,17,24,0.415,145,0.283,7,0.297,13.6,173,20,152,0.116,398,0.435,42,0.486,9.8,214,37,176,0.173,543,0.394,49,0.433,10.5,2013-14,Regular%20Season
202693,Markieff Morris,1610612756,PHX,80,47,33,2142.0,139,85,51,0.612,333,0.417,18,0.441,6.3,346,107,228,0.309,591,0.585,47,0.636,5.6,485,192,279,0.396,924,0.525,65,0.565,5.8,2013-14,Regular%20Season
203104,Marquis Teague,1610612751,BKN,21,9,12,329.0,1,0,1,0.0,38,0.026,5,0.03,21.8,38,4,34,0.105,56,0.679,1,0.691,10.4,39,4,35,0.103,94,0.415,6,0.443,10.7,2013-14,Regular%20Season
201578,Marreese Speights,1610612744,GSW,69,42,27,940.0,100,67,26,0.67,226,0.442,4,0.45,5.5,187,64,123,0.342,326,0.574,34,0.64,4.4,287,131,149,0.456,552,0.52,38,0.558,4.7,2013-14,Regular%20Season
101110,Martell Webster,1610612764,WAS,71,37,34,2020.0,37,13,23,0.351,106,0.349,10,0.385,13.8,181,48,135,0.265,341,0.531,30,0.582,6.6,218,61,158,0.28,447,0.488,40,0.536,7.8,2013-14,Regular%20Season
101107,Marvin Williams,1610612762,UTA,65,24,41,1666.0,82,41,40,0.5,179,0.458,3,0.466,8.2,252,75,174,0.298,436,0.578,38,0.633,5.8,334,116,214,0.347,615,0.543,41,0.582,6.3,2013-14,Regular%20Season
203486,Mason Plumlee,1610612751,BKN,59,30,29,1185.0,99,60,36,0.606,248,0.399,5,0.407,5.8,209,64,141,0.306,370,0.565,30,0.615,4.5,308,124,177,0.403,618,0.498,35,0.528,4.9,2013-14,Regular%20Season
2440,Matt Barnes,1610612746,LAC,63,45,18,1735.0,60,19,38,0.317,171,0.351,6,0.364,10.2,232,57,175,0.246,428,0.542,39,0.596,6.3,292,76,213,0.26,599,0.487,45,0.527,7.1,2013-14,Regular%20Season
2588,Matt Bonner,1610612759,SAS,48,33,15,583.0,16,8,9,0.5,43,0.372,0,0.372,9.4,114,34,81,0.298,206,0.553,20,0.613,6.0,130,42,90,0.323,249,0.522,20,0.568,6.4,2013-14,Regular%20Season
203521,Matthew Dellavedova,1610612739,CLE,55,21,34,1118.0,28,7,21,0.25,96,0.292,3,0.301,13.9,94,11,83,0.117,209,0.45,22,0.503,10.1,122,18,104,0.148,305,0.4,25,0.436,11.1,2013-14,Regular%20Season
203090,Maurice Harkless,1610612753,ORL,72,20,52,1835.0,69,39,29,0.565,182,0.379,12,0.406,7.7,195,40,156,0.205,341,0.572,33,0.633,7.4,264,79,185,0.299,523,0.505,45,0.552,7.5,2013-14,Regular%20Season
2408,Melvin Ely,1610612740,NOP,1,1,0,10.0,0,0,0,0.0,0,0.0,0,0.0,0.0,1,0,1,0.0,1,1.0,0,1.0,12.8,1,0,1,0.0,1,1.0,0,1.0,12.8,2013-14,Regular%20Season
1897,Metta World Peace,1610612752,NYK,23,10,13,365.0,18,8,9,0.444,54,0.333,2,0.346,6.2,41,15,25,0.366,71,0.577,6,0.631,5.8,59,23,34,0.39,125,0.472,8,0.504,5.9,2013-14,Regular%20Season
203086,Meyers Leonard,1610612757,POR,29,14,15,315.0,26,11,15,0.423,73,0.356,2,0.366,7.2,85,25,60,0.294,133,0.639,10,0.691,4.4,111,36,75,0.324,206,0.539,12,0.572,5.1,2013-14,Regular%20Season
201563,Michael Beasley,1610612748,MIA,46,30,16,791.0,31,20,11,0.645,82,0.378,1,0.383,7.6,141,35,103,0.248,243,0.58,20,0.632,5.2,172,55,114,0.32,325,0.529,21,0.566,5.6,2013-14,Regular%20Season
203487,Michael Carter-Williams,1610612755,PHI,70,18,52,2414.0,101,58,38,0.574,401,0.252,20,0.265,6.3,336,83,250,0.247,591,0.569,38,0.608,6.8,437,141,288,0.323,992,0.441,58,0.468,6.7,2013-14,Regular%20Season
203077,Michael Kidd-Gilchrist,1610612766,CHA,59,33,26,1428.0,106,69,37,0.651,279,0.38,9,0.393,7.8,206,65,139,0.316,390,0.528,36,0.582,6.0,312,134,176,0.429,669,0.466,45,0.5,6.6,2013-14,Regular%20Season
201144,Mike Conley,1610612763,MEM,67,45,22,2243.0,41,16,25,0.39,163,0.252,11,0.27,13.9,172,24,148,0.14,340,0.506,39,0.571,9.2,213,40,173,0.188,503,0.423,50,0.47,10.2,2013-14,Regular%20Season
2399,Mike Dunleavy,1610612741,CHI,80,47,33,2521.0,46,29,18,0.63,204,0.225,4,0.23,8.0,299,77,222,0.258,633,0.472,68,0.529,6.7,345,106,240,0.307,837,0.412,72,0.451,6.9,2013-14,Regular%20Season
200839,Mike Harris,1610612762,UTA,14,0,14,172.0,15,11,4,0.733,39,0.385,3,0.417,6.8,18,4,14,0.222,46,0.391,8,0.474,6.7,33,15,18,0.455,85,0.388,11,0.446,6.7,2013-14,Regular%20Season
2229,Mike James,1610612741,CHI,5,2,3,54.0,0,0,0,0.0,1,0.0,0,0.0,0.0,7,1,6,0.143,8,0.875,0,0.875,8.6,7,1,6,0.143,9,0.778,0,0.778,8.6,2013-14,Regular%20Season
2034,Mike Miller,1610612763,MEM,75,49,26,1591.0,30,11,20,0.367,101,0.297,4,0.309,12.2,177,34,142,0.192,294,0.602,22,0.651,6.0,207,45,162,0.217,395,0.524,26,0.561,6.9,2013-14,Regular%20Season
203488,Mike Muscala,1610612737,ATL,19,9,10,213.0,17,12,5,0.706,54,0.315,1,0.321,5.9,35,11,24,0.314,66,0.53,7,0.593,4.6,52,23,29,0.442,120,0.433,8,0.464,5.0,2013-14,Regular%20Season
203118,Mike Scott,1610612737,ATL,75,33,42,1420.0,60,36,24,0.6,220,0.273,5,0.279,5.9,220,72,146,0.327,352,0.625,27,0.677,5.9,280,108,170,0.386,572,0.49,32,0.519,6.0,2013-14,Regular%20Season
203101,Miles Plumlee,1610612756,PHX,80,47,33,1964.0,198,127,68,0.641,457,0.433,7,0.44,6.3,428,162,264,0.379,768,0.557,74,0.617,3.9,626,289,332,0.462,1225,0.511,81,0.547,4.7,2013-14,Regular%20Season
203545,Miroslav Raduljica,1610612749,MIL,41,6,35,437.0,54,37,16,0.685,108,0.5,9,0.545,5.7,54,22,33,0.407,130,0.415,10,0.45,5.7,108,59,49,0.546,238,0.454,19,0.493,5.7,2013-14,Regular%20Season
203141,Mirza Teletovic,1610612751,BKN,65,39,26,1298.0,60,28,27,0.467,138,0.435,3,0.444,8.9,201,66,134,0.328,359,0.56,26,0.604,5.9,261,94,161,0.36,497,0.525,29,0.558,6.6,2013-14,Regular%20Season
2590,Mo Williams,1610612757,POR,63,42,21,1583.0,41,10,32,0.244,115,0.357,3,0.366,14.8,111,11,98,0.099,260,0.427,30,0.483,9.7,152,21,130,0.138,375,0.405,33,0.444,11.2,2013-14,Regular%20Season
101145,Monta Ellis,1610612742,DAL,80,48,32,2949.0,38,17,21,0.447,196,0.194,13,0.208,11.1,257,44,211,0.171,459,0.56,41,0.615,9.9,295,61,232,0.207,655,0.45,54,0.491,10.1,2013-14,Regular%20Season
201986,Nando De Colo,1610612761,TOR,35,26,9,441.0,14,6,7,0.429,43,0.326,2,0.341,12.8,59,11,48,0.186,114,0.518,8,0.557,6.3,73,17,55,0.233,157,0.465,10,0.497,7.4,2013-14,Regular%20Season
101126,Nate Robinson,1610612743,DEN,36,19,17,744.0,20,3,16,0.15,65,0.308,4,0.328,8.8,60,4,57,0.067,123,0.488,6,0.513,10.6,80,7,73,0.088,188,0.426,10,0.449,10.2,2013-14,Regular%20Season
203489,Nate Wolters,1610612749,MIL,51,10,41,1203.0,33,15,18,0.455,119,0.277,2,0.282,11.4,112,17,95,0.152,229,0.489,24,0.546,8.3,145,32,113,0.221,348,0.417,26,0.45,9.0,2013-14,Regular%20Season
1737,Nazr Mohammed,1610612741,CHI,67,40,27,498.0,66,40,22,0.606,131,0.504,2,0.512,5.6,109,40,65,0.367,175,0.623,14,0.677,5.4,175,80,87,0.457,306,0.572,16,0.603,5.5,2013-14,Regular%20Season
203517,Nemanja Nedovic,1610612744,GSW,9,4,5,80.0,3,0,3,0.0,5,0.6,0,0.6,22.7,11,1,10,0.091,21,0.524,2,0.579,11.4,14,1,13,0.071,26,0.538,2,0.583,13.8,2013-14,Regular%20Season
2403,Nene,1610612764,WAS,52,30,22,1543.0,65,35,24,0.538,246,0.264,12,0.278,7.7,229,78,151,0.341,448,0.511,42,0.564,6.2,294,113,175,0.384,694,0.424,54,0.459,6.5,2013-14,Regular%20Season
201979,Nick Calathes,1610612763,MEM,56,33,23,1009.0,23,7,16,0.304,86,0.267,3,0.277,11.4,114,28,87,0.246,225,0.507,18,0.551,10.3,137,35,103,0.255,311,0.441,21,0.472,10.5,2013-14,Regular%20Season
2555,Nick Collison,1610612760,OKC,76,55,21,1297.0,116,71,43,0.612,255,0.455,6,0.466,5.9,177,76,98,0.429,380,0.466,49,0.535,5.3,293,147,141,0.502,635,0.461,55,0.505,5.6,2013-14,Regular%20Season
201156,Nick Young,1610612747,LAL,60,19,41,1701.0,29,7,22,0.241,122,0.238,3,0.244,12.6,137,21,117,0.153,279,0.491,15,0.519,9.0,166,28,139,0.169,401,0.414,18,0.433,9.6,2013-14,Regular%20Season
201587,Nicolas Batum,1610612757,POR,82,54,28,2956.0,116,62,56,0.534,354,0.328,13,0.34,9.2,495,107,383,0.216,837,0.591,62,0.639,5.9,611,169,439,0.277,1191,0.513,75,0.547,6.5,2013-14,Regular%20Season
201593,Nikola Pekovic,1610612750,MIN,54,27,27,1663.0,206,143,56,0.694,498,0.414,11,0.423,4.5,262,100,161,0.382,465,0.563,40,0.616,5.2,468,243,217,0.519,963,0.486,51,0.513,4.9,2013-14,Regular%20Season
202696,Nikola Vucevic,1610612753,ORL,57,19,38,1812.0,185,129,53,0.697,391,0.473,7,0.482,5.5,441,141,297,0.32,709,0.622,52,0.671,4.1,626,270,350,0.431,1100,0.569,59,0.601,4.5,2013-14,Regular%20Season
202708,Norris Cole,1610612748,MIA,68,47,21,1697.0,17,4,12,0.235,81,0.21,4,0.221,17.1,143,18,127,0.126,302,0.474,30,0.526,9.5,160,22,139,0.138,383,0.418,34,0.458,10.3,2013-14,Regular%20Season
201564,O.J. Mayo,1610612749,MIL,39,6,33,1068.0,23,6,15,0.261,88,0.261,3,0.271,16.1,95,18,78,0.189,178,0.534,7,0.556,9.8,118,24,93,0.203,266,0.444,10,0.461,11.0,2013-14,Regular%20Season
203136,Ognjen Kuzmic,1610612744,GSW,10,10,0,70.0,10,8,2,0.8,21,0.476,1,0.5,4.4,11,5,6,0.455,24,0.458,2,0.5,3.7,21,13,8,0.619,45,0.467,3,0.5,4.0,2013-14,Regular%20Season
201600,Omer Asik,1610612745,HOU,47,32,15,964.0,101,84,16,0.832,244,0.414,5,0.423,3.8,277,124,150,0.448,428,0.647,33,0.701,4.2,378,208,166,0.55,672,0.563,38,0.596,4.1,2013-14,Regular%20Season
201956,Omri Casspi,1610612745,HOU,66,43,23,1229.0,55,21,34,0.382,176,0.313,5,0.322,7.9,204,50,153,0.245,376,0.543,33,0.595,5.8,259,71,187,0.274,552,0.469,38,0.504,6.2,2013-14,Regular%20Season
203111,Orlando Johnson,1610612758,SAC,26,19,7,314.0,9,7,2,0.778,41,0.22,2,0.231,7.7,46,9,37,0.196,86,0.535,13,0.63,7.2,55,16,39,0.291,127,0.433,15,0.491,7.3,2013-14,Regular%20Season
201785,Othyus Jeffers,1610612750,MIN,4,1,3,45.0,1,1,0,1.0,6,0.167,0,0.167,1.7,8,1,7,0.125,11,0.727,1,0.8,5.7,9,2,7,0.222,17,0.529,1,0.563,5.3,2013-14,Regular%20Season
203490,Otto Porter Jr.,1610612764,WAS,24,11,13,259.0,21,11,10,0.524,52,0.404,2,0.42,9.1,36,6,27,0.167,57,0.632,7,0.72,6.2,57,17,37,0.298,109,0.523,9,0.57,7.3,2013-14,Regular%20Season
200782,P.J. Tucker,1610612756,PHX,80,47,33,2464.0,160,95,59,0.594,434,0.369,12,0.379,7.5,368,66,295,0.179,530,0.694,38,0.748,6.9,528,161,354,0.305,964,0.548,50,0.578,7.1,2013-14,Regular%20Season
203143,Pablo Prigioni,1610612752,NYK,52,21,31,1086.0,36,14,21,0.389,104,0.346,6,0.367,12.5,93,7,87,0.075,186,0.5,6,0.517,10.3,129,21,108,0.163,290,0.445,12,0.464,10.9,2013-14,Regular%20Season
201976,Patrick Beverley,1610612745,HOU,51,35,16,1611.0,71,31,41,0.437,188,0.378,7,0.392,10.5,124,18,105,0.145,252,0.492,30,0.559,10.4,195,49,146,0.251,440,0.443,37,0.484,10.5,2013-14,Regular%20Season
202335,Patrick Patterson,1610612761,TOR,63,37,26,1502.0,114,67,45,0.588,243,0.469,9,0.487,6.9,221,83,135,0.376,401,0.551,30,0.596,5.0,335,150,180,0.448,644,0.52,39,0.554,5.7,2013-14,Regular%20Season
201988,Patty Mills,1610612759,SAS,69,53,16,1352.0,34,7,25,0.206,109,0.312,4,0.324,16.3,135,20,117,0.148,237,0.57,18,0.616,10.1,169,27,142,0.16,346,0.488,22,0.522,11.3,2013-14,Regular%20Season
2200,Pau Gasol,1610612747,LAL,60,21,39,1884.0,124,70,46,0.565,300,0.413,8,0.425,8.1,456,148,305,0.325,727,0.627,47,0.671,4.5,580,218,351,0.376,1027,0.565,55,0.597,5.2,2013-14,Regular%20Season
202331,Paul George,1610612754,IND,80,54,26,2898.0,64,32,32,0.5,305,0.21,9,0.216,12.9,478,79,394,0.165,751,0.636,53,0.685,6.1,542,111,426,0.205,1056,0.513,62,0.545,6.9,2013-14,Regular%20Season
200794,Paul Millsap,1610612737,ATL,73,36,37,2453.0,152,95,54,0.625,421,0.361,13,0.373,6.7,472,170,298,0.36,855,0.552,77,0.607,5.0,624,265,352,0.425,1276,0.489,90,0.526,5.5,2013-14,Regular%20Season
1718,Paul Pierce,1610612751,BKN,73,40,33,2070.0,26,11,13,0.423,122,0.213,5,0.222,11.8,319,103,213,0.323,569,0.561,52,0.617,6.6,345,114,226,0.33,691,0.499,57,0.544,6.9,2013-14,Regular%20Season
203544,Pero Antic,1610612737,ATL,45,21,24,866.0,56,32,23,0.571,130,0.431,3,0.441,5.4,147,54,93,0.367,265,0.555,23,0.607,5.2,203,86,116,0.424,395,0.514,26,0.55,5.2,2013-14,Regular%20Season
203103,Perry Jones III,1610612760,OKC,46,34,12,659.0,28,13,15,0.464,77,0.364,4,0.384,9.8,86,18,66,0.209,149,0.577,16,0.647,6.5,114,31,81,0.272,226,0.504,20,0.553,7.3,2013-14,Regular%20Season
203491,Peyton Siva,1610612765,DET,11,4,7,131.0,2,0,2,0.0,12,0.167,1,0.182,15.3,12,2,10,0.167,24,0.5,3,0.571,8.5,14,2,12,0.143,36,0.389,4,0.438,9.4,2013-14,Regular%20Season
203515,Phil Pressey,1610612738,BOS,53,19,34,886.0,20,6,14,0.3,80,0.25,4,0.263,11.9,85,6,80,0.071,163,0.521,12,0.563,10.4,105,12,94,0.114,243,0.432,16,0.463,10.7,2013-14,Regular%20Season
203112,Quincy Acy,1610612758,SAC,55,20,35,794.0,72,39,31,0.542,193,0.373,8,0.389,8.4,144,45,95,0.313,258,0.558,27,0.623,4.4,216,84,126,0.389,451,0.479,35,0.519,5.7,2013-14,Regular%20Season
203113,Quincy Miller,1610612743,DEN,45,17,28,771.0,36,17,15,0.472,116,0.31,3,0.319,8.8,111,29,85,0.261,212,0.524,24,0.59,6.2,147,46,100,0.313,328,0.448,27,0.488,6.8,2013-14,Regular%20Season
202347,Quincy Pondexter,1610612763,MEM,13,6,7,232.0,10,6,5,0.6,33,0.303,2,0.323,8.5,16,2,14,0.125,30,0.533,3,0.593,10.5,26,8,19,0.308,63,0.413,5,0.448,9.9,2013-14,Regular%20Season
200765,Rajon Rondo,1610612738,BOS,29,5,24,963.0,22,8,14,0.364,104,0.212,5,0.222,11.7,142,17,127,0.12,262,0.542,24,0.597,6.8,164,25,141,0.152,366,0.448,29,0.487,7.5,2013-14,Regular%20Season
201196,Ramon Sessions,1610612749,MIL,75,29,46,2012.0,38,12,28,0.316,172,0.221,7,0.23,12.8,165,14,149,0.085,276,0.598,19,0.642,10.9,203,26,177,0.128,448,0.453,26,0.481,11.2,2013-14,Regular%20Season
200751,Randy Foye,1610612743,DEN,72,33,39,2237.0,36,12,22,0.333,148,0.243,7,0.255,19.3,196,28,168,0.143,381,0.514,32,0.562,10.1,232,40,190,0.172,529,0.439,39,0.473,11.4,2013-14,Regular%20Season
1740,Rashard Lewis,1610612748,MIA,47,31,16,846.0,24,11,14,0.458,64,0.375,1,0.381,9.8,86,23,62,0.267,182,0.473,18,0.524,5.7,110,34,76,0.309,246,0.447,19,0.485,6.6,2013-14,Regular%20Season
2446,Rasual Butler,1610612754,IND,24,15,9,299.0,6,5,1,0.833,23,0.261,0,0.261,8.0,34,7,26,0.206,58,0.586,6,0.654,6.9,40,12,27,0.3,81,0.494,6,0.533,7.0,2013-14,Regular%20Season
951,Ray Allen,1610612748,MIA,66,44,22,1777.0,23,10,14,0.435,102,0.225,5,0.237,13.2,182,38,144,0.209,325,0.56,17,0.591,7.6,205,48,158,0.234,427,0.48,22,0.506,8.3,2013-14,Regular%20Season
203492,Ray McCallum,1610612758,SAC,31,10,21,788.0,18,6,11,0.333,67,0.269,3,0.281,14.4,61,9,54,0.148,125,0.488,12,0.54,10.8,79,15,65,0.19,192,0.411,15,0.446,11.6,2013-14,Regular%20Season
101109,Raymond Felton,1610612752,NYK,62,31,31,1931.0,54,22,32,0.407,187,0.289,12,0.309,11.5,143,29,113,0.203,329,0.435,30,0.478,10.4,197,51,145,0.259,516,0.382,42,0.416,10.7,2013-14,Regular%20Season
203493,Reggie Bullock Jr.,1610612746,LAC,28,22,6,341.0,11,5,6,0.455,21,0.524,1,0.55,12.7,42,11,30,0.262,81,0.519,6,0.56,7.3,53,16,36,0.302,102,0.52,7,0.558,8.4,2013-14,Regular%20Season
2501,Reggie Evans,1610612758,SAC,51,16,35,876.0,115,85,27,0.739,322,0.357,11,0.37,6.0,219,67,150,0.306,351,0.624,28,0.678,4.3,334,152,177,0.455,673,0.496,39,0.527,4.8,2013-14,Regular%20Season
202704,Reggie Jackson,1610612760,OKC,78,56,22,2231.0,43,16,28,0.372,168,0.256,6,0.265,13.4,270,52,217,0.193,495,0.545,51,0.608,7.6,313,68,245,0.217,663,0.472,57,0.517,8.4,2013-14,Regular%20Season
2210,Richard Jefferson,1610612762,UTA,78,25,53,2125.0,18,6,15,0.333,131,0.137,4,0.142,14.2,199,27,171,0.136,379,0.525,35,0.578,7.4,217,33,186,0.152,510,0.425,39,0.461,8.1,2013-14,Regular%20Season
203495,Ricky Ledo,1610612742,DAL,1,0,1,2.0,0,0,0,0.0,0,0.0,0,0.0,0.0,2,2,0,1.0,2,1.0,0,1.0,1.2,2,2,0,1.0,2,1.0,0,1.0,1.2,2013-14,Regular%20Season
201937,Ricky Rubio,1610612750,MIN,81,39,42,2605.0,60,21,38,0.35,315,0.19,10,0.197,14.3,281,58,224,0.206,501,0.561,38,0.607,9.0,341,79,262,0.232,816,0.418,48,0.444,9.9,2013-14,Regular%20Season
203133,Robbie Hummel,1610612750,MIN,40,17,23,592.0,35,14,20,0.4,82,0.427,2,0.438,11.2,97,25,71,0.258,165,0.588,15,0.647,4.9,132,39,91,0.295,247,0.534,17,0.574,6.5,2013-14,Regular%20Season
203496,Robert Covington,1610612745,HOU,4,1,3,22.0,2,1,1,0.5,3,0.667,0,0.667,3.3,3,1,2,0.333,10,0.3,1,0.333,4.8,5,2,3,0.4,13,0.385,1,0.417,4.2,2013-14,Regular%20Season
203135,Robert Sacre,1610612747,LAL,60,19,41,1027.0,81,40,43,0.494,196,0.413,7,0.429,5.4,172,65,106,0.378,372,0.462,32,0.506,4.9,253,105,149,0.415,568,0.445,39,0.478,5.1,2013-14,Regular%20Season
201577,Robin Lopez,1610612757,POR,82,54,28,2604.0,326,232,85,0.712,811,0.402,24,0.414,5.0,374,153,213,0.409,839,0.446,94,0.502,5.3,700,385,298,0.55,1650,0.424,118,0.457,5.2,2013-14,Regular%20Season
201155,Rodney Stuckey,1610612765,DET,63,22,41,1759.0,39,17,22,0.436,150,0.26,4,0.267,12.5,130,29,102,0.223,246,0.528,19,0.573,9.1,169,46,124,0.272,396,0.427,23,0.453,9.9,2013-14,Regular%20Season
2427,Roger Mason Jr.,1610612748,MIA,11,8,3,149.0,1,0,1,0.0,3,0.333,0,0.333,29.1,21,5,16,0.238,29,0.724,2,0.778,11.4,22,5,17,0.227,32,0.688,2,0.733,12.2,2013-14,Regular%20Season
200758,Ronnie Brewer,1610612741,CHI,9,6,3,111.0,2,0,2,0.0,9,0.222,0,0.222,17.0,12,5,7,0.417,26,0.462,2,0.5,5.8,14,5,9,0.357,35,0.4,2,0.424,7.4,2013-14,Regular%20Season
101179,Ronnie Price,1610612753,ORL,18,5,13,253.0,8,4,5,0.5,22,0.364,0,0.364,13.4,35,3,33,0.086,64,0.547,2,0.565,10.4,43,7,38,0.163,86,0.5,2,0.512,11.0,2013-14,Regular%20Season
101142,Ronny Turiaf,1610612750,MIN,30,15,15,603.0,55,37,17,0.673,117,0.47,3,0.482,6.1,119,47,66,0.395,223,0.534,31,0.62,3.9,174,84,83,0.483,340,0.512,34,0.569,4.6,2013-14,Regular%20Season
201579,Roy Hibbert,1610612754,IND,79,55,24,2379.0,202,141,55,0.698,565,0.358,9,0.363,5.0,336,138,193,0.411,757,0.444,82,0.498,5.2,538,279,248,0.519,1322,0.407,91,0.437,5.1,2013-14,Regular%20Season
2767,Royal Ivey,1610612760,OKC,1,1,0,2.0,0,0,0,0.0,0,0.0,0,0.0,0.0,1,0,1,0.0,1,1.0,0,1.0,17.8,1,0,1,0.0,1,1.0,0,1.0,17.8,2013-14,Regular%20Season
200752,Rudy Gay,1610612758,SAC,70,26,44,2460.0,111,62,43,0.559,366,0.303,10,0.312,8.1,311,77,232,0.248,534,0.582,50,0.643,6.5,422,139,275,0.329,900,0.469,60,0.502,6.9,2013-14,Regular%20Season
203497,Rudy Gobert,1610612762,UTA,37,6,31,400.0,51,33,18,0.647,117,0.436,5,0.455,5.8,104,33,70,0.317,177,0.588,13,0.634,4.8,155,66,88,0.426,294,0.527,18,0.562,5.1,2013-14,Regular%20Season
201566,Russell Westbrook,1610612760,OKC,46,34,12,1412.0,55,21,35,0.382,190,0.289,5,0.297,9.8,208,45,163,0.216,337,0.617,21,0.658,8.2,263,66,198,0.251,527,0.499,26,0.525,8.6,2013-14,Regular%20Season
201583,Ryan Anderson,1610612740,NOP,22,12,10,795.0,66,42,19,0.636,157,0.42,10,0.449,4.9,76,33,44,0.434,183,0.415,23,0.475,5.3,142,75,63,0.528,340,0.418,33,0.463,5.1,2013-14,Regular%20Season
101155,Ryan Gomes,1610612760,OKC,4,3,1,28.0,0,0,0,0.0,2,0.0,0,0.0,0.0,4,1,3,0.25,6,0.667,0,0.667,6.8,4,1,3,0.25,8,0.5,0,0.5,6.8,2013-14,Regular%20Season
200797,Ryan Hollins,1610612746,LAC,48,34,14,420.0,31,22,9,0.71,101,0.307,1,0.31,5.7,59,23,38,0.39,139,0.424,13,0.468,5.6,90,45,47,0.5,240,0.375,14,0.398,5.6,2013-14,Regular%20Season
203527,Ryan Kelly,1610612747,LAL,57,15,42,1292.0,42,19,21,0.452,98,0.429,3,0.442,10.3,177,57,121,0.322,326,0.543,27,0.592,5.7,219,76,142,0.347,424,0.517,30,0.556,6.6,2013-14,Regular%20Season
2223,Samuel Dalembert,1610612742,DAL,80,48,32,1614.0,200,138,63,0.69,455,0.44,10,0.449,5.0,341,128,211,0.375,622,0.548,66,0.613,4.3,541,266,274,0.492,1077,0.502,76,0.54,4.6,2013-14,Regular%20Season
2756,Sasha Vujacic,1610612746,LAC,1,1,0,9.0,0,0,0,0.0,1,0.0,0,0.0,0.0,3,0,3,0.0,4,0.75,0,0.75,7.2,3,0,3,0.0,5,0.6,0,0.6,7.2,2013-14,Regular%20Season
201586,Serge Ibaka,1610612760,OKC,81,59,22,2666.0,224,147,73,0.656,484,0.463,16,0.479,5.9,485,200,284,0.412,940,0.516,107,0.582,4.2,709,347,357,0.489,1424,0.498,123,0.545,4.7,2013-14,Regular%20Season
203508,Sergey Karasev,1610612739,CLE,7,2,5,79.0,0,0,0,0.0,6,0.0,1,0.0,0.0,16,0,16,0.0,26,0.615,1,0.64,7.1,16,0,16,0.0,32,0.5,2,0.533,7.1,2013-14,Regular%20Season
203552,Seth Curry,1610612739,CLE,1,0,1,9.0,0,0,0,0.0,0,0.0,0,0.0,0.0,1,1,0,1.0,2,0.5,0,0.5,2.2,1,1,0,1.0,2,0.5,0,0.5,2.2,2013-14,Regular%20Season
203498,Shabazz Muhammad,1610612750,MIN,19,7,12,209.0,24,17,7,0.708,58,0.414,2,0.429,5.4,29,9,21,0.31,49,0.592,3,0.63,5.6,53,26,28,0.491,107,0.495,5,0.52,5.5,2013-14,Regular%20Season
2203,Shane Battier,1610612748,MIA,62,42,20,1288.0,33,17,15,0.515,82,0.402,2,0.413,8.1,104,39,64,0.375,337,0.309,43,0.354,6.7,137,56,79,0.409,419,0.327,45,0.366,7.2,2013-14,Regular%20Season
202197,Shane Edwards,1610612739,CLE,2,0,2,12.0,1,1,0,1.0,2,0.5,0,0.5,3.9,1,1,0,1.0,2,0.5,0,0.5,2.8,2,2,0,1.0,4,0.5,0,0.5,3.4,2013-14,Regular%20Season
203499,Shane Larkin,1610612742,DAL,23,13,10,325.0,10,2,8,0.2,22,0.455,0,0.455,15.8,31,6,25,0.194,58,0.534,3,0.564,9.7,41,8,33,0.195,80,0.513,3,0.532,11.2,2013-14,Regular%20Season
200769,Shannon Brown,1610612752,NYK,14,9,5,150.0,6,0,7,0.0,15,0.4,0,0.4,15.1,21,1,20,0.048,37,0.568,1,0.583,8.7,27,1,27,0.037,52,0.519,1,0.529,10.8,2013-14,Regular%20Season
2733,Shaun Livingston,1610612751,BKN,69,39,30,1859.0,65,25,42,0.385,179,0.363,8,0.38,10.1,176,43,137,0.244,348,0.506,21,0.538,8.3,241,68,179,0.282,527,0.457,29,0.484,8.8,2013-14,Regular%20Season
101183,Shavlik Randolph,1610612756,PHX,11,7,4,86.0,7,3,4,0.429,31,0.226,3,0.25,4.3,18,7,10,0.389,39,0.462,8,0.581,3.3,25,10,14,0.4,70,0.357,11,0.424,3.6,2013-14,Regular%20Season
1890,Shawn Marion,1610612742,DAL,76,44,32,2409.0,132,69,62,0.523,336,0.393,12,0.407,8.4,365,84,274,0.23,546,0.668,35,0.714,6.9,497,153,336,0.308,882,0.563,47,0.595,7.3,2013-14,Regular%20Season
200761,Shawne Williams,1610612747,LAL,34,14,20,720.0,25,11,15,0.44,76,0.329,1,0.333,10.7,142,48,92,0.338,252,0.563,13,0.594,5.1,167,59,107,0.353,328,0.509,14,0.532,6.0,2013-14,Regular%20Season
202714,Shelvin Mack,1610612737,ATL,60,29,31,1301.0,21,10,12,0.476,102,0.206,4,0.214,12.2,136,27,109,0.199,262,0.519,23,0.569,7.7,157,37,121,0.236,364,0.431,27,0.466,8.3,2013-14,Regular%20Season
203524,Solomon Hill,1610612754,IND,19,13,6,201.0,9,7,2,0.778,33,0.273,1,0.281,6.8,32,8,24,0.25,43,0.744,2,0.78,6.6,41,15,26,0.366,76,0.539,3,0.562,6.6,2013-14,Regular%20Season
200780,Solomon Jones,1610612753,ORL,5,1,4,56.0,8,5,3,0.625,14,0.571,0,0.571,8.7,8,3,5,0.375,17,0.471,2,0.533,5.4,16,8,8,0.5,31,0.516,2,0.552,7.1,2013-14,Regular%20Season
201150,Spencer Hawes,1610612739,CLE,80,26,54,2470.0,131,75,55,0.573,375,0.349,12,0.361,7.1,529,200,323,0.378,969,0.546,88,0.6,4.5,660,275,378,0.417,1344,0.491,100,0.531,4.9,2013-14,Regular%20Season
201939,Stephen Curry,1610612744,GSW,74,47,27,2703.0,46,14,37,0.304,195,0.236,9,0.247,16.5,285,52,238,0.182,525,0.543,37,0.584,9.2,331,66,275,0.199,720,0.46,46,0.491,10.4,2013-14,Regular%20Season
1536,Stephen Jackson,1610612746,LAC,4,2,2,59.0,2,1,1,0.5,5,0.4,0,0.4,10.3,8,3,5,0.375,14,0.571,1,0.615,6.7,10,4,6,0.4,19,0.526,1,0.556,7.4,2013-14,Regular%20Season
2581,Steve Blake,1610612744,GSW,51,29,22,1407.0,13,6,7,0.462,53,0.245,3,0.26,18.9,146,21,125,0.144,292,0.5,27,0.551,10.5,159,27,132,0.17,345,0.461,30,0.505,11.2,2013-14,Regular%20Season
959,Steve Nash,1610612747,LAL,13,4,9,284.0,4,0,5,0.0,18,0.222,1,0.235,11.4,25,3,22,0.12,49,0.51,3,0.543,10.7,29,3,27,0.103,67,0.433,4,0.46,11.2,2013-14,Regular%20Season
200779,Steve Novak,1610612761,TOR,32,14,18,408.0,7,1,7,0.143,13,0.538,0,0.538,9.9,50,19,31,0.38,101,0.495,2,0.505,7.3,57,20,38,0.351,114,0.5,2,0.509,7.9,2013-14,Regular%20Season
203500,Steven Adams,1610612760,OKC,75,56,19,1166.0,142,104,37,0.732,360,0.394,10,0.406,4.4,190,72,118,0.379,399,0.476,50,0.544,4.4,332,176,155,0.53,759,0.437,60,0.475,4.4,2013-14,Regular%20Season
201959,Taj Gibson,1610612741,CHI,82,48,34,2351.0,200,111,82,0.555,505,0.396,19,0.412,6.9,358,128,229,0.358,701,0.511,73,0.57,5.6,558,239,311,0.428,1206,0.463,92,0.501,6.1,2013-14,Regular%20Season
2419,Tayshaun Prince,1610612763,MEM,73,45,28,1872.0,32,15,17,0.469,146,0.219,1,0.221,9.7,202,60,141,0.297,338,0.598,24,0.643,7.2,234,75,158,0.321,484,0.483,25,0.51,7.6,2013-14,Regular%20Season
203093,Terrence Jones,1610612745,HOU,72,48,24,2037.0,162,86,69,0.531,383,0.423,9,0.433,6.9,366,125,240,0.342,619,0.591,48,0.641,5.7,528,211,309,0.4,1002,0.527,57,0.559,6.0,2013-14,Regular%20Season
203082,Terrence Ross,1610612761,TOR,77,46,31,2083.0,43,19,24,0.442,131,0.328,5,0.341,13.7,204,33,169,0.162,369,0.553,22,0.588,6.7,247,52,193,0.211,500,0.494,27,0.522,7.9,2013-14,Regular%20Season
200757,Thabo Sefolosha,1610612760,OKC,61,44,17,1584.0,50,22,26,0.44,157,0.318,9,0.338,10.1,170,37,132,0.218,297,0.572,30,0.637,9.2,220,59,158,0.268,454,0.485,39,0.53,9.4,2013-14,Regular%20Season
201152,Thaddeus Young,1610612755,PHI,78,18,60,2679.0,166,92,66,0.554,449,0.37,18,0.385,6.5,310,94,217,0.303,594,0.522,42,0.562,7.0,476,186,283,0.391,1043,0.456,60,0.484,6.9,2013-14,Regular%20Season
203080,Thomas Robinson,1610612757,POR,68,46,22,864.0,104,73,30,0.702,276,0.377,10,0.391,5.2,202,68,131,0.337,350,0.577,36,0.643,4.5,306,141,161,0.461,626,0.489,46,0.528,4.7,2013-14,Regular%20Season
201168,Tiago Splitter,1610612759,SAS,59,46,13,1271.0,123,75,47,0.61,314,0.392,9,0.403,6.1,240,96,146,0.4,444,0.541,62,0.628,4.6,363,171,193,0.471,758,0.479,71,0.528,5.1,2013-14,Regular%20Season
1495,Tim Duncan,1610612759,SAS,74,56,18,2158.0,158,106,50,0.671,379,0.417,7,0.425,6.2,563,220,340,0.391,884,0.637,60,0.683,4.4,721,326,390,0.452,1263,0.571,67,0.603,4.8,2013-14,Regular%20Season
203501,Tim Hardaway Jr.,1610612752,NYK,64,31,33,1535.0,18,7,12,0.389,88,0.205,2,0.209,18.0,101,24,76,0.238,222,0.455,20,0.5,10.2,119,31,88,0.261,310,0.384,22,0.413,11.5,2013-14,Regular%20Season
202389,Timofey Mozgov,1610612743,DEN,82,36,46,1770.0,171,111,51,0.649,509,0.336,14,0.345,6.1,357,122,226,0.342,654,0.546,78,0.62,4.3,528,233,277,0.441,1163,0.454,92,0.493,4.9,2013-14,Regular%20Season
202699,Tobias Harris,1610612753,ORL,61,16,45,1850.0,88,63,22,0.716,242,0.364,3,0.368,5.9,336,91,240,0.271,571,0.588,60,0.658,5.0,424,154,262,0.363,813,0.522,63,0.565,5.2,2013-14,Regular%20Season
201962,Toney Douglas,1610612748,MIA,36,26,10,606.0,18,8,9,0.444,59,0.305,1,0.31,8.4,69,7,63,0.101,110,0.627,7,0.67,9.8,87,15,72,0.172,169,0.515,8,0.54,9.5,2013-14,Regular%20Season
2754,Tony Allen,1610612763,MEM,51,29,22,1194.0,79,41,35,0.519,196,0.403,8,0.42,10.1,129,26,101,0.202,206,0.626,21,0.697,7.7,208,67,136,0.322,402,0.517,29,0.558,8.7,2013-14,Regular%20Season
203183,Tony Mitchell,1610612749,MIL,1,0,1,3.0,1,0,1,0.0,1,1.0,0,1.0,1.8,0,0,0,0.0,0,0.0,0,0.0,0.0,1,0,1,0.0,1,1.0,0,1.0,1.8,2013-14,Regular%20Season
203502,Tony Mitchell,1610612765,DET,11,3,8,61.0,15,12,3,0.8,23,0.652,0,0.652,6.7,11,5,6,0.455,22,0.5,3,0.579,3.1,26,17,9,0.654,45,0.578,3,0.619,5.2,2013-14,Regular%20Season
2225,Tony Parker,1610612759,SAS,62,45,17,1825.0,17,3,14,0.176,143,0.119,6,0.124,14.8,138,9,130,0.065,255,0.541,14,0.573,11.9,155,12,144,0.077,398,0.389,20,0.41,12.2,2013-14,Regular%20Season
203503,Tony Snell,1610612741,CHI,52,30,22,1074.0,19,7,10,0.368,59,0.322,3,0.339,11.9,105,19,87,0.181,208,0.505,16,0.547,8.2,124,26,97,0.21,267,0.464,19,0.5,8.7,2013-14,Regular%20Season
203100,Tony Wroten,1610612755,PHI,70,18,52,1711.0,69,40,29,0.58,264,0.261,9,0.271,7.4,159,24,137,0.151,291,0.546,21,0.589,9.4,228,64,166,0.281,555,0.411,30,0.434,8.9,2013-14,Regular%20Season
203129,Tornike Shengelia,1610612741,CHI,11,4,7,107.0,4,0,3,0.0,10,0.4,1,0.444,12.0,12,4,8,0.333,26,0.462,2,0.5,7.1,16,4,11,0.25,36,0.444,3,0.485,8.0,2013-14,Regular%20Season
203315,Toure' Murry,1610612752,NYK,27,15,12,287.0,13,5,7,0.385,34,0.382,3,0.419,11.4,31,6,27,0.194,59,0.525,4,0.564,10.1,44,11,34,0.25,93,0.473,7,0.512,10.5,2013-14,Regular%20Season
2566,Travis Outlaw,1610612758,SAC,52,18,34,976.0,36,18,17,0.5,96,0.375,4,0.391,9.5,132,28,101,0.212,231,0.571,19,0.623,7.4,168,46,118,0.274,327,0.514,23,0.553,7.8,2013-14,Regular%20Season
2772,Trevor Ariza,1610612764,WAS,76,41,35,2690.0,98,54,41,0.551,293,0.334,15,0.353,9.2,374,61,310,0.163,585,0.639,46,0.694,7.1,472,115,351,0.244,878,0.538,61,0.578,7.6,2013-14,Regular%20Season
202344,Trevor Booker,1610612764,WAS,66,34,32,1502.0,147,75,69,0.51,383,0.384,15,0.399,7.0,228,70,162,0.307,442,0.516,48,0.579,5.7,375,145,231,0.387,825,0.455,63,0.492,6.2,2013-14,Regular%20Season
203504,Trey Burke,1610612762,UTA,67,24,43,2187.0,37,8,29,0.216,121,0.306,5,0.319,14.2,171,14,159,0.082,329,0.52,18,0.55,10.9,208,22,188,0.106,450,0.462,23,0.487,11.5,2013-14,Regular%20Season
202684,Tristan Thompson,1610612739,CLE,82,33,49,2594.0,269,176,88,0.654,776,0.347,22,0.357,5.9,485,154,326,0.318,849,0.571,69,0.622,5.3,754,330,414,0.438,1625,0.464,91,0.492,5.5,2013-14,Regular%20Season
203584,Troy Daniels,1610612745,HOU,3,1,2,68.0,0,0,0,0.0,1,0.0,0,0.0,0.0,4,1,3,0.25,14,0.286,2,0.333,13.5,4,1,3,0.25,15,0.267,2,0.308,13.5,2013-14,Regular%20Season
201951,Ty Lawson,1610612743,DEN,60,28,32,2147.0,40,11,29,0.275,186,0.215,9,0.226,16.6,175,30,145,0.171,316,0.554,23,0.597,10.9,215,41,174,0.191,502,0.428,32,0.457,12.0,2013-14,Regular%20Season
201946,Tyler Hansbrough,1610612761,TOR,59,35,24,942.0,116,86,29,0.741,306,0.379,4,0.384,4.2,165,70,92,0.424,306,0.539,31,0.6,4.7,281,156,121,0.555,612,0.459,35,0.487,4.5,2013-14,Regular%20Season
203092,Tyler Zeller,1610612739,CLE,59,21,38,998.0,103,64,34,0.621,232,0.444,7,0.458,5.4,179,73,104,0.408,328,0.546,21,0.583,4.9,282,137,138,0.486,560,0.504,28,0.53,5.1,2013-14,Regular%20Season
201936,Tyreke Evans,1610612740,NOP,69,30,39,1987.0,76,42,31,0.553,300,0.253,10,0.262,9.0,265,65,203,0.245,456,0.581,35,0.629,7.9,341,107,234,0.314,756,0.451,45,0.48,8.1,2013-14,Regular%20Season
203116,Tyshawn Taylor,1610612751,BKN,10,1,9,191.0,3,1,1,0.333,24,0.125,3,0.143,8.5,12,4,9,0.333,28,0.429,3,0.48,10.6,15,5,10,0.333,52,0.288,6,0.326,10.3,2013-14,Regular%20Season
2199,Tyson Chandler,1610612752,NYK,55,24,31,1662.0,159,103,48,0.648,382,0.416,12,0.43,6.1,370,114,254,0.308,612,0.605,61,0.672,4.7,529,217,302,0.41,994,0.532,73,0.574,5.1,2013-14,Regular%20Season
2617,Udonis Haslem,1610612748,MIA,39,27,12,618.0,41,29,10,0.707,125,0.328,3,0.336,6.4,133,41,92,0.308,225,0.591,23,0.658,4.7,174,70,102,0.402,350,0.497,26,0.537,5.1,2013-14,Regular%20Season
203505,Vander Blue,1610612738,BOS,2,1,1,7.0,0,0,0,0.0,0,0.0,0,0.0,0.0,3,0,3,0.0,3,1.0,0,1.0,13.6,3,0,3,0.0,3,1.0,0,1.0,13.6,2013-14,Regular%20Season
203139,Viacheslav Kravtsov,1610612756,PHX,10,7,3,41.0,9,5,4,0.556,17,0.529,0,0.529,11.5,8,2,6,0.25,14,0.571,1,0.615,4.6,17,7,10,0.412,31,0.548,1,0.567,8.3,2013-14,Regular%20Season
201964,Victor Claver,1610612757,POR,12,8,4,172.0,9,4,4,0.444,22,0.409,1,0.429,7.7,30,13,18,0.433,62,0.484,7,0.545,6.1,39,17,22,0.436,84,0.464,8,0.513,6.4,2013-14,Regular%20Season
203506,Victor Oladipo,1610612753,ORL,78,23,55,2433.0,43,14,24,0.326,210,0.205,10,0.215,14.6,286,66,221,0.231,567,0.504,51,0.554,8.3,329,80,245,0.243,777,0.423,61,0.459,9.1,2013-14,Regular%20Season
1713,Vince Carter,1610612742,DAL,80,48,32,1945.0,67,42,25,0.627,210,0.319,8,0.332,7.5,217,72,148,0.332,476,0.456,48,0.507,5.7,284,114,173,0.401,686,0.414,56,0.451,6.1,2013-14,Regular%20Season
203543,Vitor Faverani,1610612738,BOS,29,11,18,439.0,42,27,13,0.643,98,0.429,3,0.442,5.7,86,35,50,0.407,174,0.494,12,0.531,4.7,128,62,63,0.484,272,0.471,15,0.498,5.0,2013-14,Regular%20Season
201961,Wayne Ellington,1610612742,DAL,25,14,11,302.0,8,1,7,0.125,29,0.276,1,0.286,15.2,35,10,25,0.286,59,0.593,2,0.614,10.2,43,11,32,0.256,88,0.489,3,0.506,11.1,2013-14,Regular%20Season
202325,Wesley Johnson,1610612747,LAL,76,27,49,2158.0,70,23,45,0.329,200,0.35,8,0.365,11.6,278,70,205,0.252,541,0.514,43,0.558,6.6,348,93,250,0.267,741,0.47,51,0.504,7.6,2013-14,Regular%20Season
202083,Wesley Matthews,1610612757,POR,78,51,27,2679.0,51,19,30,0.373,211,0.242,8,0.251,12.6,238,42,199,0.176,472,0.504,49,0.563,7.9,289,61,229,0.211,683,0.423,57,0.462,8.7,2013-14,Regular%20Season
203115,Will Barton,1610612757,POR,24,16,8,274.0,16,10,6,0.625,38,0.421,1,0.432,7.0,58,6,51,0.103,87,0.667,6,0.716,6.9,74,16,57,0.216,125,0.592,7,0.627,6.9,2013-14,Regular%20Season
101198,Will Bynum,1610612765,DET,45,14,31,904.0,24,8,18,0.333,111,0.216,6,0.229,15.8,75,8,69,0.107,127,0.591,2,0.6,10.6,99,16,87,0.162,238,0.416,8,0.43,12.0,2013-14,Regular%20Season
2584,Willie Green,1610612746,LAC,37,27,10,655.0,12,4,8,0.333,29,0.414,2,0.444,19.4,65,8,55,0.123,136,0.478,7,0.504,7.3,77,12,63,0.156,165,0.467,9,0.494,9.2,2013-14,Regular%20Season
201163,Wilson Chandler,1610612743,DEN,61,27,34,1896.0,58,32,25,0.552,187,0.31,4,0.317,9.2,236,67,175,0.284,439,0.538,48,0.604,5.6,294,99,200,0.337,626,0.47,52,0.512,6.4,2013-14,Regular%20Season
202333,Xavier Henry,1610612747,LAL,38,13,25,823.0,25,13,13,0.52,111,0.225,3,0.231,11.3,89,15,73,0.169,192,0.464,14,0.5,8.6,114,28,86,0.246,303,0.376,17,0.399,9.2,2013-14,Regular%20Season
2216,Zach Randolph,1610612763,MEM,78,49,29,2697.0,265,187,67,0.706,744,0.356,23,0.368,4.8,530,175,355,0.33,876,0.605,92,0.676,4.7,795,362,422,0.455,1620,0.491,115,0.528,4.7,2013-14,Regular%20Season
2585,Zaza Pachulia,1610612749,MIL,51,10,41,1301.0,140,96,43,0.686,328,0.427,10,0.44,5.4,190,74,113,0.389,368,0.516,43,0.585,4.4,330,170,156,0.515,696,0.474,53,0.513,4.8,2013-14,Regular%20Season
1733,Al Harrington,1610612764,WAS,6,3,3,59.0,1,0,1,0.0,7,0.143,0,0.143,2.0,15,3,12,0.2,16,0.938,1,1.0,5.4,16,3,13,0.188,23,0.696,1,0.727,5.2,2013-14,Playoffs
2744,Al Jefferson,1610612766,CHA,3,0,3,106.0,6,2,3,0.333,13,0.462,1,0.5,3.3,22,4,17,0.182,33,0.667,4,0.759,4.0,28,6,20,0.214,46,0.609,5,0.683,3.9,2013-14,Playoffs
101187,Alan Anderson,1610612751,BKN,11,5,6,241.0,10,4,5,0.4,21,0.476,1,0.5,11.1,22,4,18,0.182,40,0.55,2,0.579,10.3,32,8,23,0.25,61,0.525,3,0.552,10.5,2013-14,Playoffs
101161,Amir Johnson,1610612761,TOR,7,3,4,191.0,16,10,6,0.625,47,0.34,1,0.348,6.9,26,9,17,0.346,45,0.578,7,0.684,6.6,42,19,23,0.452,92,0.457,8,0.5,6.7,2013-14,Playoffs
101154,Andray Blatche,1610612751,BKN,11,5,6,168.0,25,18,7,0.72,46,0.543,0,0.543,5.8,35,19,16,0.543,57,0.614,6,0.686,4.4,60,37,23,0.617,103,0.583,6,0.619,5.0,2013-14,Playoffs
2738,Andre Iguodala,1610612744,GSW,7,3,4,248.0,5,2,3,0.4,14,0.357,1,0.385,8.6,28,2,27,0.071,48,0.583,2,0.609,8.9,33,4,30,0.121,62,0.532,3,0.559,8.9,2013-14,Playoffs
1889,Andre Miller,1610612764,WAS,7,4,3,81.0,2,0,2,0.0,14,0.143,0,0.143,17.4,9,2,7,0.222,16,0.563,1,0.6,9.7,11,2,9,0.182,30,0.367,1,0.379,11.1,2013-14,Playoffs
203460,Andre Roberson,1610612760,OKC,1,0,1,7.0,0,0,0,0.0,1,0.0,0,0.0,0.0,2,1,1,0.5,3,0.667,1,1.0,8.4,2,1,1,0.5,4,0.5,1,0.667,8.4,2013-14,Playoffs
1905,Andrei Kirilenko,1610612751,BKN,9,3,6,142.0,10,5,5,0.5,20,0.5,1,0.526,6.8,13,3,10,0.231,23,0.565,4,0.684,6.1,23,8,15,0.348,43,0.535,5,0.605,6.4,2013-14,Playoffs
201229,Anthony Tolliver,1610612766,CHA,3,0,3,16.0,1,0,1,0.0,2,0.5,0,0.5,2.1,3,0,3,0.0,4,0.75,1,1.0,6.4,4,0,4,0.0,6,0.667,1,0.8,5.3,2013-14,Playoffs
203382,Aron Baynes,1610612759,SAS,11,8,3,93.0,12,9,3,0.75,24,0.5,0,0.5,4.5,19,10,10,0.526,36,0.528,4,0.594,6.5,31,19,13,0.613,60,0.517,4,0.554,5.8,2013-14,Playoffs
201948,Austin Daye,1610612759,SAS,1,0,1,6.0,0,0,0,0.0,2,0.0,0,0.0,0.0,1,0,1,0.0,2,0.5,0,0.5,7.5,1,0,1,0.0,4,0.25,0,0.25,7.5,2013-14,Playoffs
2757,Beno Udrih,1610612763,MEM,5,3,2,77.0,2,1,1,0.5,5,0.4,1,0.5,10.2,10,2,8,0.2,14,0.714,0,0.714,8.7,12,3,9,0.25,19,0.632,1,0.667,8.9,2013-14,Playoffs
203108,Bernard James,1610612742,DAL,1,1,0,2.0,1,1,0,1.0,1,1.0,0,1.0,12.3,0,0,0,0.0,0,0.0,0,0.0,0.0,1,1,0,1.0,1,1.0,0,1.0,12.3,2013-14,Playoffs
202687,Bismack Biyombo,1610612766,CHA,3,0,3,48.0,5,2,3,0.4,13,0.385,1,0.417,8.7,6,0,6,0.0,19,0.316,3,0.375,4.6,11,2,9,0.182,32,0.344,4,0.393,6.4,2013-14,Playoffs
201933,Blake Griffin,1610612746,LAC,13,6,7,478.0,35,21,12,0.6,90,0.389,2,0.398,6.1,61,26,37,0.426,129,0.473,9,0.508,4.4,96,47,49,0.49,219,0.438,11,0.462,5.0,2013-14,Playoffs
2564,Boris Diaw,1610612759,SAS,22,16,6,587.0,25,17,7,0.68,64,0.391,3,0.41,5.3,86,24,61,0.279,183,0.47,18,0.521,5.2,111,41,68,0.369,247,0.449,21,0.491,5.2,2013-14,Playoffs
203078,Bradley Beal,1610612764,WAS,11,6,5,458.0,15,5,10,0.333,38,0.395,3,0.429,17.3,40,10,30,0.25,81,0.494,9,0.556,8.9,55,15,40,0.273,119,0.462,12,0.514,11.2,2013-14,Playoffs
201148,Brandan Wright,1610612742,DAL,5,2,3,83.0,5,4,1,0.8,8,0.625,0,0.625,8.3,7,5,2,0.714,19,0.368,2,0.412,5.6,12,9,3,0.75,27,0.444,2,0.48,6.7,2013-14,Playoffs
201228,C.J. Watson,1610612754,IND,18,10,8,327.0,3,0,3,0.0,19,0.158,2,0.176,18.6,37,6,30,0.162,55,0.673,1,0.685,9.6,40,6,33,0.15,74,0.541,3,0.563,10.3,2013-14,Playoffs
203468,CJ McCollum,1610612757,POR,1,0,1,5.0,0,0,0,0.0,0,0.0,0,0.0,0.0,1,0,1,0.0,1,1.0,0,1.0,41.3,1,0,1,0.0,1,1.0,0,1.0,41.3,2013-14,Playoffs
2430,Carlos Boozer,1610612741,CHI,5,1,4,121.0,8,7,1,0.875,23,0.348,1,0.364,6.8,31,8,23,0.258,39,0.795,2,0.838,4.4,39,15,24,0.385,62,0.629,3,0.661,4.9,2013-14,Playoffs
2406,Caron Butler,1610612760,OKC,17,9,8,412.0,11,3,7,0.273,33,0.333,3,0.367,15.2,47,13,33,0.277,94,0.5,12,0.573,6.1,58,16,40,0.276,127,0.457,15,0.518,7.7,2013-14,Playoffs
201858,Cartier Martin,1610612737,ATL,1,0,1,10.0,1,0,1,0.0,1,1.0,0,1.0,15.1,2,0,2,0.0,1,2.0,0,2.0,5.0,3,0,3,0.0,2,1.5,0,1.5,8.4,2013-14,Playoffs
202718,Chandler Parsons,1610612745,HOU,6,2,4,250.0,6,4,2,0.667,34,0.176,1,0.182,9.1,35,3,31,0.086,54,0.648,4,0.7,7.8,41,7,33,0.171,88,0.466,5,0.494,8.0,2013-14,Playoffs
2365,Chris Andersen,1610612748,MIA,18,12,6,317.0,26,19,6,0.731,75,0.347,1,0.351,3.1,81,27,53,0.333,119,0.681,11,0.75,4.2,107,46,59,0.43,194,0.552,12,0.588,3.9,2013-14,Playoffs
2547,Chris Bosh,1610612748,MIA,20,13,7,686.0,24,9,15,0.375,55,0.436,0,0.436,8.5,88,26,62,0.295,190,0.463,26,0.537,4.5,112,35,77,0.313,245,0.457,26,0.511,5.4,2013-14,Playoffs
203142,Chris Copeland,1610612754,IND,3,1,2,48.0,1,1,0,1.0,3,0.333,0,0.333,1.4,4,1,3,0.25,13,0.308,2,0.364,10.9,5,2,3,0.4,16,0.313,2,0.357,9.0,2013-14,Playoffs
201604,Chris Douglas-Roberts,1610612766,CHA,3,0,3,62.0,2,0,2,0.0,4,0.5,0,0.5,12.1,6,1,5,0.167,12,0.5,0,0.5,9.7,8,1,7,0.125,16,0.5,0,0.5,10.3,2013-14,Playoffs
101108,Chris Paul,1610612746,LAC,13,6,7,472.0,12,5,8,0.417,47,0.255,1,0.261,11.8,43,9,34,0.209,80,0.538,7,0.589,8.8,55,14,42,0.255,127,0.433,8,0.462,9.5,2013-14,Playoffs
101236,Chuck Hayes,1610612761,TOR,4,2,2,34.0,4,2,2,0.5,12,0.333,0,0.333,4.4,4,2,3,0.5,13,0.308,3,0.4,6.2,8,4,5,0.5,25,0.32,3,0.364,5.4,2013-14,Playoffs
203469,Cody Zeller,1610612766,CHA,4,0,4,53.0,5,4,1,0.8,14,0.357,0,0.357,4.3,4,2,2,0.5,10,0.4,1,0.444,2.9,9,6,3,0.667,24,0.375,1,0.391,3.7,2013-14,Playoffs
202709,Cory Joseph,1610612759,SAS,4,2,2,39.0,1,1,0,1.0,10,0.1,1,0.111,2.7,8,2,6,0.25,12,0.667,0,0.667,10.5,9,3,6,0.333,22,0.409,1,0.429,9.6,2013-14,Playoffs
201584,Courtney Lee,1610612763,MEM,6,3,3,187.0,3,0,3,0.0,9,0.333,0,0.333,11.7,11,2,9,0.182,25,0.44,5,0.55,8.5,14,2,12,0.143,34,0.412,5,0.483,9.2,2013-14,Playoffs
201571,D.J. Augustin,1610612741,CHI,4,1,3,118.0,4,2,0,0.5,12,0.333,1,0.364,3.3,4,0,4,0.0,17,0.235,2,0.267,14.7,8,2,4,0.25,29,0.276,3,0.308,10.9,2013-14,Playoffs
201591,DJ White,1610612766,CHA,1,0,1,3.0,0,0,0,0.0,0,0.0,0,0.0,0.0,2,0,2,0.0,2,1.0,0,1.0,7.9,2,0,2,0.0,2,1.0,0,1.0,7.9,2013-14,Playoffs
203081,Damian Lillard,1610612757,POR,11,5,6,466.0,12,5,8,0.417,39,0.308,0,0.308,17.5,44,8,36,0.182,112,0.393,13,0.444,8.8,56,13,44,0.232,151,0.371,13,0.406,10.5,2013-14,Playoffs
101122,Danny Granger,1610612746,LAC,9,6,3,100.0,2,1,0,0.5,9,0.222,0,0.222,2.7,18,6,12,0.333,43,0.419,3,0.45,5.1,20,7,12,0.35,52,0.385,3,0.408,5.0,2013-14,Playoffs
201980,Danny Green,1610612759,SAS,23,16,7,529.0,9,2,6,0.222,28,0.321,1,0.333,13.3,60,10,50,0.167,131,0.458,9,0.492,7.8,69,12,56,0.174,159,0.434,10,0.463,8.4,2013-14,Playoffs
201954,Darren Collison,1610612746,LAC,11,5,6,207.0,10,4,6,0.4,29,0.345,1,0.357,15.7,17,2,16,0.118,38,0.447,1,0.459,8.1,27,6,22,0.222,67,0.403,2,0.415,10.8,2013-14,Playoffs
101135,David Lee,1610612744,GSW,7,3,4,217.0,24,18,5,0.75,65,0.369,2,0.381,5.9,40,16,23,0.4,89,0.449,5,0.476,3.4,64,34,28,0.531,154,0.416,7,0.435,4.3,2013-14,Playoffs
2561,David West,1610612754,IND,19,10,9,687.0,24,13,8,0.542,86,0.279,4,0.293,6.7,104,31,73,0.298,187,0.556,17,0.612,5.2,128,44,81,0.344,273,0.469,21,0.508,5.4,2013-14,Playoffs
201599,DeAndre Jordan,1610612746,LAC,13,6,7,442.0,43,32,7,0.744,108,0.398,0,0.398,5.3,120,34,85,0.283,177,0.678,10,0.719,4.4,163,66,92,0.405,285,0.572,10,0.593,4.7,2013-14,Playoffs
201971,DeJuan Blair,1610612742,DAL,4,2,2,74.0,14,9,5,0.643,25,0.56,1,0.583,7.4,23,7,16,0.304,28,0.821,1,0.852,5.0,37,16,21,0.432,53,0.698,2,0.725,5.9,2013-14,Playoffs
201942,DeMar DeRozan,1610612761,TOR,7,3,4,282.0,3,0,3,0.0,18,0.167,1,0.176,12.6,26,5,21,0.192,39,0.667,2,0.703,6.9,29,5,24,0.172,57,0.509,3,0.537,7.5,2013-14,Playoffs
201960,DeMarre Carroll,1610612737,ATL,7,3,4,246.0,12,4,8,0.333,38,0.316,1,0.324,14.4,22,4,17,0.182,40,0.55,3,0.595,7.9,34,8,25,0.235,78,0.436,4,0.459,10.3,2013-14,Playoffs
203471,Dennis Schroder,1610612737,ATL,1,0,1,7.0,0,0,0,0.0,0,0.0,0,0.0,0.0,2,0,2,0.0,2,1.0,0,1.0,6.8,2,0,2,0.0,2,1.0,0,1.0,6.8,2013-14,Playoffs
965,Derek Fisher,1610612760,OKC,16,9,7,268.0,6,2,4,0.333,15,0.4,1,0.429,15.6,27,1,24,0.037,38,0.711,3,0.771,10.8,33,3,28,0.091,53,0.623,4,0.673,11.7,2013-14,Playoffs
101114,Deron Williams,1610612751,BKN,11,5,6,392.0,7,3,4,0.429,33,0.212,0,0.212,17.5,31,6,25,0.194,62,0.5,7,0.564,10.3,38,9,29,0.237,95,0.4,7,0.432,11.6,2013-14,Playoffs
2734,Devin Harris,1610612742,DAL,6,2,4,151.0,1,0,1,0.0,9,0.111,0,0.111,4.7,16,2,14,0.125,23,0.696,2,0.762,10.1,17,2,15,0.118,32,0.531,2,0.567,9.8,2013-14,Playoffs
1717,Dirk Nowitzki,1610612742,DAL,7,3,4,263.0,5,3,2,0.6,17,0.294,2,0.333,9.3,51,19,32,0.373,80,0.638,8,0.708,5.1,56,22,34,0.393,97,0.577,10,0.644,5.5,2013-14,Playoffs
202388,Donald Sloan,1610612754,IND,1,1,0,4.0,0,0,0,0.0,0,0.0,0,0.0,0.0,1,0,1,0.0,1,1.0,0,1.0,6.9,1,0,1,0.0,1,1.0,0,1.0,6.9,2013-14,Playoffs
2748,Dorell Wright,1610612757,POR,4,3,1,67.0,2,0,2,0.0,2,1.0,0,1.0,5.1,14,4,10,0.286,27,0.519,3,0.583,4.8,16,4,12,0.25,29,0.552,3,0.615,4.9,2013-14,Playoffs
203110,Draymond Green,1610612744,GSW,7,3,4,228.0,18,10,6,0.556,40,0.45,0,0.45,6.8,40,13,26,0.325,87,0.46,8,0.506,4.8,58,23,32,0.397,127,0.457,8,0.487,5.4,2013-14,Playoffs
2400,Drew Gooden,1610612764,WAS,8,3,5,141.0,20,17,2,0.85,55,0.364,1,0.37,4.6,22,10,13,0.455,38,0.579,6,0.688,4.2,42,27,15,0.643,93,0.452,7,0.488,4.4,2013-14,Playoffs
2730,Dwight Howard,1610612745,HOU,6,2,4,231.0,27,18,7,0.667,62,0.435,2,0.45,4.1,55,28,26,0.509,91,0.604,5,0.64,4.0,82,46,33,0.561,153,0.536,7,0.562,4.0,2013-14,Playoffs
2548,Dwyane Wade,1610612748,MIA,20,13,7,693.0,16,5,10,0.313,62,0.258,0,0.258,6.5,61,14,47,0.23,106,0.575,13,0.656,7.4,77,19,57,0.247,168,0.458,13,0.497,7.2,2013-14,Playoffs
2248,Earl Watson,1610612757,POR,1,0,1,5.0,0,0,0,0.0,0,0.0,0,0.0,0.0,1,0,1,0.0,1,1.0,0,1.0,9.5,1,0,1,0.0,1,1.0,0,1.0,9.5,2013-14,Playoffs
202334,Ed Davis,1610612763,MEM,5,1,4,22.0,8,6,2,0.75,17,0.471,1,0.5,6.5,7,5,2,0.714,10,0.7,0,0.7,5.8,15,11,4,0.733,27,0.556,1,0.577,6.2,2013-14,Playoffs
1882,Elton Brand,1610612737,ATL,6,3,3,78.0,7,4,3,0.571,13,0.538,0,0.538,10.9,16,8,8,0.5,29,0.552,2,0.593,5.4,23,12,11,0.522,42,0.548,2,0.575,7.0,2013-14,Playoffs
202323,Evan Turner,1610612754,IND,9,5,4,128.0,0,0,0,0.0,6,0.0,1,0.0,0.0,26,3,23,0.115,45,0.578,3,0.619,7.1,26,3,23,0.115,51,0.51,4,0.553,7.1,2013-14,Playoffs
101128,Francisco Garcia,1610612745,HOU,1,0,1,18.0,1,1,1,1.0,2,0.5,0,0.5,14.8,1,1,0,1.0,3,0.333,0,0.333,1.9,2,2,1,1.0,5,0.4,0,0.4,10.5,2013-14,Playoffs
202390,Gary Neal,1610612766,CHA,4,0,4,104.0,3,0,3,0.0,7,0.429,0,0.429,24.9,5,1,4,0.2,11,0.455,1,0.5,7.4,8,1,7,0.125,18,0.444,1,0.471,14.0,2013-14,Playoffs
201588,George Hill,1610612754,IND,19,10,9,687.0,14,5,8,0.357,53,0.264,1,0.269,12.7,58,13,45,0.224,148,0.392,17,0.443,7.4,72,18,53,0.25,201,0.358,18,0.393,8.4,2013-14,Playoffs
201945,Gerald Henderson,1610612766,CHA,4,0,4,119.0,1,0,1,0.0,4,0.25,0,0.25,25.6,15,2,13,0.133,22,0.682,1,0.714,9.6,16,2,14,0.125,26,0.615,1,0.64,10.6,2013-14,Playoffs
201175,Glen Davis,1610612746,LAC,13,6,7,158.0,14,6,8,0.429,41,0.341,2,0.359,7.0,22,13,8,0.591,55,0.4,5,0.44,5.2,36,19,16,0.528,96,0.375,7,0.404,5.9,2013-14,Playoffs
202349,Greivis Vasquez,1610612761,TOR,7,3,4,190.0,3,0,3,0.0,14,0.214,0,0.214,24.5,23,6,17,0.261,37,0.622,7,0.767,6.3,26,6,20,0.231,51,0.51,7,0.591,8.4,2013-14,Playoffs
203084,Harrison Barnes,1610612744,GSW,6,3,3,133.0,7,3,3,0.429,16,0.438,1,0.467,8.6,21,4,16,0.19,42,0.5,3,0.538,5.4,28,7,19,0.25,58,0.483,4,0.519,6.1,2013-14,Playoffs
2045,Hedo Turkoglu,1610612746,LAC,4,2,2,36.0,0,0,0,0.0,0,0.0,0,0.0,0.0,5,1,4,0.2,10,0.5,0,0.5,5.0,5,1,4,0.2,10,0.5,0,0.5,5.0,2013-14,Playoffs
200756,Hilton Armstrong,1610612744,GSW,2,1,1,12.0,3,3,0,1.0,4,0.75,0,0.75,6.6,1,1,0,1.0,3,0.333,0,0.333,1.2,4,4,0,1.0,7,0.571,0,0.571,5.3,2013-14,Playoffs
101133,Ian Mahinmi,1610612754,IND,14,8,6,195.0,22,16,6,0.727,49,0.449,2,0.468,5.7,23,11,12,0.478,52,0.442,10,0.548,5.8,45,27,18,0.6,101,0.446,12,0.506,5.8,2013-14,Playoffs
200755,JJ Redick,1610612746,LAC,11,5,6,304.0,4,1,3,0.25,14,0.286,0,0.286,21.9,18,2,16,0.111,40,0.45,4,0.5,11.6,22,3,19,0.136,54,0.407,4,0.44,13.5,2013-14,Playoffs
203109,Jae Crowder,1610612742,DAL,5,2,3,59.0,4,2,2,0.5,6,0.667,0,0.667,9.5,8,2,6,0.25,16,0.5,2,0.571,6.2,12,4,8,0.333,22,0.545,2,0.6,7.3,2013-14,Playoffs
203479,Jamaal Franklin,1610612763,MEM,1,0,1,1.0,0,0,0,0.0,1,0.0,0,0.0,0.0,1,0,1,0.0,0,0.0,0,0.0,2.1,1,0,1,0.0,1,1.0,0,1.0,2.1,2013-14,Playoffs
2037,Jamal Crawford,1610612746,LAC,10,5,5,253.0,5,0,4,0.0,17,0.294,3,0.357,27.2,14,5,7,0.357,26,0.538,3,0.609,7.9,19,5,11,0.263,43,0.442,6,0.514,12.7,2013-14,Playoffs
201935,James Harden,1610612745,HOU,6,2,4,263.0,5,1,4,0.2,27,0.185,0,0.185,7.2,23,3,20,0.13,45,0.511,6,0.59,6.6,28,4,24,0.143,72,0.389,6,0.424,6.7,2013-14,Playoffs
201949,James Johnson,1610612763,MEM,2,0,2,24.0,4,0,4,0.0,9,0.444,0,0.444,9.8,2,1,2,0.5,2,1.0,0,1.0,5.1,6,1,6,0.167,11,0.545,0,0.545,8.4,2013-14,Playoffs
2592,James Jones,1610612748,MIA,8,5,3,77.0,3,0,3,0.0,4,0.75,0,0.75,25.0,8,1,7,0.125,11,0.727,0,0.727,8.1,11,1,10,0.091,15,0.733,0,0.733,12.7,2013-14,Playoffs
2457,Jannero Pargo,1610612766,CHA,1,0,1,3.0,0,0,0,0.0,0,0.0,0,0.0,0.0,1,0,1,0.0,1,1.0,0,1.0,17.3,1,0,1,0.0,1,1.0,0,1.0,17.3,2013-14,Playoffs
201162,Jared Dudley,1610612746,LAC,3,1,2,30.0,0,0,0,0.0,1,0.0,0,0.0,0.0,6,1,5,0.167,10,0.6,0,0.6,6.2,6,1,5,0.167,11,0.545,0,0.545,6.2,2013-14,Playoffs
201965,Jeff Ayres,1610612759,SAS,10,7,3,45.0,6,4,2,0.667,13,0.462,0,0.462,6.2,13,4,9,0.308,19,0.684,1,0.722,4.4,19,8,11,0.421,32,0.594,1,0.613,5.0,2013-14,Playoffs
201952,Jeff Teague,1610612737,ATL,7,3,4,242.0,5,0,5,0.0,27,0.185,1,0.192,18.6,21,2,19,0.095,41,0.512,1,0.525,14.3,26,2,24,0.077,68,0.382,2,0.394,15.1,2013-14,Playoffs
203087,Jeremy Lamb,1610612760,OKC,6,3,3,82.0,4,2,2,0.5,7,0.571,0,0.571,7.7,12,1,11,0.083,18,0.667,0,0.667,7.4,16,3,13,0.188,25,0.64,0,0.64,7.5,2013-14,Playoffs
202391,Jeremy Lin,1610612745,HOU,6,2,4,177.0,7,2,5,0.286,15,0.467,0,0.467,10.1,15,1,15,0.067,33,0.455,2,0.484,9.8,22,3,20,0.136,48,0.458,2,0.478,9.9,2013-14,Playoffs
979,Jermaine O'Neal,1610612744,GSW,6,3,3,81.0,12,6,6,0.5,28,0.429,1,0.444,4.9,12,4,7,0.333,31,0.387,6,0.48,3.4,24,10,13,0.417,59,0.407,7,0.462,4.2,2013-14,Playoffs
202710,Jimmy Butler,1610612741,CHI,5,1,4,218.0,6,3,4,0.5,16,0.375,0,0.375,11.5,20,4,16,0.2,34,0.588,4,0.667,9.0,26,7,20,0.269,50,0.52,4,0.565,9.6,2013-14,Playoffs
201149,Joakim Noah,1610612741,CHI,5,1,4,210.0,15,10,5,0.667,36,0.417,2,0.441,5.7,49,15,34,0.306,93,0.527,2,0.538,3.8,64,25,39,0.391,129,0.496,4,0.512,4.2,2013-14,Playoffs
2207,Joe Johnson,1610612751,BKN,10,3,7,390.0,9,5,4,0.556,21,0.429,2,0.474,13.4,37,9,27,0.243,62,0.597,5,0.649,8.2,46,14,31,0.304,83,0.554,7,0.605,9.2,2013-14,Playoffs
200777,Joel Freeland,1610612757,POR,5,2,3,19.0,4,3,1,0.75,7,0.571,0,0.571,6.3,4,2,1,0.5,7,0.571,0,0.571,4.0,8,5,2,0.625,14,0.571,0,0.571,5.3,2013-14,Playoffs
2422,John Salmons,1610612761,TOR,4,2,2,59.0,0,0,0,0.0,0,0.0,0,0.0,0.0,6,2,4,0.333,9,0.667,1,0.75,9.4,6,2,4,0.333,9,0.667,1,0.75,9.4,2013-14,Playoffs
202322,John Wall,1610612764,WAS,11,6,5,420.0,5,3,3,0.6,30,0.167,1,0.172,11.3,39,4,34,0.103,77,0.506,8,0.565,9.5,44,7,37,0.159,107,0.411,9,0.449,9.9,2013-14,Playoffs
202720,Jon Leuer,1610612763,MEM,2,0,2,20.0,2,1,1,0.5,3,0.667,0,0.667,4.9,6,2,4,0.333,6,1.0,0,1.0,6.6,8,3,5,0.375,9,0.889,0,0.889,6.1,2013-14,Playoffs
202685,Jonas Valanciunas,1610612761,TOR,7,3,4,200.0,19,12,7,0.632,53,0.358,0,0.358,5.0,49,10,38,0.204,72,0.681,4,0.721,3.4,68,22,45,0.324,125,0.544,4,0.562,3.8,2013-14,Playoffs
202348,Jordan Crawford,1610612744,GSW,4,1,3,47.0,4,2,2,0.5,8,0.5,0,0.5,20.7,5,1,4,0.2,8,0.625,2,0.833,9.1,9,3,6,0.333,16,0.563,2,0.643,14.3,2013-14,Playoffs
203268,Jorge Gutierrez,1610612751,BKN,1,0,1,2.0,1,1,0,1.0,1,1.0,0,1.0,2.7,0,0,0,0.0,0,0.0,0,0.0,0.0,1,1,0,1.0,1,1.0,0,1.0,2.7,2013-14,Playoffs
101181,Jose Calderon,1610612742,DAL,3,1,2,88.0,2,0,2,0.0,5,0.4,0,0.4,23.0,7,1,6,0.143,10,0.7,0,0.7,9.2,9,1,8,0.111,15,0.6,0,0.6,12.3,2013-14,Playoffs
201177,Josh McRoberts,1610612766,CHA,4,0,4,154.0,1,1,0,1.0,10,0.1,1,0.111,6.8,26,3,24,0.115,46,0.565,3,0.605,4.8,27,4,24,0.148,56,0.482,4,0.519,4.9,2013-14,Playoffs
202695,Kawhi Leonard,1610612759,SAS,23,16,7,736.0,31,18,11,0.581,70,0.443,1,0.449,6.4,124,33,89,0.266,208,0.596,20,0.66,6.5,155,51,100,0.329,278,0.558,21,0.603,6.5,2013-14,Playoffs
202689,Kemba Walker,1610612766,CHA,4,0,4,153.0,1,1,0,1.0,7,0.143,1,0.167,5.7,14,4,10,0.286,31,0.452,0,0.452,11.0,15,5,10,0.333,38,0.395,1,0.405,10.6,2013-14,Playoffs
2570,Kendrick Perkins,1610612760,OKC,18,9,9,374.0,33,21,12,0.636,58,0.569,0,0.569,5.3,69,27,43,0.391,135,0.511,14,0.57,4.1,102,48,55,0.471,193,0.528,14,0.57,4.5,2013-14,Playoffs
201142,Kevin Durant,1610612760,OKC,19,10,9,815.0,25,12,12,0.48,55,0.455,1,0.463,9.2,145,32,112,0.221,194,0.747,11,0.792,6.9,170,44,124,0.259,249,0.683,12,0.717,7.2,2013-14,Playoffs
708,Kevin Garnett,1610612751,BKN,12,5,7,250.0,19,11,8,0.579,46,0.413,0,0.413,6.4,57,26,31,0.456,88,0.648,5,0.687,4.0,76,37,39,0.487,134,0.567,5,0.589,4.6,2013-14,Playoffs
202338,Kevin Seraphin,1610612764,WAS,2,1,1,4.0,1,1,0,1.0,2,0.5,0,0.5,3.5,1,1,0,1.0,1,1.0,0,1.0,6.3,2,2,0,1.0,3,0.667,0,0.667,4.9,2013-14,Playoffs
2550,Kirk Hinrich,1610612741,CHI,4,1,3,138.0,1,0,1,0.0,4,0.25,0,0.25,21.3,14,2,12,0.143,27,0.519,2,0.56,11.9,15,2,13,0.133,31,0.484,2,0.517,12.6,2013-14,Playoffs
202691,Klay Thompson,1610612744,GSW,6,3,3,237.0,4,0,5,0.0,18,0.222,3,0.267,14.0,20,5,16,0.25,42,0.476,1,0.488,13.8,24,5,21,0.208,60,0.4,4,0.429,14.4,2013-14,Playoffs
201585,Kosta Koufos,1610612763,MEM,6,2,4,45.0,7,5,2,0.714,16,0.438,0,0.438,5.7,8,2,6,0.25,14,0.571,1,0.615,4.3,15,7,8,0.467,30,0.5,1,0.517,5.0,2013-14,Playoffs
2594,Kyle Korver,1610612737,ATL,7,3,4,250.0,2,1,1,0.5,11,0.182,0,0.182,8.3,35,10,26,0.286,70,0.5,10,0.583,7.2,37,11,27,0.297,81,0.457,10,0.521,7.2,2013-14,Playoffs
200768,Kyle Lowry,1610612761,TOR,6,2,4,233.0,9,4,4,0.444,32,0.281,1,0.29,11.4,24,2,21,0.083,47,0.511,5,0.571,10.1,33,6,25,0.182,79,0.418,6,0.452,10.5,2013-14,Playoffs
200746,LaMarcus Aldridge,1610612757,POR,11,5,6,441.0,30,22,7,0.733,87,0.345,2,0.353,5.9,87,32,55,0.368,142,0.613,10,0.659,4.7,117,54,62,0.462,229,0.511,12,0.539,5.0,2013-14,Playoffs
202362,Lance Stephenson,1610612754,IND,18,10,8,677.0,24,13,11,0.542,77,0.312,4,0.329,11.7,107,18,89,0.168,170,0.629,12,0.677,6.5,131,31,100,0.237,247,0.53,16,0.567,7.4,2013-14,Playoffs
202361,Landry Fields,1610612761,TOR,2,1,1,25.0,2,1,1,0.5,6,0.333,0,0.333,10.7,5,1,4,0.2,10,0.5,2,0.625,6.6,7,2,5,0.286,16,0.438,2,0.5,7.7,2013-14,Playoffs
202730,Lavoy Allen,1610612754,IND,2,1,1,7.0,1,1,0,1.0,1,1.0,0,1.0,10.7,4,1,3,0.25,4,1.0,0,1.0,4.6,5,2,3,0.4,5,1.0,0,1.0,5.8,2013-14,Playoffs
2544,LeBron James,1610612748,MIA,20,13,7,763.0,14,8,5,0.571,62,0.226,2,0.233,9.4,127,30,96,0.236,172,0.738,11,0.789,6.2,141,38,101,0.27,234,0.603,13,0.638,6.5,2013-14,Playoffs
101150,Lou Williams,1610612737,ATL,7,3,4,133.0,0,0,0,0.0,11,0.0,1,0.0,0.0,16,3,13,0.188,25,0.64,0,0.64,7.0,16,3,13,0.188,36,0.444,1,0.457,7.0,2013-14,Playoffs
2449,Luis Scola,1610612754,IND,14,7,7,218.0,11,8,1,0.727,36,0.306,3,0.333,6.1,31,11,21,0.355,72,0.431,10,0.5,4.5,42,19,22,0.452,108,0.389,13,0.442,4.9,2013-14,Playoffs
2557,Luke Ridnour,1610612766,CHA,3,0,3,26.0,0,0,0,0.0,0,0.0,0,0.0,0.0,4,1,3,0.25,8,0.5,0,0.5,8.8,4,1,3,0.25,8,0.5,0,0.5,8.8,2013-14,Playoffs
1938,Manu Ginobili,1610612759,SAS,22,16,6,575.0,9,5,4,0.556,40,0.225,1,0.231,7.8,66,18,48,0.273,111,0.595,9,0.647,8.2,75,23,52,0.307,151,0.497,10,0.532,8.1,2013-14,Playoffs
201188,Marc Gasol,1610612763,MEM,7,3,4,299.0,13,5,8,0.385,32,0.406,0,0.406,9.8,41,14,27,0.341,91,0.451,9,0.5,4.4,54,19,35,0.352,123,0.439,9,0.474,5.7,2013-14,Playoffs
101162,Marcin Gortat,1610612764,WAS,11,6,5,382.0,36,26,10,0.722,101,0.356,2,0.364,6.0,73,27,46,0.37,148,0.493,15,0.549,4.1,109,53,56,0.486,249,0.438,17,0.47,4.7,2013-14,Playoffs
201158,Marco Belinelli,1610612759,SAS,18,11,7,307.0,4,1,3,0.25,18,0.222,0,0.222,13.2,48,6,43,0.125,81,0.593,6,0.64,6.6,52,7,46,0.135,99,0.525,6,0.559,7.1,2013-14,Playoffs
201977,Marcus Thornton,1610612751,BKN,8,3,5,105.0,7,2,4,0.286,15,0.467,1,0.5,5.6,12,1,11,0.083,18,0.667,3,0.8,11.5,19,3,15,0.158,33,0.576,4,0.655,9.5,2013-14,Playoffs
201596,Mario Chalmers,1610612748,MIA,19,13,6,504.0,2,1,1,0.5,22,0.091,3,0.105,7.7,44,9,35,0.205,86,0.512,6,0.55,7.6,46,10,36,0.217,108,0.426,9,0.465,7.6,2013-14,Playoffs
201578,Marreese Speights,1610612744,GSW,6,3,3,58.0,9,6,3,0.667,21,0.429,0,0.429,6.6,13,6,5,0.462,22,0.591,4,0.722,4.4,22,12,8,0.545,43,0.512,4,0.564,5.4,2013-14,Playoffs
101110,Martell Webster,1610612764,WAS,10,6,4,178.0,4,2,2,0.5,14,0.286,2,0.333,12.8,21,10,11,0.476,34,0.618,4,0.7,5.3,25,12,13,0.48,48,0.521,6,0.595,6.5,2013-14,Playoffs
203486,Mason Plumlee,1610612751,BKN,9,4,5,109.0,5,4,1,0.8,17,0.294,0,0.294,4.9,18,6,12,0.333,41,0.439,2,0.462,5.1,23,10,13,0.435,58,0.397,2,0.411,5.0,2013-14,Playoffs
2440,Matt Barnes,1610612746,LAC,13,6,7,404.0,22,8,14,0.364,63,0.349,4,0.373,10.4,36,3,31,0.083,72,0.5,8,0.563,6.8,58,11,45,0.19,135,0.43,12,0.472,8.2,2013-14,Playoffs
2588,Matt Bonner,1610612759,SAS,8,5,3,70.0,2,2,0,1.0,8,0.25,0,0.25,7.1,12,5,7,0.417,21,0.571,1,0.6,6.4,14,7,7,0.5,29,0.483,1,0.5,6.5,2013-14,Playoffs
203086,Meyers Leonard,1610612757,POR,2,0,2,5.0,0,0,0,0.0,0,0.0,0,0.0,0.0,2,0,2,0.0,3,0.667,0,0.667,9.7,2,0,2,0.0,3,0.667,0,0.667,9.7,2013-14,Playoffs
201563,Michael Beasley,1610612748,MIA,2,1,1,19.0,2,0,2,0.0,4,0.5,0,0.5,13.4,2,0,2,0.0,7,0.286,1,0.333,18.6,4,0,4,0.0,11,0.364,1,0.4,16.0,2013-14,Playoffs
203077,Michael Kidd-Gilchrist,1610612766,CHA,4,0,4,91.0,8,3,4,0.375,25,0.32,0,0.32,5.5,18,5,13,0.278,30,0.6,1,0.621,5.8,26,8,17,0.308,55,0.473,1,0.481,5.7,2013-14,Playoffs
201144,Mike Conley,1610612763,MEM,7,3,4,267.0,5,2,3,0.4,24,0.208,0,0.208,12.4,27,1,26,0.037,54,0.5,5,0.551,8.7,32,3,29,0.094,78,0.41,5,0.438,9.3,2013-14,Playoffs
2399,Mike Dunleavy,1610612741,CHI,5,1,4,163.0,5,4,0,0.8,14,0.357,0,0.357,3.7,13,2,11,0.154,38,0.342,9,0.448,9.0,18,6,11,0.333,52,0.346,9,0.419,7.8,2013-14,Playoffs
2034,Mike Miller,1610612763,MEM,7,3,4,173.0,2,0,2,0.0,8,0.25,1,0.286,28.9,24,7,17,0.292,48,0.5,5,0.558,6.0,26,7,19,0.269,56,0.464,6,0.52,7.7,2013-14,Playoffs
203118,Mike Scott,1610612737,ATL,7,3,4,146.0,3,2,1,0.667,24,0.125,3,0.143,6.5,15,2,12,0.133,25,0.6,3,0.682,6.5,18,4,13,0.222,49,0.367,6,0.419,6.5,2013-14,Playoffs
203141,Mirza Teletovic,1610612751,BKN,12,5,7,220.0,15,10,5,0.667,26,0.577,0,0.577,8.4,25,10,15,0.4,63,0.397,9,0.463,5.7,40,20,20,0.5,89,0.449,9,0.5,6.7,2013-14,Playoffs
2590,Mo Williams,1610612757,POR,6,3,3,157.0,2,1,1,0.5,5,0.4,1,0.5,13.5,10,1,9,0.1,24,0.417,3,0.476,10.9,12,2,10,0.167,29,0.414,4,0.48,11.4,2013-14,Playoffs
101145,Monta Ellis,1610612742,DAL,7,3,4,249.0,6,1,5,0.167,22,0.273,2,0.3,17.2,11,3,8,0.273,21,0.524,4,0.647,9.5,17,4,13,0.235,43,0.395,6,0.459,12.2,2013-14,Playoffs
201986,Nando De Colo,1610612761,TOR,1,0,1,4.0,0,0,0,0.0,0,0.0,0,0.0,0.0,1,0,1,0.0,2,0.5,1,1.0,7.7,1,0,1,0.0,2,0.5,1,1.0,7.7,2013-14,Playoffs
1737,Nazr Mohammed,1610612741,CHI,2,0,2,5.0,1,1,0,1.0,1,1.0,0,1.0,3.7,1,0,1,0.0,0,0.0,0,0.0,8.6,2,1,1,0.5,1,2.0,0,2.0,6.1,2013-14,Playoffs
2403,Nene,1610612764,WAS,10,5,5,325.0,8,3,5,0.375,49,0.163,3,0.174,8.8,45,17,28,0.378,80,0.563,10,0.643,5.8,53,20,33,0.377,129,0.411,13,0.457,6.3,2013-14,Playoffs
2555,Nick Collison,1610612760,OKC,14,5,9,165.0,12,8,4,0.667,47,0.255,2,0.267,6.4,26,9,17,0.346,58,0.448,9,0.531,5.6,38,17,21,0.447,105,0.362,11,0.404,5.8,2013-14,Playoffs
201587,Nicolas Batum,1610612757,POR,11,5,6,459.0,10,6,4,0.6,50,0.2,1,0.204,7.4,74,14,59,0.189,112,0.661,9,0.718,5.3,84,20,63,0.238,162,0.519,10,0.553,5.5,2013-14,Playoffs
202708,Norris Cole,1610612748,MIA,12,8,4,252.0,1,0,1,0.0,8,0.125,0,0.125,19.4,21,1,20,0.048,39,0.538,2,0.568,7.7,22,1,21,0.045,47,0.468,2,0.489,8.2,2013-14,Playoffs
203136,Ognjen Kuzmic,1610612744,GSW,1,0,1,7.0,1,1,0,1.0,2,0.5,0,0.5,6.1,3,0,3,0.0,5,0.6,0,0.6,6.2,4,1,3,0.25,7,0.571,0,0.571,6.1,2013-14,Playoffs
201600,Omer Asik,1610612745,HOU,6,2,4,163.0,21,15,4,0.714,41,0.512,2,0.538,6.5,28,13,15,0.464,46,0.609,5,0.683,3.8,49,28,19,0.571,87,0.563,7,0.613,4.9,2013-14,Playoffs
201976,Patrick Beverley,1610612745,HOU,6,2,4,202.0,13,6,7,0.462,29,0.448,0,0.448,11.4,12,1,11,0.083,32,0.375,3,0.414,11.2,25,7,18,0.28,61,0.41,3,0.431,11.3,2013-14,Playoffs
202335,Patrick Patterson,1610612761,TOR,7,3,4,199.0,12,8,4,0.667,21,0.571,0,0.571,5.3,35,10,25,0.286,53,0.66,5,0.729,4.5,47,18,29,0.383,74,0.635,5,0.681,4.7,2013-14,Playoffs
201988,Patty Mills,1610612759,SAS,19,15,4,300.0,3,0,3,0.0,12,0.25,0,0.25,25.9,32,2,29,0.063,61,0.525,3,0.552,11.1,35,2,32,0.057,73,0.479,3,0.5,12.4,2013-14,Playoffs
202331,Paul George,1610612754,IND,19,10,9,781.0,13,3,10,0.231,62,0.21,4,0.224,9.8,132,24,108,0.182,197,0.67,7,0.695,6.4,145,27,118,0.186,259,0.56,11,0.585,6.7,2013-14,Playoffs
200794,Paul Millsap,1610612737,ATL,7,3,4,267.0,21,15,7,0.714,56,0.375,1,0.382,8.5,55,18,37,0.327,106,0.519,8,0.561,5.1,76,33,44,0.434,162,0.469,9,0.497,6.1,2013-14,Playoffs
1718,Paul Pierce,1610612751,BKN,12,5,7,368.0,4,1,3,0.25,17,0.235,2,0.267,9.6,50,11,39,0.22,88,0.568,4,0.595,7.1,54,12,42,0.222,105,0.514,6,0.545,7.3,2013-14,Playoffs
203544,Pero Antic,1610612737,ATL,7,3,4,170.0,10,8,2,0.8,31,0.323,2,0.345,4.2,17,3,14,0.176,46,0.37,6,0.425,4.8,27,11,16,0.407,77,0.351,8,0.391,4.6,2013-14,Playoffs
203103,Perry Jones III,1610612760,OKC,4,1,3,47.0,3,2,1,0.667,7,0.429,0,0.429,18.4,6,2,4,0.333,13,0.462,1,0.5,8.6,9,4,5,0.444,20,0.45,1,0.474,11.9,2013-14,Playoffs
1740,Rashard Lewis,1610612748,MIA,16,11,5,271.0,4,0,4,0.0,13,0.308,0,0.308,12.4,33,11,22,0.333,57,0.579,7,0.66,6.3,37,11,26,0.297,70,0.529,7,0.587,6.9,2013-14,Playoffs
2446,Rasual Butler,1610612754,IND,6,3,3,37.0,0,0,0,0.0,0,0.0,0,0.0,0.0,6,3,3,0.5,7,0.857,0,0.857,4.3,6,3,3,0.5,7,0.857,0,0.857,4.3,2013-14,Playoffs
951,Ray Allen,1610612748,MIA,20,13,7,527.0,13,6,7,0.462,37,0.351,4,0.394,8.6,54,7,47,0.13,94,0.574,8,0.628,8.8,67,13,54,0.194,131,0.511,12,0.563,8.8,2013-14,Playoffs
202704,Reggie Jackson,1610612760,OKC,19,10,9,531.0,13,3,10,0.231,44,0.295,1,0.302,8.2,59,12,49,0.203,134,0.44,12,0.484,8.5,72,15,59,0.208,178,0.404,13,0.436,8.5,2013-14,Playoffs
201577,Robin Lopez,1610612757,POR,11,5,6,367.0,47,36,12,0.766,130,0.362,3,0.37,4.9,54,20,33,0.37,122,0.443,10,0.482,4.6,101,56,45,0.554,252,0.401,13,0.423,4.7,2013-14,Playoffs
201579,Roy Hibbert,1610612754,IND,17,10,7,512.0,43,31,12,0.721,134,0.321,4,0.331,5.3,61,21,40,0.344,161,0.379,20,0.433,5.4,104,52,52,0.5,295,0.353,24,0.384,5.4,2013-14,Playoffs
201566,Russell Westbrook,1610612760,OKC,19,10,9,735.0,45,22,19,0.489,104,0.433,2,0.441,8.8,93,22,67,0.237,150,0.62,9,0.66,8.9,138,44,86,0.319,254,0.543,11,0.568,8.9,2013-14,Playoffs
200797,Ryan Hollins,1610612746,LAC,3,2,1,9.0,1,1,0,1.0,2,0.5,0,0.5,3.2,2,1,1,0.5,6,0.333,1,0.4,2.5,3,2,1,0.667,8,0.375,1,0.429,2.8,2013-14,Playoffs
2223,Samuel Dalembert,1610612742,DAL,7,3,4,135.0,23,14,9,0.609,56,0.411,1,0.418,5.1,36,12,24,0.333,55,0.655,5,0.72,3.2,59,26,33,0.441,111,0.532,6,0.562,3.9,2013-14,Playoffs
201586,Serge Ibaka,1610612760,OKC,17,10,7,581.0,31,20,8,0.645,87,0.356,2,0.365,4.5,85,27,56,0.318,178,0.478,21,0.541,4.0,116,47,64,0.405,265,0.438,23,0.479,4.1,2013-14,Playoffs
2203,Shane Battier,1610612748,MIA,8,4,4,128.0,1,1,0,1.0,10,0.1,0,0.1,6.2,9,2,7,0.222,20,0.45,2,0.5,4.8,10,3,7,0.3,30,0.333,2,0.357,4.9,2013-14,Playoffs
203499,Shane Larkin,1610612742,DAL,1,0,1,7.0,0,0,0,0.0,0,0.0,0,0.0,0.0,1,0,1,0.0,2,0.5,0,0.5,11.4,1,0,1,0.0,2,0.5,0,0.5,11.4,2013-14,Playoffs
2733,Shaun Livingston,1610612751,BKN,11,5,6,292.0,8,6,2,0.75,29,0.276,0,0.276,7.0,34,6,28,0.176,61,0.557,5,0.607,7.8,42,12,30,0.286,90,0.467,5,0.494,7.7,2013-14,Playoffs
1890,Shawn Marion,1610612742,DAL,7,3,4,193.0,14,7,7,0.5,28,0.5,0,0.5,8.8,23,8,15,0.348,36,0.639,1,0.657,6.8,37,15,22,0.405,64,0.578,1,0.587,7.6,2013-14,Playoffs
202714,Shelvin Mack,1610612737,ATL,7,3,4,118.0,3,0,3,0.0,10,0.3,0,0.3,21.7,10,0,10,0.0,27,0.37,5,0.455,7.9,13,0,13,0.0,37,0.351,5,0.406,11.1,2013-14,Playoffs
201939,Stephen Curry,1610612744,GSW,7,3,4,296.0,4,2,2,0.5,27,0.148,0,0.148,11.7,21,5,16,0.238,51,0.412,3,0.438,8.3,25,7,18,0.28,78,0.321,3,0.333,8.9,2013-14,Playoffs
2581,Steve Blake,1610612744,GSW,2,0,2,25.0,1,0,1,0.0,2,0.5,0,0.5,32.8,3,0,3,0.0,9,0.333,0,0.333,9.1,4,0,4,0.0,11,0.364,0,0.364,15.0,2013-14,Playoffs
200779,Steve Novak,1610612761,TOR,2,1,1,15.0,0,0,0,0.0,0,0.0,0,0.0,0.0,5,2,3,0.4,6,0.833,0,0.833,6.3,5,2,3,0.4,6,0.833,0,0.833,6.3,2013-14,Playoffs
203500,Steven Adams,1610612760,OKC,16,9,7,323.0,22,14,8,0.636,66,0.333,2,0.344,4.5,52,16,36,0.308,118,0.441,11,0.486,3.7,74,30,44,0.405,184,0.402,13,0.433,4.0,2013-14,Playoffs
201959,Taj Gibson,1610612741,CHI,5,1,4,154.0,21,12,7,0.571,36,0.583,1,0.6,6.3,10,4,6,0.4,39,0.256,5,0.294,5.9,31,16,13,0.516,75,0.413,6,0.449,6.2,2013-14,Playoffs
2419,Tayshaun Prince,1610612763,MEM,5,3,2,91.0,4,1,3,0.25,9,0.444,0,0.444,8.8,6,1,5,0.167,14,0.429,2,0.5,10.6,10,2,8,0.2,23,0.435,2,0.476,9.9,2013-14,Playoffs
203093,Terrence Jones,1610612745,HOU,6,2,4,138.0,17,10,8,0.588,40,0.425,2,0.447,5.0,20,9,11,0.45,39,0.513,2,0.541,8.6,37,19,19,0.514,79,0.468,4,0.493,6.9,2013-14,Playoffs
203082,Terrence Ross,1610612761,TOR,7,3,4,158.0,1,1,0,1.0,7,0.143,0,0.143,13.0,13,1,12,0.077,21,0.619,2,0.684,6.3,14,2,12,0.143,28,0.5,2,0.538,6.8,2013-14,Playoffs
200757,Thabo Sefolosha,1610612760,OKC,12,5,7,216.0,7,3,5,0.429,16,0.438,0,0.438,11.9,24,2,22,0.083,45,0.533,5,0.6,10.1,31,5,27,0.161,61,0.508,5,0.554,10.6,2013-14,Playoffs
203080,Thomas Robinson,1610612757,POR,9,5,4,108.0,10,7,3,0.7,34,0.294,4,0.333,5.3,18,4,13,0.222,38,0.474,3,0.514,4.3,28,11,16,0.393,72,0.389,7,0.431,4.6,2013-14,Playoffs
201168,Tiago Splitter,1610612759,SAS,23,16,7,516.0,45,27,16,0.6,100,0.45,1,0.455,7.4,95,32,62,0.337,159,0.597,16,0.664,5.3,140,59,78,0.421,259,0.541,17,0.579,5.9,2013-14,Playoffs
1495,Tim Duncan,1610612759,SAS,23,16,7,752.0,65,47,16,0.723,141,0.461,5,0.478,6.1,146,53,90,0.363,282,0.518,28,0.575,4.4,211,100,106,0.474,423,0.499,33,0.541,4.9,2013-14,Playoffs
201962,Toney Douglas,1610612748,MIA,3,1,2,17.0,1,0,1,0.0,1,1.0,0,1.0,24.1,3,1,2,0.333,3,1.0,0,1.0,10.4,4,1,3,0.25,4,1.0,0,1.0,13.8,2013-14,Playoffs
2754,Tony Allen,1610612763,MEM,7,3,4,230.0,23,19,4,0.826,66,0.348,4,0.371,7.5,31,6,25,0.194,49,0.633,5,0.705,8.6,54,25,29,0.463,115,0.47,9,0.509,8.1,2013-14,Playoffs
2225,Tony Parker,1610612759,SAS,19,14,5,601.0,5,0,5,0.0,44,0.114,0,0.114,18.6,38,3,36,0.079,90,0.422,6,0.452,11.8,43,3,41,0.07,134,0.321,6,0.336,12.6,2013-14,Playoffs
203503,Tony Snell,1610612741,CHI,5,1,4,46.0,0,0,0,0.0,1,0.0,0,0.0,0.0,6,0,6,0.0,11,0.545,1,0.6,6.0,6,0,6,0.0,12,0.5,1,0.545,6.0,2013-14,Playoffs
2772,Trevor Ariza,1610612764,WAS,11,6,5,407.0,21,10,11,0.476,50,0.42,2,0.438,10.8,77,13,62,0.169,106,0.726,6,0.77,5.0,98,23,73,0.235,156,0.628,8,0.662,6.3,2013-14,Playoffs
202344,Trevor Booker,1610612764,WAS,8,5,3,137.0,16,9,7,0.563,41,0.39,1,0.4,7.2,23,7,16,0.304,50,0.46,5,0.511,5.7,39,16,23,0.41,91,0.429,6,0.459,6.3,2013-14,Playoffs
203584,Troy Daniels,1610612745,HOU,3,2,1,58.0,3,0,3,0.0,6,0.5,1,0.6,16.0,6,3,3,0.5,15,0.4,3,0.5,4.7,9,3,6,0.333,21,0.429,4,0.529,8.5,2013-14,Playoffs
201946,Tyler Hansbrough,1610612761,TOR,3,0,3,29.0,2,2,0,1.0,9,0.222,0,0.222,7.5,4,1,3,0.25,11,0.364,2,0.444,8.2,6,3,3,0.5,20,0.3,2,0.333,8.0,2013-14,Playoffs
2617,Udonis Haslem,1610612748,MIA,14,9,5,166.0,12,9,3,0.75,31,0.387,0,0.387,5.6,29,10,20,0.345,52,0.558,5,0.617,4.4,41,19,23,0.463,83,0.494,5,0.526,4.8,2013-14,Playoffs
201964,Victor Claver,1610612757,POR,2,0,2,7.0,0,0,0,0.0,1,0.0,0,0.0,0.0,5,2,3,0.4,7,0.714,0,0.714,4.4,5,2,3,0.4,8,0.625,0,0.625,4.4,2013-14,Playoffs
1713,Vince Carter,1610612742,DAL,7,3,4,190.0,7,4,3,0.571,21,0.333,2,0.368,7.7,18,6,12,0.333,39,0.462,4,0.514,5.7,25,10,15,0.4,60,0.417,6,0.463,6.2,2013-14,Playoffs
201961,Wayne Ellington,1610612742,DAL,1,0,1,10.0,0,0,0,0.0,1,0.0,0,0.0,0.0,2,0,2,0.0,2,1.0,0,1.0,4.0,2,0,2,0.0,3,0.667,0,0.667,4.0,2013-14,Playoffs
202083,Wesley Matthews,1610612757,POR,11,5,6,426.0,7,3,5,0.429,30,0.233,0,0.233,17.7,36,5,31,0.139,73,0.493,10,0.571,9.4,43,8,36,0.186,103,0.417,10,0.462,10.9,2013-14,Playoffs
203115,Will Barton,1610612757,POR,5,1,4,80.0,5,3,2,0.6,11,0.455,0,0.455,9.3,7,3,4,0.429,16,0.438,2,0.5,9.3,12,6,6,0.5,27,0.444,2,0.48,9.3,2013-14,Playoffs
2584,Willie Green,1610612746,LAC,4,2,2,16.0,0,0,0,0.0,1,0.0,0,0.0,0.0,7,0,7,0.0,5,1.4,0,1.4,6.5,7,0,7,0.0,6,1.167,0,1.167,6.5,2013-14,Playoffs
2216,Zach Randolph,1610612763,MEM,6,3,3,234.0,17,14,3,0.824,72,0.236,6,0.258,4.2,35,13,22,0.371,66,0.53,10,0.625,5.5,52,27,25,0.519,138,0.377,16,0.426,5.1,2013-14,Playoffs
201985,AJ Price,1610612739,CLE,16,6,10,237.0,6,1,5,0.167,16,0.375,0,0.375,15.1,26,6,20,0.231,41,0.634,3,0.684,11.7,32,7,25,0.219,57,0.561,3,0.593,12.3,2014-15,Regular%20Season
201166,Aaron Brooks,1610612741,CHI,72,44,28,1679.0,32,12,18,0.375,141,0.227,6,0.237,11.9,134,20,115,0.149,272,0.493,19,0.53,10.3,166,32,133,0.193,413,0.402,25,0.428,10.6,2014-15,Regular%20Season
203932,Aaron Gordon,1610612753,ORL,45,14,31,771.0,46,34,11,0.739,107,0.43,2,0.438,5.5,123,36,88,0.293,206,0.597,18,0.654,5.8,169,70,99,0.414,313,0.54,20,0.577,5.7,2014-15,Regular%20Season
203940,Adreian Payne,1610612750,MIN,31,6,25,738.0,48,26,25,0.542,116,0.414,5,0.432,8.0,114,35,77,0.307,187,0.61,16,0.667,4.5,162,61,102,0.377,303,0.535,21,0.574,5.6,2014-15,Regular%20Season
201143,Al Horford,1610612737,ATL,76,56,20,2318.0,131,79,51,0.603,265,0.494,10,0.514,7.3,413,177,234,0.429,707,0.584,54,0.632,5.7,544,256,285,0.471,972,0.56,64,0.599,6.1,2014-15,Regular%20Season
2744,Al Jefferson,1610612766,CHA,65,25,40,1992.0,99,58,40,0.586,237,0.418,9,0.434,8.6,449,155,290,0.345,701,0.641,51,0.691,4.1,548,213,330,0.389,938,0.584,60,0.624,4.9,2014-15,Regular%20Season
202329,Al-Farouq Aminu,1610612742,DAL,69,41,28,1347.0,114,66,46,0.579,245,0.465,18,0.502,6.7,228,76,148,0.333,385,0.592,46,0.673,5.6,342,142,194,0.415,630,0.543,64,0.604,6.0,2014-15,Regular%20Season
101187,Alan Anderson,1610612751,BKN,66,31,35,1607.0,31,15,15,0.484,119,0.261,7,0.277,10.4,173,37,132,0.214,301,0.575,34,0.648,8.2,204,52,147,0.255,420,0.486,41,0.538,8.6,2014-15,Regular%20Season
202692,Alec Burks,1610612762,UTA,27,9,18,899.0,19,10,9,0.526,83,0.229,4,0.241,9.4,95,18,76,0.189,163,0.583,17,0.651,6.8,114,28,85,0.246,246,0.463,21,0.507,7.2,2014-15,Regular%20Season
203945,Alex Kirk,1610612739,CLE,1,0,1,2.0,1,1,0,1.0,2,0.5,0,0.5,4.1,0,0,0,0.0,0,0.0,0,0.0,0.0,1,1,0,1.0,2,0.5,0,0.5,4.1,2014-15,Regular%20Season
203458,Alex Len,1610612756,PHX,66,34,32,1488.0,142,101,38,0.711,328,0.433,8,0.444,5.1,312,142,169,0.455,582,0.536,68,0.607,3.6,454,243,207,0.535,910,0.499,76,0.544,4.1,2014-15,Regular%20Season
203144,Alexey Shved,1610612752,NYK,29,6,23,632.0,23,11,13,0.478,78,0.295,4,0.311,11.6,76,17,59,0.224,122,0.623,8,0.667,8.4,99,28,72,0.283,200,0.495,12,0.527,9.3,2014-15,Regular%20Season
201582,Alexis Ajinca,1610612740,NOP,62,37,25,937.0,104,71,33,0.683,221,0.471,4,0.479,5.5,211,81,133,0.384,331,0.637,21,0.681,4.1,315,152,166,0.483,552,0.571,25,0.598,4.6,2014-15,Regular%20Season
203459,Allen Crabbe,1610612757,POR,37,28,9,598.0,7,2,4,0.286,32,0.219,0,0.219,14.3,66,11,55,0.167,118,0.559,7,0.595,5.9,73,13,59,0.178,150,0.487,7,0.51,6.6,2014-15,Regular%20Season
202087,Alonzo Gee,1610612757,POR,37,10,27,540.0,37,20,16,0.541,107,0.346,7,0.37,8.0,57,19,38,0.333,96,0.594,8,0.648,7.5,94,39,54,0.415,203,0.463,15,0.5,7.7,2014-15,Regular%20Season
2405,Amar'e Stoudemire,1610612742,DAL,58,19,39,1236.0,109,83,24,0.761,283,0.385,8,0.396,5.0,218,95,123,0.436,400,0.545,33,0.594,3.9,327,178,147,0.544,683,0.479,41,0.509,4.2,2014-15,Regular%20Season
101161,Amir Johnson,1610612761,TOR,74,44,30,1962.0,159,112,46,0.704,381,0.417,11,0.43,5.4,297,142,152,0.478,630,0.471,68,0.528,4.3,456,254,198,0.557,1011,0.451,79,0.489,4.7,2014-15,Regular%20Season
2760,Anderson Varejao,1610612739,CLE,26,16,10,636.0,57,30,24,0.526,143,0.399,3,0.407,6.1,113,42,71,0.372,220,0.514,19,0.562,4.7,170,72,95,0.424,363,0.468,22,0.499,5.2,2014-15,Regular%20Season
203958,Andre Dawkins,1610612748,MIA,2,1,1,18.0,0,0,0,0.0,0,0.0,0,0.0,0.0,2,2,0,1.0,3,0.667,1,1.0,9.6,2,2,0,1.0,3,0.667,1,1.0,9.6,2014-15,Regular%20Season
203083,Andre Drummond,1610612765,DET,82,32,50,2502.0,437,314,110,0.719,785,0.557,12,0.565,4.8,667,250,416,0.375,995,0.67,66,0.718,3.9,1104,564,526,0.511,1780,0.62,78,0.649,4.3,2014-15,Regular%20Season
2738,Andre Iguodala,1610612744,GSW,73,61,12,1982.0,44,14,30,0.318,147,0.299,3,0.306,13.0,213,43,179,0.202,358,0.595,16,0.623,9.1,257,57,209,0.222,505,0.509,19,0.529,9.8,2014-15,Regular%20Season
1889,Andre Miller,1610612758,SAC,61,33,28,1023.0,37,23,13,0.622,128,0.289,7,0.306,8.2,116,16,100,0.138,177,0.655,9,0.69,10.8,153,39,113,0.255,305,0.502,16,0.529,10.2,2014-15,Regular%20Season
203460,Andre Roberson,1610612760,OKC,63,39,24,1234.0,60,26,31,0.433,204,0.294,4,0.3,8.2,195,55,140,0.282,315,0.619,27,0.677,5.9,255,81,171,0.318,519,0.491,31,0.523,6.4,2014-15,Regular%20Season
200745,Andrea Bargnani,1610612752,NYK,27,5,22,765.0,32,17,15,0.531,87,0.368,5,0.39,8.0,95,27,66,0.284,166,0.572,11,0.613,5.5,127,44,81,0.346,253,0.502,16,0.536,6.1,2014-15,Regular%20Season
1905,Andrei Kirilenko,1610612751,BKN,5,3,2,29.0,2,1,1,0.5,6,0.333,0,0.333,15.2,6,1,5,0.167,9,0.667,3,1.0,3.1,8,2,6,0.25,15,0.533,3,0.667,6.1,2014-15,Regular%20Season
101106,Andrew Bogut,1610612744,GSW,67,58,9,1583.0,141,105,34,0.745,270,0.522,3,0.528,5.0,402,183,212,0.455,705,0.57,58,0.621,3.9,543,288,246,0.53,975,0.557,61,0.594,4.2,2014-15,Regular%20Season
203094,Andrew Nicholson,1610612753,ORL,29,10,19,438.0,17,9,7,0.529,43,0.395,0,0.395,7.3,65,29,36,0.446,128,0.508,16,0.58,4.3,82,38,43,0.463,171,0.48,16,0.529,4.9,2014-15,Regular%20Season
203952,Andrew Wiggins,1610612750,MIN,81,16,65,2937.0,134,91,40,0.679,430,0.312,13,0.321,6.4,239,76,163,0.318,454,0.526,30,0.564,8.1,373,167,203,0.448,884,0.422,43,0.444,7.5,2014-15,Regular%20Season
203461,Anthony Bennett,1610612750,MIN,52,12,40,871.0,51,33,17,0.647,126,0.405,4,0.418,6.4,161,51,109,0.317,255,0.631,16,0.674,4.6,212,84,126,0.396,381,0.556,20,0.587,5.0,2014-15,Regular%20Season
203076,Anthony Davis,1610612740,NOP,68,39,29,2455.0,173,118,53,0.682,360,0.481,12,0.497,5.8,523,204,316,0.39,730,0.716,35,0.753,4.8,696,322,369,0.463,1090,0.639,47,0.667,5.1,2014-15,Regular%20Season
201627,Anthony Morrow,1610612760,OKC,60,33,27,1536.0,40,16,24,0.4,98,0.408,2,0.417,12.8,155,38,115,0.245,224,0.692,18,0.752,9.0,195,54,139,0.277,322,0.606,20,0.646,9.8,2014-15,Regular%20Season
201229,Anthony Tolliver,1610612765,DET,66,33,33,1367.0,51,16,32,0.314,132,0.386,4,0.398,8.5,185,56,131,0.303,389,0.476,39,0.529,5.0,236,72,163,0.305,521,0.453,43,0.494,5.7,2014-15,Regular%20Season
203462,Archie Goodwin,1610612756,PHX,32,12,20,446.0,27,18,7,0.667,85,0.318,3,0.329,6.6,47,10,39,0.213,84,0.56,6,0.603,6.5,74,28,46,0.378,169,0.438,9,0.463,6.6,2014-15,Regular%20Season
202620,Arinze Onuaku,1610612750,MIN,4,0,4,68.0,7,6,1,0.857,15,0.467,0,0.467,3.5,14,4,10,0.286,18,0.778,0,0.778,4.9,21,10,11,0.476,33,0.636,0,0.636,4.4,2014-15,Regular%20Season
203382,Aron Baynes,1610612759,SAS,66,45,21,1106.0,108,75,31,0.694,308,0.351,7,0.359,4.9,209,85,123,0.407,370,0.565,40,0.633,4.4,317,160,154,0.505,678,0.468,47,0.502,4.6,2014-15,Regular%20Season
201167,Arron Afflalo,1610612757,POR,75,34,41,2418.0,27,12,16,0.444,115,0.235,4,0.243,16.2,220,17,203,0.077,355,0.62,26,0.669,9.6,247,29,219,0.117,470,0.526,30,0.561,10.4,2014-15,Regular%20Season
201948,Austin Daye,1610612737,ATL,24,11,13,323.0,10,4,6,0.4,24,0.417,0,0.417,14.9,65,21,43,0.323,103,0.631,10,0.699,6.2,75,25,49,0.333,127,0.591,10,0.641,7.4,2014-15,Regular%20Season
203085,Austin Rivers,1610612746,LAC,65,41,24,1373.0,27,10,17,0.37,109,0.248,6,0.262,11.6,125,19,108,0.152,255,0.49,26,0.546,8.5,152,29,125,0.191,364,0.418,32,0.458,9.0,2014-15,Regular%20Season
202340,Avery Bradley,1610612738,BOS,72,34,38,2292.0,46,13,37,0.283,181,0.254,8,0.266,14.0,195,26,173,0.133,379,0.515,42,0.579,6.1,241,39,210,0.162,560,0.43,50,0.473,7.8,2014-15,Regular%20Season
2732,Ben Gordon,1610612753,ORL,36,9,27,560.0,6,1,6,0.167,32,0.188,1,0.194,14.0,57,10,48,0.175,93,0.613,8,0.671,9.1,63,11,54,0.175,125,0.504,9,0.543,9.7,2014-15,Regular%20Season
203463,Ben McLemore,1610612758,SAC,77,27,50,2509.0,31,5,24,0.161,149,0.208,6,0.217,15.1,210,33,177,0.157,430,0.488,45,0.545,7.9,241,38,201,0.158,579,0.416,51,0.456,8.7,2014-15,Regular%20Season
2757,Beno Udrih,1610612763,MEM,67,47,20,1314.0,20,6,14,0.3,69,0.29,3,0.303,15.2,123,15,110,0.122,239,0.515,19,0.559,10.2,143,21,124,0.147,308,0.464,22,0.5,10.9,2014-15,Regular%20Season
203108,Bernard James,1610612742,DAL,12,6,6,147.0,18,11,7,0.611,37,0.486,2,0.514,5.4,21,7,14,0.333,39,0.538,4,0.6,5.6,39,18,21,0.462,76,0.513,6,0.557,5.5,2014-15,Regular%20Season
202687,Bismack Biyombo,1610612766,CHA,61,25,36,1214.0,159,124,34,0.78,384,0.414,16,0.432,5.0,248,89,156,0.359,448,0.554,39,0.606,4.5,407,213,190,0.523,832,0.489,55,0.524,4.7,2014-15,Regular%20Season
201933,Blake Griffin,1610612746,LAC,67,47,20,2356.0,126,75,44,0.595,315,0.4,20,0.427,7.2,382,131,249,0.343,680,0.562,47,0.603,5.0,508,206,293,0.406,995,0.511,67,0.547,5.5,2014-15,Regular%20Season
202711,Bojan Bogdanovic,1610612751,BKN,66,30,36,1666.0,50,36,14,0.72,164,0.305,4,0.313,7.5,163,23,140,0.141,255,0.639,9,0.663,8.5,213,59,154,0.277,419,0.508,13,0.525,8.2,2014-15,Regular%20Season
2564,Boris Diaw,1610612759,SAS,81,55,26,1984.0,78,47,29,0.603,226,0.345,14,0.368,7.2,270,85,183,0.315,514,0.525,49,0.581,5.8,348,132,212,0.379,740,0.47,63,0.514,6.1,2014-15,Regular%20Season
203078,Bradley Beal,1610612764,WAS,61,37,24,2061.0,57,28,28,0.491,184,0.31,8,0.324,10.8,184,38,143,0.207,305,0.603,24,0.655,6.7,241,66,171,0.274,489,0.493,32,0.527,7.7,2014-15,Regular%20Season
201148,Brandan Wright,1610612756,PHX,73,36,37,1430.0,128,65,60,0.508,246,0.52,8,0.538,7.6,193,85,105,0.44,395,0.489,41,0.545,5.2,321,150,165,0.467,641,0.501,49,0.542,6.2,2014-15,Regular%20Season
101138,Brandon Bass,1610612738,BOS,80,40,40,1910.0,139,80,57,0.576,308,0.451,14,0.473,7.1,259,75,182,0.29,444,0.583,38,0.638,6.5,398,155,239,0.389,752,0.529,52,0.569,6.7,2014-15,Regular%20Season
203561,Brandon Davies,1610612755,PHI,24,4,20,415.0,37,20,13,0.541,76,0.487,1,0.493,7.0,45,12,33,0.267,97,0.464,10,0.517,5.3,82,32,46,0.39,173,0.474,11,0.506,6.0,2014-15,Regular%20Season
201943,Brandon Jennings,1610612765,DET,39,16,23,1111.0,21,8,15,0.381,92,0.228,4,0.239,13.3,83,10,73,0.12,159,0.522,12,0.565,10.1,104,18,88,0.173,251,0.414,16,0.443,11.0,2014-15,Regular%20Season
202688,Brandon Knight,1610612756,PHX,59,31,28,1936.0,27,14,12,0.519,126,0.214,8,0.229,12.3,212,29,183,0.137,400,0.53,30,0.573,8.1,239,43,195,0.18,526,0.454,38,0.49,8.6,2014-15,Regular%20Season
201575,Brandon Rush,1610612744,GSW,21,19,2,212.0,4,2,2,0.5,12,0.333,0,0.333,12.2,37,10,27,0.27,58,0.638,4,0.685,5.4,41,12,29,0.293,70,0.586,4,0.621,6.1,2014-15,Regular%20Season
2217,Brendan Haywood,1610612739,CLE,12,7,5,89.0,6,3,3,0.5,17,0.353,0,0.353,6.5,23,6,16,0.261,34,0.676,5,0.793,4.8,29,9,19,0.31,51,0.569,5,0.63,5.2,2014-15,Regular%20Season
203148,Brian Roberts,1610612766,CHA,55,21,34,1068.0,13,2,11,0.154,50,0.26,6,0.295,18.9,96,3,96,0.031,170,0.565,16,0.623,10.1,109,5,107,0.046,220,0.495,22,0.551,11.1,2014-15,Regular%20Season
201572,Brook Lopez,1610612751,BKN,72,34,38,2100.0,214,153,47,0.715,396,0.54,5,0.547,5.5,321,145,171,0.452,576,0.557,50,0.61,5.4,535,298,218,0.557,972,0.55,55,0.583,5.4,2014-15,Regular%20Season
203998,Bruno Caboclo,1610612761,TOR,2,2,0,14.0,1,1,0,1.0,4,0.25,1,0.333,2.3,1,0,1,0.0,2,0.5,0,0.5,22.0,2,1,1,0.5,6,0.333,1,0.4,12.1,2014-15,Regular%20Season
203955,Bryce Cotton,1610612762,UTA,9,4,5,147.0,3,0,3,0.0,6,0.5,0,0.5,22.1,15,1,14,0.067,23,0.652,0,0.652,9.6,18,1,17,0.056,29,0.621,0,0.621,11.7,2014-15,Regular%20Season
201228,C.J. Watson,1610612754,IND,55,24,31,1370.0,18,3,16,0.167,72,0.25,3,0.261,14.7,145,15,129,0.103,268,0.541,22,0.589,8.5,163,18,145,0.11,340,0.479,25,0.517,9.2,2014-15,Regular%20Season
203912,C.J. Wilcox,1610612746,LAC,5,3,2,37.0,1,1,0,1.0,3,0.333,0,0.333,16.8,6,1,5,0.167,12,0.5,0,0.5,6.0,7,2,5,0.286,15,0.467,0,0.467,7.6,2014-15,Regular%20Season
203468,CJ McCollum,1610612757,POR,37,25,12,701.0,14,5,9,0.357,48,0.292,2,0.304,10.6,77,13,64,0.169,141,0.546,10,0.588,8.7,91,18,73,0.198,189,0.481,12,0.514,9.0,2014-15,Regular%20Season
101139,CJ Miles,1610612754,IND,64,29,35,1743.0,18,3,12,0.167,96,0.188,0,0.188,15.2,196,43,151,0.219,328,0.598,25,0.647,7.5,214,46,163,0.215,424,0.505,25,0.536,8.1,2014-15,Regular%20Season
203946,Cameron Bairstow,1610612741,CHI,5,3,2,33.0,6,6,0,1.0,12,0.5,0,0.5,5.8,2,0,2,0.0,7,0.286,0,0.286,3.3,8,6,2,0.75,19,0.421,0,0.421,5.1,2014-15,Regular%20Season
201171,Carl Landry,1610612758,SAC,65,24,41,1164.0,99,60,37,0.606,240,0.413,7,0.425,6.4,169,50,118,0.296,289,0.585,29,0.65,6.1,268,110,155,0.41,529,0.507,36,0.544,6.3,2014-15,Regular%20Season
2430,Carlos Boozer,1610612747,LAL,71,18,53,1692.0,111,76,34,0.685,311,0.357,10,0.369,6.1,371,126,238,0.34,572,0.649,39,0.696,4.7,482,202,272,0.419,883,0.546,49,0.578,5.0,2014-15,Regular%20Season
2546,Carmelo Anthony,1610612752,NYK,39,10,29,1400.0,72,47,24,0.653,161,0.447,5,0.462,7.1,189,42,147,0.222,293,0.645,21,0.695,5.9,261,89,171,0.341,454,0.575,26,0.61,6.2,2014-15,Regular%20Season
2406,Caron Butler,1610612765,DET,67,25,42,1430.0,21,9,12,0.429,117,0.179,2,0.183,10.6,175,44,128,0.251,325,0.538,32,0.597,6.4,196,53,140,0.27,442,0.443,34,0.48,6.9,2014-15,Regular%20Season
201858,Cartier Martin,1610612765,DET,10,3,7,108.0,0,0,0,0.0,5,0.0,0,0.0,0.0,19,6,12,0.316,22,0.864,1,0.905,6.2,19,6,12,0.316,27,0.704,1,0.731,6.2,2014-15,Regular%20Season
202718,Chandler Parsons,1610612742,DAL,66,41,25,2186.0,64,34,29,0.531,235,0.272,12,0.287,9.9,259,57,203,0.22,459,0.564,27,0.6,7.3,323,91,232,0.282,694,0.465,39,0.493,7.8,2014-15,Regular%20Season
101112,Channing Frye,1610612753,ORL,72,22,50,1837.0,27,14,11,0.519,58,0.466,1,0.474,9.9,266,100,166,0.376,463,0.575,34,0.62,4.6,293,114,177,0.389,521,0.562,35,0.603,5.0,2014-15,Regular%20Season
101111,Charlie Villanueva,1610612742,DAL,49,28,21,581.0,30,16,11,0.533,60,0.5,2,0.517,7.2,119,34,85,0.286,177,0.672,7,0.7,4.7,149,50,96,0.336,237,0.629,9,0.654,5.2,2014-15,Regular%20Season
201978,Chase Budinger,1610612750,MIN,56,5,51,1226.0,33,18,16,0.545,103,0.32,3,0.33,8.9,164,39,125,0.238,270,0.607,18,0.651,7.3,197,57,141,0.289,373,0.528,21,0.56,7.7,2014-15,Regular%20Season
2365,Chris Andersen,1610612748,MIA,57,25,32,1091.0,74,52,19,0.703,212,0.349,5,0.357,5.2,217,94,121,0.433,408,0.532,42,0.593,3.8,291,146,140,0.502,620,0.469,47,0.508,4.2,2014-15,Regular%20Season
2547,Chris Bosh,1610612748,MIA,44,19,25,1556.0,46,26,16,0.565,127,0.362,5,0.377,9.8,264,90,172,0.341,449,0.588,35,0.638,5.1,310,116,188,0.374,576,0.538,40,0.578,5.8,2014-15,Regular%20Season
203142,Chris Copeland,1610612754,IND,35,14,21,696.0,23,14,10,0.609,74,0.311,1,0.315,7.6,88,18,69,0.205,134,0.657,12,0.721,5.6,111,32,79,0.288,208,0.534,13,0.569,6.1,2014-15,Regular%20Season
201604,Chris Douglas-Roberts,1610612746,LAC,7,3,4,85.0,1,0,1,0.0,6,0.167,0,0.167,20.9,11,3,8,0.273,13,0.846,0,0.846,6.6,12,3,9,0.25,19,0.632,0,0.632,7.8,2014-15,Regular%20Season
203187,Chris Johnson,1610612762,UTA,22,6,16,437.0,8,3,5,0.375,31,0.258,1,0.267,5.5,47,14,33,0.298,87,0.54,8,0.595,8.0,55,17,38,0.309,118,0.466,9,0.505,7.6,2014-15,Regular%20Season
2549,Chris Kaman,1610612757,POR,73,47,26,1394.0,149,105,41,0.705,332,0.449,6,0.457,5.8,335,153,179,0.457,565,0.593,36,0.633,4.0,484,258,220,0.533,897,0.54,42,0.566,4.5,2014-15,Regular%20Season
101108,Chris Paul,1610612746,LAC,82,56,26,2857.0,52,21,29,0.404,206,0.252,6,0.26,15.7,324,59,268,0.182,589,0.55,41,0.591,9.6,376,80,297,0.213,795,0.473,47,0.503,10.5,2014-15,Regular%20Season
101236,Chuck Hayes,1610612761,TOR,23,14,9,216.0,18,11,7,0.611,45,0.4,3,0.429,5.2,33,18,15,0.545,67,0.493,8,0.559,4.1,51,29,22,0.569,112,0.455,11,0.505,4.5,2014-15,Regular%20Season
203921,Cleanthony Early,1610612752,NYK,32,5,27,619.0,22,13,8,0.591,70,0.314,4,0.333,12.3,75,24,53,0.32,150,0.5,20,0.577,5.8,97,37,61,0.381,220,0.441,24,0.495,7.2,2014-15,Regular%20Season
203991,Clint Capela,1610612745,HOU,9,6,3,82.0,10,7,2,0.7,18,0.556,0,0.556,6.1,26,15,11,0.577,41,0.634,5,0.722,5.5,36,22,13,0.611,59,0.61,5,0.667,5.7,2014-15,Regular%20Season
203469,Cody Zeller,1610612766,CHA,61,26,35,1470.0,97,55,37,0.567,285,0.34,7,0.349,6.5,265,87,178,0.328,482,0.55,42,0.602,5.2,362,142,215,0.392,767,0.472,49,0.504,5.5,2014-15,Regular%20Season
202332,Cole Aldrich,1610612752,NYK,57,11,46,955.0,100,63,34,0.63,232,0.431,4,0.439,6.2,234,86,149,0.368,375,0.624,27,0.672,3.5,334,149,183,0.446,607,0.55,31,0.58,4.3,2014-15,Regular%20Season
201147,Corey Brewer,1610612745,HOU,74,39,35,1964.0,79,40,38,0.506,226,0.35,10,0.366,9.5,213,49,165,0.23,385,0.553,29,0.598,8.8,292,89,203,0.305,611,0.478,39,0.51,9.0,2014-15,Regular%20Season
203928,Cory Jefferson,1610612751,BKN,45,17,28,512.0,47,33,14,0.702,104,0.452,2,0.461,6.5,98,26,71,0.265,171,0.573,9,0.605,4.7,145,59,85,0.407,275,0.527,11,0.549,5.2,2014-15,Regular%20Season
202709,Cory Joseph,1610612759,SAS,68,45,23,1346.0,44,22,21,0.5,152,0.289,7,0.303,11.7,148,31,118,0.209,255,0.58,22,0.635,8.3,192,53,139,0.276,407,0.472,29,0.508,9.1,2014-15,Regular%20Season
201584,Courtney Lee,1610612763,MEM,73,48,25,2247.0,21,6,15,0.286,87,0.241,3,0.25,12.6,157,25,134,0.159,291,0.54,15,0.569,10.0,178,31,149,0.174,378,0.471,18,0.494,10.3,2014-15,Regular%20Season
201571,D.J. Augustin,1610612760,OKC,68,33,35,1677.0,20,6,14,0.3,109,0.183,4,0.19,20.0,141,11,134,0.078,234,0.603,14,0.641,12.0,161,17,148,0.106,343,0.469,18,0.495,13.0,2014-15,Regular%20Season
2563,Dahntay Jones,1610612746,LAC,9,7,2,54.0,1,0,1,0.0,5,0.2,0,0.2,1.4,10,3,7,0.3,9,1.111,0,1.111,5.8,11,3,8,0.273,14,0.786,0,0.786,5.4,2014-15,Regular%20Season
203081,Damian Lillard,1610612757,POR,80,50,30,2853.0,49,15,36,0.306,227,0.216,10,0.226,14.6,329,48,283,0.146,609,0.54,50,0.589,7.4,378,63,319,0.167,836,0.452,60,0.487,8.3,2014-15,Regular%20Season
204014,Damjan Rudez,1610612754,IND,28,13,15,510.0,8,2,6,0.25,28,0.286,0,0.286,13.7,39,9,31,0.231,57,0.684,2,0.709,11.1,47,11,37,0.234,85,0.553,2,0.566,11.5,2014-15,Regular%20Season
201568,Danilo Gallinari,1610612743,DEN,58,23,35,1408.0,31,15,16,0.484,125,0.248,5,0.258,9.9,187,34,153,0.182,334,0.56,25,0.605,6.5,218,49,169,0.225,459,0.475,30,0.508,7.0,2014-15,Regular%20Season
101122,Danny Granger,1610612756,PHX,25,9,16,527.0,20,14,6,0.7,58,0.345,2,0.357,12.0,53,15,40,0.283,122,0.434,16,0.5,7.9,73,29,46,0.397,180,0.406,18,0.451,8.9,2014-15,Regular%20Season
201980,Danny Green,1610612759,SAS,79,53,26,2281.0,54,19,32,0.352,159,0.34,13,0.37,13.3,289,84,204,0.291,558,0.518,42,0.56,5.7,343,103,236,0.3,717,0.478,55,0.518,6.8,2014-15,Regular%20Season
201967,Dante Cunningham,1610612740,NOP,61,35,26,1556.0,70,31,38,0.443,207,0.338,10,0.355,9.3,186,51,134,0.274,335,0.555,22,0.594,6.6,256,82,172,0.32,542,0.472,32,0.502,7.4,2014-15,Regular%20Season
203957,Dante Exum,1610612762,UTA,68,33,35,1522.0,27,5,21,0.185,71,0.38,1,0.386,16.7,104,14,88,0.135,213,0.488,11,0.515,11.0,131,19,109,0.145,284,0.461,12,0.482,12.2,2014-15,Regular%20Season
203121,Darius Miller,1610612740,NOP,1,0,1,4.0,0,0,0,0.0,0,0.0,0,0.0,0.0,1,1,0,1.0,1,1.0,0,1.0,3.6,1,1,0,1.0,1,1.0,0,1.0,3.6,2014-15,Regular%20Season
202721,Darius Morris,1610612751,BKN,17,7,10,181.0,7,3,4,0.429,18,0.389,0,0.389,15.0,20,3,18,0.15,33,0.606,3,0.667,11.6,27,6,22,0.222,51,0.529,3,0.563,12.5,2014-15,Regular%20Season
201589,Darrell Arthur,1610612743,DEN,49,18,31,881.0,53,29,24,0.547,105,0.505,0,0.505,7.8,118,46,72,0.39,257,0.459,27,0.513,5.3,171,75,96,0.439,362,0.472,27,0.51,6.1,2014-15,Regular%20Season
201954,Darren Collison,1610612758,SAC,42,14,28,1461.0,19,4,15,0.211,95,0.2,5,0.211,17.3,124,14,110,0.113,229,0.541,19,0.59,10.5,143,18,125,0.126,324,0.441,24,0.477,11.4,2014-15,Regular%20Season
101135,David Lee,1610612744,GSW,47,35,12,881.0,81,50,29,0.617,193,0.42,5,0.431,6.7,176,70,103,0.398,278,0.633,17,0.674,4.4,257,120,132,0.467,471,0.546,22,0.572,5.1,2014-15,Regular%20Season
204065,David Stockton,1610612758,SAC,1,0,1,7.0,0,0,0,0.0,1,0.0,0,0.0,0.0,2,0,2,0.0,2,1.0,0,1.0,11.4,2,0,2,0.0,3,0.667,0,0.667,11.4,2014-15,Regular%20Season
204033,David Wear,1610612758,SAC,2,0,2,7.0,2,1,1,0.5,4,0.5,0,0.5,9.8,0,0,0,0.0,1,0.0,0,0.0,0.0,2,1,1,0.5,5,0.4,0,0.4,9.8,2014-15,Regular%20Season
2561,David West,1610612754,IND,66,32,34,1895.0,108,69,35,0.639,234,0.462,8,0.478,7.4,341,98,242,0.287,557,0.612,36,0.655,5.4,449,167,277,0.372,791,0.568,44,0.601,5.8,2014-15,Regular%20Season
201599,DeAndre Jordan,1610612746,LAC,82,56,26,2820.0,397,274,112,0.69,744,0.534,12,0.542,5.3,829,240,581,0.29,1163,0.713,77,0.763,4.6,1226,514,693,0.419,1907,0.643,89,0.674,4.8,2014-15,Regular%20Season
201971,DeJuan Blair,1610612764,WAS,23,10,13,169.0,16,14,2,0.875,52,0.308,1,0.314,4.3,40,12,28,0.3,61,0.656,8,0.755,4.1,56,26,30,0.464,113,0.496,9,0.538,4.1,2014-15,Regular%20Season
201942,DeMar DeRozan,1610612761,TOR,59,36,23,2061.0,41,14,27,0.341,156,0.263,4,0.27,14.8,236,50,183,0.212,371,0.636,28,0.688,7.2,277,64,210,0.231,527,0.526,32,0.56,8.3,2014-15,Regular%20Season
202326,DeMarcus Cousins,1610612758,SAC,59,23,36,2013.0,185,131,41,0.708,449,0.412,8,0.42,5.2,562,213,351,0.379,837,0.671,46,0.71,4.2,747,344,392,0.461,1286,0.581,54,0.606,4.4,2014-15,Regular%20Season
201960,DeMarre Carroll,1610612737,ATL,70,53,17,2189.0,99,55,44,0.556,264,0.375,11,0.391,9.3,273,46,226,0.168,441,0.619,43,0.686,6.9,372,101,270,0.272,705,0.528,54,0.571,7.6,2014-15,Regular%20Season
203471,Dennis Schroder,1610612737,ATL,70,50,20,1388.0,29,12,17,0.414,125,0.232,6,0.244,14.2,135,15,121,0.111,266,0.508,24,0.558,8.1,164,27,138,0.165,391,0.419,30,0.454,9.2,2014-15,Regular%20Season
101114,Deron Williams,1610612751,BKN,66,33,33,2087.0,29,12,18,0.414,129,0.225,5,0.234,13.9,208,23,184,0.111,397,0.524,29,0.565,9.0,237,35,202,0.148,526,0.451,34,0.482,9.6,2014-15,Regular%20Season
202324,Derrick Favors,1610612762,UTA,73,33,40,2255.0,195,153,40,0.785,431,0.452,14,0.468,5.6,411,179,234,0.436,718,0.572,54,0.619,4.8,606,332,274,0.548,1149,0.527,68,0.561,5.1,2014-15,Regular%20Season
201565,Derrick Rose,1610612741,CHI,50,33,17,1520.0,35,20,14,0.571,161,0.217,11,0.233,10.0,126,14,112,0.111,259,0.486,14,0.514,10.1,161,34,126,0.211,420,0.383,25,0.408,10.0,2014-15,Regular%20Season
202682,Derrick Williams,1610612758,SAC,61,21,40,1333.0,41,22,18,0.537,119,0.345,6,0.363,8.0,160,24,137,0.15,230,0.696,16,0.748,6.9,201,46,155,0.229,349,0.576,22,0.615,7.1,2014-15,Regular%20Season
2734,Devin Harris,1610612742,DAL,56,36,20,1321.0,13,5,7,0.385,63,0.206,5,0.224,17.0,122,24,98,0.197,231,0.528,17,0.57,9.3,135,29,105,0.215,294,0.459,22,0.496,10.0,2014-15,Regular%20Season
203906,Devyn Marble,1610612753,ORL,12,2,10,206.0,5,0,4,0.0,13,0.385,1,0.417,17.3,26,3,23,0.115,37,0.703,0,0.703,8.2,31,3,27,0.097,50,0.62,1,0.633,9.4,2014-15,Regular%20Season
203473,Dewayne Dedmon,1610612753,ORL,53,15,38,818.0,117,77,33,0.658,194,0.603,3,0.613,5.1,177,70,104,0.395,283,0.625,37,0.72,4.3,294,147,137,0.5,477,0.616,40,0.673,4.6,2014-15,Regular%20Season
203079,Dion Waiters,1610612760,OKC,69,42,27,1971.0,40,13,28,0.325,149,0.268,5,0.278,15.1,146,22,125,0.151,257,0.568,16,0.606,10.5,186,35,153,0.188,406,0.458,21,0.483,11.5,2014-15,Regular%20Season
1717,Dirk Nowitzki,1610612742,DAL,77,47,30,2282.0,44,23,21,0.523,156,0.282,5,0.291,8.3,413,160,250,0.387,674,0.613,54,0.666,4.3,457,183,271,0.4,830,0.551,59,0.593,4.7,2014-15,Regular%20Season
202388,Donald Sloan,1610612754,IND,39,17,22,933.0,12,1,11,0.083,48,0.25,2,0.261,16.9,131,15,116,0.115,212,0.618,17,0.672,8.6,143,16,127,0.112,260,0.55,19,0.593,9.3,2014-15,Regular%20Season
202700,Donatas Motiejunas,1610612745,HOU,70,47,23,2006.0,133,85,45,0.639,368,0.361,13,0.375,7.7,281,112,171,0.399,632,0.445,49,0.482,4.6,414,197,216,0.476,1000,0.414,62,0.441,5.6,2014-15,Regular%20Season
2748,Dorell Wright,1610612757,POR,39,23,16,541.0,14,8,6,0.571,38,0.368,1,0.378,8.5,96,22,74,0.229,144,0.667,15,0.744,6.2,110,30,80,0.273,182,0.604,16,0.663,6.5,2014-15,Regular%20Season
203926,Doug McDermott,1610612741,CHI,20,11,9,244.0,6,3,2,0.5,21,0.286,3,0.333,7.5,37,6,31,0.162,52,0.712,4,0.771,6.5,43,9,33,0.209,73,0.589,7,0.652,6.6,2014-15,Regular%20Season
203110,Draymond Green,1610612744,GSW,79,64,15,2490.0,114,81,27,0.711,235,0.485,9,0.504,6.8,533,197,326,0.37,854,0.624,53,0.665,4.4,647,278,353,0.43,1089,0.594,62,0.63,4.8,2014-15,Regular%20Season
2400,Drew Gooden,1610612764,WAS,48,28,20,858.0,72,48,22,0.667,165,0.436,3,0.444,5.5,151,41,111,0.272,243,0.621,13,0.657,4.7,223,89,133,0.399,408,0.547,16,0.569,5.0,2014-15,Regular%20Season
204079,Drew Gordon,1610612755,PHI,6,0,6,59.0,7,4,3,0.571,16,0.438,1,0.467,6.0,11,5,6,0.455,23,0.478,2,0.524,4.2,18,9,9,0.5,39,0.462,3,0.5,4.9,2014-15,Regular%20Season
202779,Dwight Buycks,1610612747,LAL,6,1,5,123.0,2,1,1,0.5,11,0.182,1,0.2,16.5,10,2,8,0.2,18,0.556,0,0.556,9.1,12,3,9,0.25,29,0.414,1,0.429,10.3,2014-15,Regular%20Season
2730,Dwight Howard,1610612745,HOU,40,28,12,1189.0,108,78,31,0.722,261,0.414,10,0.43,4.5,313,128,185,0.409,476,0.658,37,0.713,3.5,421,206,216,0.489,737,0.571,47,0.61,3.8,2014-15,Regular%20Season
203939,Dwight Powell,1610612742,DAL,16,7,9,190.0,18,9,8,0.5,43,0.419,1,0.429,6.9,32,6,26,0.188,44,0.727,3,0.78,5.6,50,15,34,0.3,87,0.575,4,0.602,6.0,2014-15,Regular%20Season
2548,Dwyane Wade,1610612748,MIA,59,26,33,1880.0,57,36,20,0.632,177,0.322,8,0.337,9.0,157,39,120,0.248,304,0.516,19,0.551,8.1,214,75,140,0.35,481,0.445,27,0.471,8.4,2014-15,Regular%20Season
202734,E'Twaun Moore,1610612741,CHI,24,16,8,346.0,12,5,7,0.417,41,0.293,0,0.293,11.1,34,9,25,0.265,59,0.576,6,0.642,10.2,46,14,32,0.304,100,0.46,6,0.489,10.5,2014-15,Regular%20Season
2853,Earl Barron,1610612756,PHX,12,4,8,129.0,14,10,5,0.714,37,0.378,3,0.412,3.8,14,4,10,0.286,30,0.467,5,0.56,5.4,28,14,15,0.5,67,0.418,8,0.475,4.6,2014-15,Regular%20Season
201947,Earl Clark,1610612751,BKN,8,5,3,85.0,1,1,0,1.0,5,0.2,0,0.2,3.8,22,6,16,0.273,35,0.629,4,0.71,3.5,23,7,16,0.304,40,0.575,4,0.639,3.5,2014-15,Regular%20Season
202334,Ed Davis,1610612747,LAL,79,20,59,1840.0,230,160,66,0.696,500,0.46,12,0.471,4.8,370,110,259,0.297,617,0.6,62,0.667,4.9,600,270,325,0.45,1117,0.537,74,0.575,4.8,2014-15,Regular%20Season
202327,Ekpe Udoh,1610612746,LAC,16,13,3,84.0,7,4,3,0.571,14,0.5,0,0.5,10.8,19,8,11,0.421,31,0.613,3,0.679,5.4,26,12,14,0.462,45,0.578,3,0.619,6.8,2014-15,Regular%20Season
203901,Elfrid Payton,1610612753,ORL,78,24,54,2410.0,107,50,55,0.467,364,0.294,17,0.308,8.6,242,41,199,0.169,421,0.575,33,0.624,8.1,349,91,254,0.261,785,0.445,50,0.475,8.3,2014-15,Regular%20Season
202407,Elijah Millsap,1610612762,UTA,39,20,19,841.0,28,15,11,0.536,69,0.406,6,0.444,7.7,122,25,97,0.205,232,0.526,25,0.589,7.9,150,40,108,0.267,301,0.498,31,0.556,7.9,2014-15,Regular%20Season
202343,Elliot Williams,1610612755,PHI,7,2,5,80.0,0,0,0,0.0,6,0.0,0,0.0,0.0,8,0,8,0.0,13,0.615,3,0.8,7.6,8,0,8,0.0,19,0.421,3,0.5,7.6,2014-15,Regular%20Season
1882,Elton Brand,1610612737,ATL,30,20,10,451.0,28,18,7,0.643,63,0.444,3,0.467,5.1,72,31,43,0.431,143,0.503,17,0.571,5.3,100,49,50,0.49,206,0.485,20,0.538,5.2,2014-15,Regular%20Season
202683,Enes Freedom,1610612760,OKC,75,32,43,2136.0,277,210,56,0.758,662,0.418,15,0.428,4.0,394,134,254,0.34,669,0.589,61,0.648,4.6,671,344,310,0.513,1331,0.504,76,0.535,4.4,2014-15,Regular%20Season
202339,Eric Bledsoe,1610612756,PHX,79,37,42,2757.0,72,38,37,0.528,249,0.289,13,0.305,11.1,351,65,288,0.185,661,0.531,50,0.574,7.5,423,103,325,0.243,910,0.465,63,0.499,8.2,2014-15,Regular%20Season
201569,Eric Gordon,1610612740,NOP,55,30,25,1840.0,28,12,17,0.429,99,0.283,3,0.292,15.7,131,15,116,0.115,225,0.582,17,0.63,8.9,159,27,133,0.17,324,0.491,20,0.523,10.2,2014-15,Regular%20Season
203961,Eric Moreland,1610612758,SAC,2,0,2,2.0,0,0,0,0.0,0,0.0,0,0.0,0.0,1,0,2,0.0,0,0.0,0,0.0,3.9,1,0,2,0.0,0,0.0,0,0.0,3.9,2014-15,Regular%20Season
203475,Erick Green,1610612743,DEN,21,9,12,292.0,7,2,5,0.286,12,0.583,0,0.583,13.0,24,3,23,0.125,36,0.667,2,0.706,9.3,31,5,28,0.161,48,0.646,2,0.674,10.1,2014-15,Regular%20Season
101141,Ersan Ilyasova,1610612749,MIL,55,23,32,1300.0,80,60,17,0.75,204,0.392,6,0.404,4.6,195,76,118,0.39,346,0.564,28,0.613,5.3,275,136,135,0.495,550,0.5,34,0.533,5.1,2014-15,Regular%20Season
203095,Evan Fournier,1610612753,ORL,51,17,34,1512.0,28,9,19,0.321,122,0.23,10,0.25,12.8,125,26,99,0.208,222,0.563,14,0.601,10.1,153,35,118,0.229,344,0.445,24,0.478,10.6,2014-15,Regular%20Season
202323,Evan Turner,1610612738,BOS,81,39,42,2235.0,40,21,18,0.525,184,0.217,7,0.226,9.6,377,81,292,0.215,599,0.629,44,0.679,5.3,417,102,310,0.245,783,0.533,51,0.57,5.8,2014-15,Regular%20Season
203105,Festus Ezeli,1610612744,GSW,42,35,7,491.0,60,45,14,0.75,148,0.405,5,0.42,4.0,95,41,51,0.432,184,0.516,14,0.559,3.9,155,86,65,0.555,332,0.467,19,0.495,3.9,2014-15,Regular%20Season
101128,Francisco Garcia,1610612745,HOU,10,8,2,155.0,3,3,0,1.0,13,0.231,0,0.231,11.8,14,2,12,0.143,22,0.636,3,0.737,7.9,17,5,12,0.294,35,0.486,3,0.531,8.6,2014-15,Regular%20Season
203128,Furkan Aldemir,1610612755,PHI,37,7,30,528.0,78,57,19,0.731,172,0.453,6,0.47,5.0,98,31,63,0.316,159,0.616,16,0.685,4.4,176,88,82,0.5,331,0.532,22,0.57,4.6,2014-15,Regular%20Season
203539,Gal Mekel,1610612742,DAL,1,0,1,9.0,0,0,0,0.0,1,0.0,0,0.0,0.0,1,0,1,0.0,1,1.0,0,1.0,8.4,1,0,1,0.0,2,0.5,0,0.5,8.4,2014-15,Regular%20Season
202066,Garrett Temple,1610612764,WAS,33,18,15,677.0,24,7,16,0.292,51,0.471,2,0.49,17.9,66,13,53,0.197,127,0.52,11,0.569,8.3,90,20,69,0.222,178,0.506,13,0.545,10.9,2014-15,Regular%20Season
203914,Gary Harris,1610612743,DEN,37,13,24,564.0,21,10,12,0.476,58,0.362,4,0.389,14.3,43,8,34,0.186,77,0.558,4,0.589,7.4,64,18,46,0.281,135,0.474,8,0.504,9.8,2014-15,Regular%20Season
202390,Gary Neal,1610612750,MIN,52,22,30,1154.0,14,5,8,0.357,72,0.194,3,0.203,15.1,115,16,99,0.139,203,0.567,17,0.618,8.4,129,21,107,0.163,275,0.469,20,0.506,9.1,2014-15,Regular%20Season
201588,George Hill,1610612754,IND,42,26,16,1247.0,25,8,16,0.32,89,0.281,6,0.301,11.5,154,26,128,0.169,256,0.602,21,0.655,7.7,179,34,144,0.19,345,0.519,27,0.563,8.2,2014-15,Regular%20Season
101123,Gerald Green,1610612756,PHX,63,29,34,1312.0,33,11,21,0.333,101,0.327,6,0.347,13.2,153,33,117,0.216,266,0.575,16,0.612,7.9,186,44,138,0.237,367,0.507,22,0.539,8.9,2014-15,Regular%20Season
201945,Gerald Henderson,1610612766,CHA,76,32,44,2240.0,36,9,28,0.25,145,0.248,2,0.252,17.4,237,33,205,0.139,399,0.594,27,0.637,7.9,273,42,233,0.154,544,0.502,29,0.53,9.3,2014-15,Regular%20Season
2222,Gerald Wallace,1610612738,BOS,24,13,11,240.0,17,13,4,0.765,42,0.405,0,0.405,5.4,40,4,36,0.1,63,0.635,6,0.702,6.9,57,17,40,0.298,105,0.543,6,0.576,6.4,2014-15,Regular%20Season
203507,Giannis Antetokounmpo,1610612749,MIL,80,40,40,2508.0,99,60,40,0.606,301,0.329,10,0.34,8.0,438,127,310,0.29,694,0.631,59,0.69,5.8,537,187,350,0.348,995,0.54,69,0.58,6.2,2014-15,Regular%20Season
203540,Gigi Datome,1610612738,BOS,15,8,7,179.0,3,3,0,1.0,20,0.15,1,0.158,5.7,26,7,19,0.269,46,0.565,4,0.619,6.3,29,10,19,0.345,66,0.439,5,0.475,6.2,2014-15,Regular%20Season
201175,Glen Davis,1610612746,LAC,59,39,20,767.0,43,31,12,0.721,139,0.309,2,0.314,5.7,125,67,58,0.536,241,0.519,24,0.576,5.3,168,98,70,0.583,380,0.442,26,0.475,5.4,2014-15,Regular%20Season
203318,Glen Rice,1610612764,WAS,3,3,0,34.0,2,1,1,0.5,5,0.4,0,0.4,17.8,2,1,1,0.5,4,0.5,0,0.5,2.4,4,2,2,0.5,9,0.444,0,0.444,10.1,2014-15,Regular%20Season
203922,Glenn Robinson III,1610612755,PHI,16,0,16,174.0,15,11,4,0.733,28,0.536,0,0.536,8.6,24,3,21,0.125,36,0.667,4,0.75,6.4,39,14,25,0.359,64,0.609,4,0.65,7.3,2014-15,Regular%20Season
201609,Goran Dragic,1610612748,MIA,76,40,36,2600.0,81,37,43,0.457,250,0.324,8,0.335,12.2,193,29,162,0.15,418,0.462,30,0.497,10.8,274,66,205,0.241,668,0.41,38,0.435,11.2,2014-15,Regular%20Season
202330,Gordon Hayward,1610612762,UTA,76,35,41,2618.0,54,22,31,0.407,198,0.273,8,0.284,12.8,319,49,270,0.154,480,0.665,32,0.712,8.3,373,71,301,0.19,678,0.55,40,0.585,8.9,2014-15,Regular%20Season
203476,Gorgui Dieng,1610612750,MIN,72,16,56,2179.0,222,141,80,0.635,477,0.465,12,0.477,6.2,384,139,241,0.362,677,0.567,54,0.616,4.4,606,280,321,0.462,1154,0.525,66,0.557,5.1,2014-15,Regular%20Season
203511,Grant Jerrett,1610612762,UTA,5,3,2,47.0,2,0,2,0.0,6,0.333,0,0.333,15.3,7,0,7,0.0,7,1.0,2,1.4,5.7,9,0,9,0.0,13,0.692,2,0.818,7.8,2014-15,Regular%20Season
202328,Greg Monroe,1610612765,DET,69,25,44,2137.0,229,164,63,0.716,509,0.45,12,0.461,5.6,475,168,300,0.354,709,0.67,51,0.722,4.7,704,332,363,0.472,1218,0.578,63,0.61,5.0,2014-15,Regular%20Season
202962,Greg Smith,1610612742,DAL,26,17,9,288.0,26,17,9,0.654,62,0.419,1,0.426,6.1,53,19,34,0.358,106,0.5,13,0.57,4.1,79,36,43,0.456,168,0.47,14,0.513,4.7,2014-15,Regular%20Season
201880,Greg Stiemsma,1610612761,TOR,8,6,2,50.0,9,3,6,0.333,13,0.692,0,0.692,7.2,6,2,4,0.333,9,0.667,0,0.667,3.5,15,5,10,0.333,22,0.682,0,0.682,5.7,2014-15,Regular%20Season
202349,Greivis Vasquez,1610612761,TOR,75,47,28,1831.0,22,4,18,0.182,121,0.182,3,0.186,17.9,194,23,170,0.119,363,0.534,20,0.566,8.6,216,27,188,0.125,484,0.446,23,0.469,9.6,2014-15,Regular%20Season
203084,Harrison Barnes,1610612744,GSW,81,66,15,2293.0,117,55,63,0.47,306,0.382,9,0.394,9.8,336,80,255,0.238,612,0.549,56,0.604,6.1,453,135,318,0.298,918,0.493,65,0.531,7.1,2014-15,Regular%20Season
202355,Hassan Whiteside,1610612748,MIA,45,17,28,1128.0,144,122,19,0.847,340,0.424,2,0.426,4.1,335,143,187,0.427,526,0.637,39,0.688,3.7,479,265,206,0.553,866,0.553,41,0.581,3.8,2014-15,Regular%20Season
2045,Hedo Turkoglu,1610612746,LAC,46,32,14,591.0,5,1,4,0.2,29,0.172,2,0.185,13.3,94,22,72,0.234,135,0.696,8,0.74,5.5,99,23,76,0.232,164,0.604,10,0.643,5.9,2014-15,Regular%20Season
203156,Henry Sims,1610612755,PHI,70,13,57,1369.0,121,89,32,0.736,334,0.362,11,0.375,6.0,238,97,143,0.408,443,0.537,40,0.591,4.5,359,186,175,0.518,777,0.462,51,0.494,5.0,2014-15,Regular%20Season
201611,Henry Walker,1610612748,MIA,23,12,11,609.0,7,2,5,0.286,27,0.259,1,0.269,13.3,75,21,55,0.28,155,0.484,19,0.551,6.5,82,23,60,0.28,182,0.451,20,0.506,7.1,2014-15,Regular%20Season
203138,Hollis Thompson,1610612755,PHI,67,12,55,1691.0,53,20,30,0.377,127,0.417,6,0.438,12.0,145,41,105,0.283,261,0.556,20,0.602,8.3,198,61,135,0.308,388,0.51,26,0.547,9.3,2014-15,Regular%20Season
203546,Ian Clark,1610612743,DEN,11,3,8,119.0,4,1,3,0.25,11,0.364,0,0.364,15.6,12,2,10,0.167,16,0.75,0,0.75,12.3,16,3,13,0.188,27,0.593,0,0.593,13.1,2014-15,Regular%20Season
101133,Ian Mahinmi,1610612754,IND,58,27,31,1117.0,105,81,24,0.771,230,0.457,6,0.469,5.1,251,91,158,0.363,382,0.657,28,0.709,4.9,356,172,182,0.483,612,0.582,34,0.616,5.0,2014-15,Regular%20Season
202697,Iman Shumpert,1610612739,CLE,57,31,26,1457.0,55,19,34,0.345,123,0.447,4,0.462,13.2,169,32,139,0.189,256,0.66,14,0.698,7.3,224,51,173,0.228,379,0.591,18,0.62,8.7,2014-15,Regular%20Season
203477,Isaiah Canaan,1610612755,PHI,32,15,17,749.0,18,1,16,0.056,51,0.353,3,0.375,18.9,67,9,59,0.134,111,0.604,4,0.626,9.2,85,10,75,0.118,162,0.525,7,0.548,11.1,2014-15,Regular%20Season
202738,Isaiah Thomas,1610612738,BOS,59,36,23,1525.0,33,14,20,0.424,133,0.248,7,0.262,12.8,119,19,103,0.16,222,0.536,8,0.556,11.8,152,33,123,0.217,355,0.428,15,0.447,12.1,2014-15,Regular%20Season
202397,Ish Smith,1610612755,PHI,39,16,23,704.0,15,3,12,0.2,63,0.238,4,0.254,8.4,85,12,74,0.141,172,0.494,10,0.525,8.5,100,15,86,0.15,235,0.426,14,0.452,8.5,2014-15,Regular%20Season
200826,J.J. Barea,1610612742,DAL,59,38,21,1113.0,23,11,12,0.478,94,0.245,6,0.261,10.4,111,10,101,0.09,202,0.55,14,0.59,10.1,134,21,113,0.157,296,0.453,20,0.486,10.2,2014-15,Regular%20Season
201581,JJ Hickson,1610612743,DEN,72,26,46,1409.0,150,94,46,0.627,340,0.441,6,0.449,5.5,302,84,215,0.278,449,0.673,32,0.724,5.0,452,178,261,0.394,789,0.573,38,0.602,5.2,2014-15,Regular%20Season
200755,JJ Redick,1610612746,LAC,62,43,19,1971.0,22,1,19,0.045,87,0.253,2,0.259,19.0,144,16,128,0.111,272,0.529,27,0.588,10.4,166,17,147,0.102,359,0.462,29,0.503,11.4,2014-15,Regular%20Season
2747,JR Smith,1610612739,CLE,65,36,29,2008.0,30,9,20,0.3,109,0.275,11,0.306,14.9,188,29,158,0.154,297,0.633,21,0.681,9.2,218,38,178,0.174,406,0.537,32,0.583,10.0,2014-15,Regular%20Season
203960,JaKarr Sampson,1610612755,PHI,61,14,47,1001.0,34,12,21,0.353,88,0.386,2,0.395,11.7,127,22,104,0.173,231,0.55,14,0.585,6.3,161,34,125,0.211,319,0.505,16,0.531,7.4,2014-15,Regular%20Season
203210,JaMychal Green,1610612763,MEM,18,7,11,154.0,19,9,10,0.474,31,0.613,0,0.613,6.6,26,7,19,0.269,35,0.743,3,0.813,4.9,45,16,29,0.356,66,0.682,3,0.714,5.6,2014-15,Regular%20Season
201580,JaVale McGee,1610612743,DEN,20,7,13,245.0,18,11,6,0.611,43,0.419,1,0.429,7.1,43,14,28,0.326,83,0.518,10,0.589,3.8,61,25,34,0.41,126,0.484,11,0.53,4.8,2014-15,Regular%20Season
203913,Jabari Brown,1610612747,LAL,16,3,13,487.0,3,1,2,0.333,33,0.091,2,0.097,15.0,33,3,30,0.091,66,0.5,6,0.55,9.1,36,4,32,0.111,99,0.364,8,0.396,9.6,2014-15,Regular%20Season
203953,Jabari Parker,1610612749,MIL,25,13,12,738.0,50,19,27,0.38,99,0.505,3,0.521,9.4,88,25,58,0.284,176,0.5,13,0.54,5.6,138,44,85,0.319,275,0.502,16,0.533,7.0,2014-15,Regular%20Season
204022,Jack Cooley,1610612762,UTA,9,8,1,61.0,10,7,3,0.7,20,0.5,2,0.556,4.4,15,8,7,0.533,22,0.682,2,0.75,4.2,25,15,10,0.6,42,0.595,4,0.658,4.3,2014-15,Regular%20Season
203109,Jae Crowder,1610612738,BOS,70,38,32,1544.0,72,33,37,0.458,185,0.389,10,0.411,8.8,221,61,157,0.276,351,0.63,30,0.688,6.4,293,94,194,0.321,536,0.547,40,0.591,7.0,2014-15,Regular%20Season
203479,Jamaal Franklin,1610612743,DEN,2,1,1,13.0,1,0,1,0.0,2,0.5,0,0.5,9.0,1,0,1,0.0,1,1.0,0,1.0,12.0,2,0,2,0.0,3,0.667,0,0.667,10.5,2014-15,Regular%20Season
2037,Jamal Crawford,1610612746,LAC,47,33,14,1277.0,18,7,8,0.389,55,0.327,3,0.346,9.8,106,15,94,0.142,153,0.693,3,0.707,10.9,124,22,102,0.177,208,0.596,6,0.614,10.8,2014-15,Regular%20Season
2749,Jameer Nelson,1610612743,DEN,55,23,32,1239.0,33,9,23,0.273,79,0.418,2,0.429,12.5,113,19,93,0.168,222,0.509,17,0.551,8.6,146,28,116,0.192,301,0.485,19,0.518,9.5,2014-15,Regular%20Season
203516,James Ennis III,1610612748,MIA,52,23,29,943.0,51,25,23,0.49,134,0.381,6,0.398,7.2,125,30,96,0.24,211,0.592,26,0.676,6.3,176,55,119,0.313,345,0.51,32,0.562,6.5,2014-15,Regular%20Season
201935,James Harden,1610612745,HOU,80,55,25,2941.0,74,38,36,0.514,295,0.251,14,0.263,9.5,381,75,305,0.197,631,0.604,49,0.655,7.7,455,113,341,0.248,926,0.491,63,0.527,8.0,2014-15,Regular%20Season
201949,James Johnson,1610612761,TOR,67,37,30,1338.0,61,36,26,0.59,172,0.355,5,0.365,8.6,196,47,152,0.24,318,0.616,21,0.66,5.2,257,83,178,0.323,490,0.524,26,0.554,6.0,2014-15,Regular%20Season
2592,James Jones,1610612739,CLE,29,15,14,440.0,9,2,7,0.222,21,0.429,1,0.45,19.3,52,14,38,0.269,90,0.578,7,0.627,6.2,61,16,45,0.262,111,0.55,8,0.592,8.2,2014-15,Regular%20Season
203949,James Michael McAdoo,1610612744,GSW,10,8,2,128.0,15,9,6,0.6,26,0.577,0,0.577,8.0,22,8,14,0.364,44,0.5,4,0.55,4.7,37,17,20,0.459,70,0.529,4,0.561,6.0,2014-15,Regular%20Season
203923,James Young,1610612738,BOS,24,11,13,301.0,9,2,6,0.222,21,0.429,2,0.474,16.6,32,9,22,0.281,53,0.604,6,0.681,6.2,41,11,28,0.268,74,0.554,8,0.621,8.4,2014-15,Regular%20Season
2457,Jannero Pargo,1610612766,CHA,3,1,2,35.0,0,0,0,0.0,3,0.0,0,0.0,0.0,3,1,3,0.333,6,0.5,0,0.5,5.0,3,1,3,0.333,9,0.333,0,0.333,5.0,2014-15,Regular%20Season
203099,Jared Cunningham,1610612746,LAC,8,6,2,46.0,1,1,0,1.0,3,0.333,0,0.333,7.0,8,3,5,0.375,10,0.8,0,0.8,7.6,9,4,5,0.444,13,0.692,0,0.692,7.5,2014-15,Regular%20Season
201162,Jared Dudley,1610612749,MIL,64,34,30,1552.0,43,22,20,0.512,125,0.344,5,0.358,8.9,172,50,123,0.291,383,0.449,37,0.497,6.8,215,72,143,0.335,508,0.423,42,0.461,7.2,2014-15,Regular%20Season
203096,Jared Sullinger,1610612738,BOS,58,26,32,1566.0,147,109,34,0.741,345,0.426,8,0.436,5.1,294,112,183,0.381,498,0.59,42,0.645,4.6,441,221,217,0.501,843,0.523,50,0.556,4.7,2014-15,Regular%20Season
203950,Jarnell Stokes,1610612763,MEM,14,8,6,118.0,16,11,4,0.688,40,0.4,3,0.432,3.6,18,3,15,0.167,37,0.486,1,0.5,4.4,34,14,19,0.412,77,0.442,4,0.466,4.1,2014-15,Regular%20Season
101127,Jarrett Jack,1610612751,BKN,78,35,43,2189.0,18,5,15,0.278,97,0.186,4,0.194,17.8,225,20,207,0.089,384,0.586,24,0.625,9.9,243,25,222,0.103,481,0.505,28,0.536,10.5,2014-15,Regular%20Season
101131,Jason Maxiell,1610612766,CHA,57,20,37,847.0,86,56,26,0.651,191,0.45,7,0.467,5.7,116,35,80,0.302,244,0.475,28,0.537,5.2,202,91,106,0.45,435,0.464,35,0.505,5.4,2014-15,Regular%20Season
2202,Jason Richardson,1610612755,PHI,19,4,15,416.0,13,9,4,0.692,35,0.371,3,0.406,4.8,53,9,44,0.17,87,0.609,6,0.654,8.2,66,18,48,0.273,122,0.541,9,0.584,7.6,2014-15,Regular%20Season
201160,Jason Smith,1610612752,NYK,79,17,62,1741.0,97,58,35,0.598,246,0.394,4,0.401,7.5,223,63,155,0.283,410,0.544,34,0.593,5.3,320,121,190,0.378,656,0.488,38,0.518,6.0,2014-15,Regular%20Season
1891,Jason Terry,1610612745,HOU,54,41,13,1211.0,15,3,13,0.2,56,0.268,1,0.273,18.9,103,9,94,0.087,198,0.52,17,0.569,11.9,118,12,107,0.102,254,0.465,18,0.5,12.8,2014-15,Regular%20Season
201574,Jason Thompson,1610612758,SAC,81,29,52,1991.0,139,100,36,0.719,335,0.415,10,0.428,5.8,391,135,253,0.345,651,0.601,53,0.654,4.6,530,235,289,0.443,986,0.538,63,0.574,5.0,2014-15,Regular%20Season
202399,Jeff Adrien,1610612745,HOU,17,1,16,215.0,23,14,8,0.609,55,0.418,0,0.418,4.8,54,19,34,0.352,76,0.711,8,0.794,3.8,77,33,42,0.429,131,0.588,8,0.626,4.1,2014-15,Regular%20Season
201965,Jeff Ayres,1610612759,SAS,38,23,15,361.0,37,27,10,0.73,80,0.463,3,0.481,5.5,80,26,53,0.325,124,0.645,8,0.69,4.0,117,53,63,0.453,204,0.574,11,0.606,4.5,2014-15,Regular%20Season
201145,Jeff Green,1610612763,MEM,76,40,36,2409.0,64,36,28,0.563,207,0.309,2,0.312,10.1,264,64,199,0.242,433,0.61,27,0.65,7.5,328,100,227,0.305,640,0.513,29,0.537,8.0,2014-15,Regular%20Season
201952,Jeff Teague,1610612737,ATL,65,49,16,1991.0,30,6,27,0.2,155,0.194,7,0.203,15.7,154,21,133,0.136,293,0.526,16,0.556,10.0,184,27,160,0.147,448,0.411,23,0.433,11.1,2014-15,Regular%20Season
203481,Jeff Withey,1610612740,NOP,25,10,15,216.0,23,15,7,0.652,43,0.535,2,0.561,6.1,41,19,21,0.463,64,0.641,2,0.661,3.6,64,34,28,0.531,107,0.598,4,0.621,4.5,2014-15,Regular%20Season
203106,Jeffery Taylor,1610612766,CHA,21,7,14,372.0,14,7,7,0.5,40,0.35,0,0.35,12.2,39,8,31,0.205,71,0.549,5,0.591,8.1,53,15,38,0.283,111,0.477,5,0.5,9.2,2014-15,Regular%20Season
203924,Jerami Grant,1610612755,PHI,62,18,44,1336.0,49,30,19,0.612,145,0.338,8,0.358,10.5,149,36,114,0.242,309,0.482,32,0.538,6.8,198,66,133,0.333,454,0.436,40,0.478,7.7,2014-15,Regular%20Season
202077,Jerel McNeal,1610612756,PHX,3,1,2,29.0,0,0,0,0.0,1,0.0,0,0.0,0.0,3,1,2,0.333,7,0.429,0,0.429,8.0,3,1,2,0.333,8,0.375,0,0.375,8.0,2014-15,Regular%20Season
202379,Jeremy Evans,1610612762,UTA,25,14,11,222.0,26,16,9,0.615,58,0.448,3,0.473,5.6,45,19,27,0.422,76,0.592,7,0.652,6.6,71,35,36,0.493,134,0.53,10,0.573,6.2,2014-15,Regular%20Season
203087,Jeremy Lamb,1610612760,OKC,35,21,14,608.0,8,2,6,0.25,35,0.229,2,0.242,6.6,99,20,78,0.202,140,0.707,6,0.739,6.7,107,22,84,0.206,175,0.611,8,0.641,6.7,2014-15,Regular%20Season
202391,Jeremy Lin,1610612747,LAL,68,18,50,1769.0,26,6,19,0.231,142,0.183,2,0.186,15.6,170,45,130,0.265,364,0.467,41,0.526,9.2,196,51,149,0.26,506,0.387,43,0.423,10.0,2014-15,Regular%20Season
202366,Jerome Jordan,1610612751,BKN,38,12,26,371.0,52,34,18,0.654,96,0.542,0,0.542,5.5,53,21,33,0.396,106,0.5,16,0.589,7.9,105,55,51,0.524,202,0.52,16,0.565,6.7,2014-15,Regular%20Season
203968,Jerrelle Benimon,1610612743,DEN,1,1,0,2.0,1,1,0,1.0,1,1.0,0,1.0,1.9,2,1,1,0.5,2,1.0,0,1.0,4.4,3,2,1,0.667,3,1.0,0,1.0,3.5,2014-15,Regular%20Season
201573,Jerryd Bayless,1610612749,MIL,66,34,32,1544.0,22,5,14,0.227,100,0.22,5,0.232,14.2,189,31,156,0.164,330,0.573,29,0.628,8.2,211,36,170,0.171,430,0.491,34,0.533,8.8,2014-15,Regular%20Season
202690,Jimmer Fredette,1610612740,NOP,27,15,12,364.0,8,1,7,0.125,24,0.333,1,0.348,15.1,32,4,29,0.125,55,0.582,4,0.627,10.8,40,5,36,0.125,79,0.506,5,0.541,11.6,2014-15,Regular%20Season
202710,Jimmy Butler,1610612741,CHI,65,40,25,2513.0,114,66,46,0.579,322,0.354,7,0.362,8.1,265,66,196,0.249,480,0.552,44,0.608,8.4,379,132,242,0.348,802,0.473,51,0.505,8.3,2014-15,Regular%20Season
201149,Joakim Noah,1610612741,CHI,67,39,28,2049.0,219,168,42,0.767,523,0.419,11,0.428,4.5,427,160,268,0.375,775,0.551,62,0.599,4.3,646,328,310,0.508,1298,0.498,73,0.527,4.4,2014-15,Regular%20Season
201975,Jodie Meeks,1610612765,DET,51,22,29,1256.0,12,2,10,0.167,64,0.188,4,0.2,19.0,92,11,82,0.12,146,0.63,10,0.676,9.7,104,13,92,0.125,210,0.495,14,0.531,10.8,2014-15,Regular%20Season
203925,Joe Harris,1610612739,CLE,24,14,10,335.0,7,2,5,0.286,19,0.368,1,0.389,17.6,34,5,29,0.147,61,0.557,4,0.596,8.9,41,7,34,0.171,80,0.513,5,0.547,10.4,2014-15,Regular%20Season
204060,Joe Ingles,1610612762,UTA,67,34,33,1484.0,22,4,18,0.182,68,0.324,0,0.324,20.6,153,29,127,0.19,239,0.64,11,0.671,9.5,175,33,145,0.189,307,0.57,11,0.591,10.9,2014-15,Regular%20Season
2207,Joe Johnson,1610612751,BKN,78,38,40,2726.0,53,30,22,0.566,199,0.266,6,0.275,10.6,331,54,275,0.163,449,0.737,32,0.794,7.6,384,84,297,0.219,648,0.593,38,0.63,8.0,2014-15,Regular%20Season
201202,Joel Anthony,1610612765,DET,34,17,17,342.0,32,19,13,0.594,85,0.376,2,0.386,6.1,61,17,44,0.279,117,0.521,14,0.592,4.5,93,36,57,0.387,202,0.46,16,0.5,5.1,2014-15,Regular%20Season
200777,Joel Freeland,1610612757,POR,42,30,12,584.0,62,44,17,0.71,139,0.446,2,0.453,5.8,129,47,80,0.364,231,0.558,27,0.632,4.1,191,91,97,0.476,370,0.516,29,0.56,4.7,2014-15,Regular%20Season
201595,Joey Dorsey,1610612745,HOU,61,40,21,830.0,102,79,22,0.775,263,0.388,10,0.403,5.2,174,67,108,0.385,284,0.613,24,0.669,4.3,276,146,130,0.529,547,0.505,34,0.538,4.6,2014-15,Regular%20Season
203530,Joffrey Lauvergne,1610612743,DEN,21,9,12,264.0,27,20,3,0.741,73,0.37,1,0.375,3.6,50,19,31,0.38,80,0.625,9,0.704,3.1,77,39,34,0.506,153,0.503,10,0.538,3.3,2014-15,Regular%20Season
203089,John Henson,1610612749,MIL,64,33,31,1196.0,123,91,31,0.74,227,0.542,6,0.557,5.4,186,87,99,0.468,351,0.53,28,0.576,3.8,309,178,130,0.576,578,0.535,34,0.568,4.4,2014-15,Regular%20Season
203098,John Jenkins,1610612737,ATL,19,10,9,279.0,2,0,2,0.0,13,0.154,0,0.154,25.8,37,4,32,0.108,71,0.521,3,0.544,8.6,39,4,34,0.103,84,0.464,3,0.481,9.5,2014-15,Regular%20Season
101249,John Lucas III,1610612765,DET,9,5,4,130.0,4,1,3,0.25,8,0.5,0,0.5,13.0,12,1,11,0.083,21,0.571,1,0.6,12.1,16,2,14,0.125,29,0.552,1,0.571,12.3,2014-15,Regular%20Season
2422,John Salmons,1610612740,NOP,10,4,6,148.0,4,0,4,0.0,14,0.286,0,0.286,27.0,17,3,14,0.176,24,0.708,2,0.773,9.6,21,3,18,0.143,38,0.553,2,0.583,12.9,2014-15,Regular%20Season
202322,John Wall,1610612764,WAS,79,45,34,2837.0,36,9,29,0.25,208,0.173,12,0.184,14.2,330,29,300,0.088,538,0.613,34,0.655,9.2,366,38,329,0.104,746,0.491,46,0.523,9.8,2014-15,Regular%20Season
203948,Johnny O'Bryant III,1610612749,MIL,24,15,9,291.0,25,13,11,0.52,54,0.463,4,0.5,7.1,38,14,24,0.368,77,0.494,7,0.543,5.7,63,27,35,0.429,131,0.481,11,0.525,6.2,2014-15,Regular%20Season
202720,Jon Leuer,1610612763,MEM,57,42,15,791.0,50,29,19,0.58,135,0.37,4,0.382,6.4,157,58,99,0.369,274,0.573,20,0.618,4.1,207,87,118,0.42,409,0.506,24,0.538,4.7,2014-15,Regular%20Season
201973,Jonas Jerebko,1610612738,BOS,71,35,36,1199.0,93,58,36,0.624,219,0.425,7,0.439,6.8,189,64,123,0.339,323,0.585,30,0.645,5.2,282,122,159,0.433,542,0.52,37,0.558,5.7,2014-15,Regular%20Season
202685,Jonas Valanciunas,1610612761,TOR,79,47,32,2085.0,215,168,39,0.781,542,0.397,6,0.401,3.9,478,183,295,0.383,796,0.601,64,0.653,3.7,693,351,334,0.506,1338,0.518,70,0.547,3.8,2014-15,Regular%20Season
203919,Jordan Adams,1610612763,MEM,16,6,10,175.0,9,5,4,0.556,23,0.391,1,0.409,9.2,19,5,14,0.263,25,0.76,2,0.826,7.0,28,10,18,0.357,48,0.583,3,0.622,7.7,2014-15,Regular%20Season
203903,Jordan Clarkson,1610612747,LAL,52,11,41,1407.0,56,33,23,0.589,174,0.322,11,0.344,9.4,135,17,119,0.126,269,0.502,29,0.563,8.0,191,50,142,0.262,443,0.431,40,0.474,8.4,2014-15,Regular%20Season
200770,Jordan Farmar,1610612746,LAC,25,18,7,390.0,8,1,7,0.125,26,0.308,0,0.308,18.0,34,8,25,0.235,69,0.493,6,0.54,8.9,42,9,32,0.214,95,0.442,6,0.472,10.7,2014-15,Regular%20Season
202706,Jordan Hamilton,1610612746,LAC,8,4,4,100.0,2,2,0,1.0,8,0.25,1,0.286,6.9,14,6,8,0.429,26,0.538,1,0.56,5.3,16,8,8,0.5,34,0.471,2,0.5,5.5,2014-15,Regular%20Season
201941,Jordan Hill,1610612747,LAL,70,19,51,1874.0,174,115,51,0.661,403,0.432,12,0.445,6.3,382,139,240,0.364,619,0.617,60,0.683,4.3,556,254,291,0.457,1022,0.544,72,0.585,4.9,2014-15,Regular%20Season
203268,Jorge Gutierrez,1610612749,MIL,11,5,6,136.0,5,1,4,0.2,12,0.417,0,0.417,13.2,20,3,17,0.15,28,0.714,1,0.741,7.3,25,4,21,0.16,40,0.625,1,0.641,8.5,2014-15,Regular%20Season
101181,Jose Calderon,1610612752,NYK,38,7,31,1150.0,19,0,19,0.0,48,0.396,1,0.404,20.1,102,9,94,0.088,175,0.583,11,0.622,10.4,121,9,113,0.074,223,0.543,12,0.573,11.9,2014-15,Regular%20Season
201177,Josh McRoberts,1610612748,MIA,14,7,7,264.0,7,4,3,0.571,15,0.467,0,0.467,4.3,38,20,17,0.526,78,0.487,7,0.535,5.4,45,24,20,0.533,93,0.484,7,0.523,5.2,2014-15,Regular%20Season
2746,Josh Smith,1610612745,HOU,83,41,42,2301.0,152,93,60,0.612,334,0.455,10,0.469,8.3,378,134,239,0.354,688,0.549,59,0.601,5.6,530,227,299,0.428,1022,0.519,69,0.556,6.3,2014-15,Regular%20Season
201950,Jrue Holiday,1610612740,NOP,38,19,19,1241.0,32,15,17,0.469,101,0.317,3,0.327,12.2,103,22,83,0.214,206,0.5,15,0.539,7.9,135,37,100,0.274,307,0.44,18,0.467,8.8,2014-15,Regular%20Season
203120,Justin Hamilton,1610612750,MIN,35,4,31,698.0,57,43,13,0.754,123,0.463,1,0.467,5.5,77,29,49,0.377,194,0.397,26,0.458,6.0,134,72,62,0.537,317,0.423,27,0.462,5.8,2014-15,Regular%20Season
203200,Justin Holiday,1610612744,GSW,36,30,6,511.0,12,7,7,0.583,40,0.3,0,0.3,6.7,59,10,49,0.169,101,0.584,9,0.641,10.6,71,17,56,0.239,141,0.504,9,0.538,10.2,2014-15,Regular%20Season
203994,Jusuf Nurkic,1610612743,DEN,60,20,40,1083.0,125,94,27,0.752,304,0.411,8,0.422,4.4,257,108,147,0.42,418,0.615,28,0.659,4.0,382,202,174,0.529,722,0.529,36,0.557,4.2,2014-15,Regular%20Season
203909,KJ McDaniels,1610612745,HOU,54,14,40,1293.0,65,41,20,0.631,133,0.489,5,0.508,7.6,135,36,100,0.267,288,0.469,35,0.534,7.4,200,77,120,0.385,421,0.475,40,0.525,7.5,2014-15,Regular%20Season
202695,Kawhi Leonard,1610612759,SAS,64,46,18,2033.0,85,51,34,0.6,186,0.457,9,0.48,9.0,376,99,279,0.263,551,0.682,38,0.733,6.4,461,150,313,0.325,737,0.626,47,0.668,6.9,2014-15,Regular%20Season
203482,Kelly Olynyk,1610612738,BOS,63,31,32,1408.0,92,52,39,0.565,259,0.355,14,0.376,7.8,211,55,151,0.261,400,0.528,42,0.589,5.6,303,107,190,0.353,659,0.46,56,0.502,6.2,2014-15,Regular%20Season
202689,Kemba Walker,1610612766,CHA,61,21,40,2093.0,35,14,20,0.4,168,0.208,5,0.215,16.4,185,36,152,0.195,418,0.443,49,0.501,8.6,220,50,172,0.227,586,0.375,54,0.414,9.8,2014-15,Regular%20Season
203088,Kendall Marshall,1610612749,MIL,15,4,11,264.0,2,0,3,0.0,18,0.111,1,0.118,23.1,25,4,21,0.16,38,0.658,1,0.676,9.6,27,4,24,0.148,56,0.482,2,0.5,11.1,2014-15,Regular%20Season
2570,Kendrick Perkins,1610612739,CLE,65,36,29,1139.0,91,59,30,0.648,239,0.381,12,0.401,6.6,229,83,145,0.362,398,0.575,40,0.64,3.9,320,142,175,0.444,637,0.502,52,0.547,4.7,2014-15,Regular%20Season
202702,Kenneth Faried,1610612743,DEN,75,30,45,2086.0,242,164,71,0.678,560,0.432,16,0.445,6.0,426,152,269,0.357,649,0.656,40,0.7,5.1,668,316,340,0.473,1209,0.553,56,0.579,5.5,2014-15,Regular%20Season
203145,Kent Bazemore,1610612737,ATL,67,47,20,1268.0,21,12,10,0.571,75,0.28,2,0.288,7.7,201,37,160,0.184,332,0.605,30,0.666,6.2,222,49,170,0.221,407,0.545,32,0.592,6.3,2014-15,Regular%20Season
203484,Kentavious Caldwell-Pope,1610612765,DET,75,30,45,2418.0,46,13,35,0.283,167,0.275,8,0.289,12.0,209,38,171,0.182,370,0.565,38,0.63,9.0,255,51,206,0.2,537,0.475,46,0.519,9.5,2014-15,Regular%20Season
2030,Kenyon Martin,1610612749,MIL,7,6,1,87.0,5,3,1,0.6,15,0.333,0,0.333,6.4,13,8,5,0.615,25,0.52,3,0.591,4.1,18,11,6,0.611,40,0.45,3,0.486,4.6,2014-15,Regular%20Season
201142,Kevin Durant,1610612760,OKC,27,18,9,913.0,16,7,8,0.438,60,0.267,2,0.276,10.9,162,37,123,0.228,218,0.743,13,0.79,6.3,178,44,131,0.247,278,0.64,15,0.677,6.7,2014-15,Regular%20Season
708,Kevin Garnett,1610612750,MIN,46,20,26,948.0,48,24,22,0.5,88,0.545,6,0.585,8.1,263,78,186,0.297,367,0.717,23,0.765,4.9,311,102,208,0.328,455,0.684,29,0.73,5.4,2014-15,Regular%20Season
201567,Kevin Love,1610612739,CLE,74,50,24,2493.0,141,83,54,0.589,320,0.441,5,0.448,7.3,585,223,358,0.381,938,0.624,71,0.675,4.2,726,306,412,0.421,1258,0.577,76,0.614,4.8,2014-15,Regular%20Season
2755,Kevin Martin,1610612750,MIN,37,11,26,1251.0,18,6,11,0.333,91,0.198,4,0.207,14.3,119,11,105,0.092,190,0.626,22,0.708,8.2,137,17,116,0.124,281,0.488,26,0.537,9.0,2014-15,Regular%20Season
202338,Kevin Seraphin,1610612764,WAS,76,44,32,1218.0,87,52,32,0.598,207,0.42,4,0.429,6.4,201,67,134,0.333,402,0.5,43,0.56,5.0,288,119,166,0.413,609,0.473,47,0.512,5.4,2014-15,Regular%20Season
203114,Khris Middleton,1610612749,MIL,78,39,39,2345.0,48,24,22,0.5,176,0.273,9,0.287,11.6,293,62,232,0.212,460,0.637,32,0.685,7.0,341,86,254,0.252,636,0.536,41,0.573,7.6,2014-15,Regular%20Season
2550,Kirk Hinrich,1610612741,CHI,54,30,24,1381.0,20,2,18,0.1,74,0.27,2,0.278,19.4,101,23,75,0.228,184,0.549,12,0.587,10.2,121,25,93,0.207,258,0.469,14,0.496,11.8,2014-15,Regular%20Season
202691,Klay Thompson,1610612744,GSW,75,63,12,2394.0,27,14,13,0.519,169,0.16,9,0.169,10.7,220,50,172,0.227,426,0.516,36,0.564,8.3,247,64,185,0.259,595,0.415,45,0.449,8.6,2014-15,Regular%20Season
977,Kobe Bryant,1610612747,LAL,35,10,25,1207.0,26,20,9,0.769,102,0.255,6,0.271,8.6,173,28,145,0.162,279,0.62,22,0.673,7.0,199,48,154,0.241,381,0.522,28,0.564,7.2,2014-15,Regular%20Season
201585,Kosta Koufos,1610612763,MEM,81,55,26,1348.0,121,70,47,0.579,256,0.473,6,0.484,5.5,305,129,175,0.423,488,0.625,45,0.688,4.0,426,199,222,0.467,744,0.573,51,0.615,4.4,2014-15,Regular%20Season
203123,Kostas Papanikolaou,1610612745,HOU,36,24,12,743.0,39,17,20,0.436,102,0.382,4,0.398,10.4,79,23,56,0.291,190,0.416,22,0.47,6.7,118,40,76,0.339,292,0.404,26,0.444,7.9,2014-15,Regular%20Season
2743,Kris Humphries,1610612764,WAS,62,35,27,1340.0,118,73,43,0.619,303,0.389,8,0.4,6.0,298,83,213,0.279,499,0.597,39,0.648,4.7,416,156,256,0.375,802,0.519,47,0.551,5.1,2014-15,Regular%20Season
203937,Kyle Anderson,1610612759,SAS,23,15,8,316.0,5,4,1,0.8,21,0.238,1,0.25,7.1,67,20,46,0.299,104,0.644,5,0.677,6.0,72,24,47,0.333,125,0.576,6,0.605,6.1,2014-15,Regular%20Season
2594,Kyle Korver,1610612737,ATL,74,58,16,2404.0,15,4,12,0.267,101,0.149,4,0.155,22.0,289,84,201,0.291,572,0.505,43,0.546,6.9,304,88,213,0.289,673,0.452,47,0.486,7.7,2014-15,Regular%20Season
200768,Kyle Lowry,1610612761,TOR,69,42,27,2377.0,54,32,23,0.593,263,0.205,13,0.216,10.1,274,49,227,0.179,546,0.502,47,0.549,8.5,328,81,250,0.247,809,0.405,60,0.438,8.9,2014-15,Regular%20Season
203124,Kyle O'Quinn,1610612753,ORL,47,14,33,786.0,46,31,14,0.674,112,0.411,5,0.43,5.6,153,55,98,0.359,255,0.6,24,0.662,4.2,199,86,112,0.432,367,0.542,29,0.589,4.5,2014-15,Regular%20Season
202713,Kyle Singler,1610612760,OKC,73,30,43,1665.0,33,9,24,0.273,139,0.237,1,0.239,12.9,161,38,122,0.236,340,0.474,30,0.519,7.2,194,47,146,0.242,479,0.405,31,0.433,8.2,2014-15,Regular%20Season
202681,Kyrie Irving,1610612739,CLE,72,51,21,2618.0,55,20,39,0.364,246,0.224,13,0.236,13.5,178,31,149,0.174,398,0.447,24,0.476,10.6,233,51,188,0.219,644,0.362,37,0.384,11.4,2014-15,Regular%20Season
200746,LaMarcus Aldridge,1610612757,POR,71,48,23,2512.0,177,119,47,0.672,344,0.515,15,0.538,6.4,549,163,387,0.297,797,0.689,50,0.735,4.9,726,282,434,0.388,1141,0.636,65,0.675,5.3,2014-15,Regular%20Season
202362,Lance Stephenson,1610612766,CHA,57,22,35,1516.0,39,16,22,0.41,158,0.247,5,0.255,9.4,238,33,202,0.139,347,0.686,28,0.746,6.0,277,49,224,0.177,505,0.549,33,0.587,6.4,2014-15,Regular%20Season
202498,Lance Thomas,1610612752,NYK,57,19,38,1408.0,65,29,32,0.446,178,0.365,6,0.378,9.0,126,23,103,0.183,224,0.563,15,0.603,8.5,191,52,135,0.272,402,0.475,21,0.501,8.6,2014-15,Regular%20Season
202361,Landry Fields,1610612761,TOR,12,8,4,174.0,10,4,6,0.4,17,0.588,0,0.588,6.9,16,1,15,0.063,22,0.727,2,0.8,8.1,26,5,21,0.192,39,0.667,2,0.703,7.6,2014-15,Regular%20Season
204038,Langston Galloway,1610612752,NYK,43,12,31,1400.0,37,15,23,0.405,110,0.336,8,0.363,13.8,152,24,130,0.158,254,0.598,23,0.658,9.1,189,39,153,0.206,364,0.519,31,0.568,10.0,2014-15,Regular%20Season
203580,Larry Drew II,1610612755,PHI,9,4,5,165.0,1,0,2,0.0,9,0.111,0,0.111,8.5,14,0,15,0.0,25,0.56,4,0.667,9.2,15,0,17,0.0,34,0.441,4,0.5,9.3,2014-15,Regular%20Season
202336,Larry Sanders,1610612749,MIL,27,12,15,586.0,67,44,20,0.657,142,0.472,4,0.486,4.3,99,47,50,0.475,191,0.518,15,0.563,4.3,166,91,70,0.548,333,0.498,19,0.529,4.3,2014-15,Regular%20Season
202730,Lavoy Allen,1610612754,IND,58,26,32,1055.0,123,75,44,0.61,272,0.452,8,0.466,5.5,200,61,138,0.305,345,0.58,32,0.639,4.8,323,136,182,0.421,617,0.524,40,0.56,5.0,2014-15,Regular%20Season
2544,LeBron James,1610612739,CLE,68,50,18,2453.0,51,27,23,0.529,214,0.238,4,0.243,9.7,361,73,288,0.202,530,0.681,13,0.698,7.5,412,100,311,0.243,744,0.554,17,0.567,7.7,2014-15,Regular%20Season
2571,Leandro Barbosa,1610612744,GSW,49,41,8,785.0,23,10,13,0.435,66,0.348,3,0.365,12.1,68,13,55,0.191,111,0.613,8,0.66,10.5,91,23,68,0.253,177,0.514,11,0.548,10.9,2014-15,Regular%20Season
201991,Lester Hudson,1610612746,LAC,3,3,0,54.0,1,0,1,0.0,5,0.2,0,0.2,7.4,7,3,4,0.429,10,0.7,0,0.7,9.1,8,3,5,0.375,15,0.533,0,0.533,8.9,2014-15,Regular%20Season
203485,Lorenzo Brown,1610612750,MIN,23,4,19,527.0,14,5,9,0.357,44,0.318,4,0.35,11.8,56,12,44,0.214,95,0.589,6,0.629,7.1,70,17,53,0.243,139,0.504,10,0.543,8.1,2014-15,Regular%20Season
200811,Lou Amundson,1610612752,NYK,49,17,32,912.0,93,60,31,0.645,235,0.396,6,0.406,5.1,169,59,108,0.349,339,0.499,34,0.554,4.2,262,119,139,0.454,574,0.456,40,0.491,4.5,2014-15,Regular%20Season
101150,Lou Williams,1610612761,TOR,65,39,26,1675.0,24,11,13,0.458,104,0.231,4,0.24,14.0,127,11,116,0.087,220,0.577,16,0.623,9.9,151,22,129,0.146,324,0.466,20,0.497,10.5,2014-15,Regular%20Season
201601,Luc Mbah a Moute,1610612755,PHI,66,16,50,1896.0,82,42,37,0.512,257,0.319,11,0.333,7.9,246,80,164,0.325,493,0.499,38,0.541,7.3,328,122,201,0.372,750,0.437,49,0.468,7.4,2014-15,Regular%20Season
203512,Lucas Nogueira,1610612761,TOR,5,2,3,21.0,2,2,0,1.0,7,0.286,0,0.286,4.0,9,4,5,0.444,9,1.0,1,1.125,4.8,11,6,5,0.545,16,0.688,1,0.733,4.7,2014-15,Regular%20Season
2449,Luis Scola,1610612754,IND,80,36,44,1642.0,138,88,42,0.638,365,0.378,10,0.389,5.9,388,127,258,0.327,600,0.647,56,0.713,4.3,526,215,300,0.409,965,0.545,66,0.585,4.7,2014-15,Regular%20Season
202337,Luke Babbitt,1610612740,NOP,40,18,22,642.0,12,7,5,0.583,42,0.286,2,0.3,11.4,97,26,75,0.268,173,0.561,14,0.61,5.8,109,33,80,0.303,215,0.507,16,0.548,6.4,2014-15,Regular%20Season
2557,Luke Ridnour,1610612753,ORL,35,12,23,556.0,8,3,4,0.375,26,0.308,0,0.308,8.0,60,6,54,0.1,95,0.632,6,0.674,9.8,68,9,58,0.132,121,0.562,6,0.591,9.6,2014-15,Regular%20Season
2736,Luol Deng,1610612748,MIA,70,31,39,2352.0,100,61,37,0.61,274,0.365,9,0.377,7.4,268,58,211,0.216,490,0.547,49,0.608,7.7,368,119,248,0.323,764,0.482,58,0.521,7.6,2014-15,Regular%20Season
202952,Malcolm Thomas,1610612755,PHI,15,2,13,187.0,16,10,6,0.625,36,0.444,1,0.457,4.8,40,15,27,0.375,56,0.714,6,0.8,4.7,56,25,33,0.446,92,0.609,7,0.659,4.7,2014-15,Regular%20Season
1938,Manu Ginobili,1610612759,SAS,67,45,22,1532.0,28,11,17,0.393,136,0.206,6,0.215,14.8,183,46,138,0.251,314,0.583,25,0.633,7.8,211,57,155,0.27,450,0.469,31,0.504,8.7,2014-15,Regular%20Season
201188,Marc Gasol,1610612763,MEM,81,55,26,2687.0,115,86,27,0.748,280,0.411,11,0.428,6.0,515,234,275,0.454,857,0.601,57,0.644,5.0,630,320,302,0.508,1137,0.554,68,0.589,5.2,2014-15,Regular%20Season
101162,Marcin Gortat,1610612764,WAS,82,46,36,2453.0,180,113,65,0.628,437,0.412,18,0.43,5.9,537,154,381,0.287,962,0.558,72,0.603,4.3,717,267,446,0.372,1399,0.513,90,0.548,4.7,2014-15,Regular%20Season
201158,Marco Belinelli,1610612759,SAS,56,37,19,1279.0,26,5,20,0.192,71,0.366,3,0.382,15.1,131,19,112,0.145,220,0.595,11,0.627,8.0,157,24,132,0.153,291,0.54,14,0.567,9.1,2014-15,Regular%20Season
202694,Marcus Morris Sr.,1610612756,PHX,75,33,42,1916.0,72,46,25,0.639,204,0.353,6,0.364,9.4,312,88,225,0.282,504,0.619,30,0.658,5.6,384,134,250,0.349,708,0.542,36,0.571,6.3,2014-15,Regular%20Season
203935,Marcus Smart,1610612738,BOS,59,30,29,1652.0,61,31,26,0.508,157,0.389,4,0.399,10.3,161,42,119,0.261,297,0.542,24,0.59,8.2,222,73,145,0.329,454,0.489,28,0.521,8.7,2014-15,Regular%20Season
201977,Marcus Thornton,1610612756,PHX,38,17,21,609.0,23,5,18,0.217,83,0.277,3,0.288,10.0,63,14,49,0.222,113,0.558,11,0.618,7.4,86,19,67,0.221,196,0.439,14,0.473,8.1,2014-15,Regular%20Season
201596,Mario Chalmers,1610612748,MIA,73,31,42,2219.0,23,7,18,0.304,161,0.143,6,0.148,13.6,182,30,155,0.165,369,0.493,30,0.537,9.4,205,37,173,0.18,530,0.387,36,0.415,9.9,2014-15,Regular%20Season
203900,Markel Brown,1610612751,BKN,34,16,18,694.0,16,7,9,0.438,60,0.267,3,0.281,12.6,91,14,77,0.154,132,0.689,8,0.734,7.6,107,21,86,0.196,192,0.557,11,0.591,8.3,2014-15,Regular%20Season
202693,Markieff Morris,1610612756,PHX,82,39,43,2581.0,110,58,51,0.527,292,0.377,12,0.393,7.9,396,131,261,0.331,727,0.545,75,0.607,5.2,506,189,312,0.374,1019,0.497,87,0.543,5.8,2014-15,Regular%20Season
201578,Marreese Speights,1610612744,GSW,70,57,13,1163.0,109,78,27,0.716,232,0.47,3,0.476,5.0,215,99,115,0.46,408,0.527,39,0.583,4.1,324,177,142,0.546,640,0.506,42,0.542,4.4,2014-15,Regular%20Season
101110,Martell Webster,1610612764,WAS,21,5,16,283.0,10,4,6,0.4,21,0.476,0,0.476,8.6,36,7,28,0.194,53,0.679,4,0.735,6.1,46,11,34,0.239,74,0.622,4,0.657,6.6,2014-15,Regular%20Season
101107,Marvin Williams,1610612766,CHA,76,30,46,1988.0,58,30,24,0.517,151,0.384,7,0.403,10.5,328,83,243,0.253,566,0.58,48,0.633,5.8,386,113,267,0.293,717,0.538,55,0.583,6.5,2014-15,Regular%20Season
203486,Mason Plumlee,1610612751,BKN,80,36,44,1730.0,175,117,50,0.669,413,0.424,11,0.435,5.7,337,137,201,0.407,595,0.566,56,0.625,4.3,512,254,251,0.496,1008,0.508,67,0.544,4.7,2014-15,Regular%20Season
2440,Matt Barnes,1610612746,LAC,74,50,24,2223.0,51,21,27,0.412,162,0.315,11,0.338,11.6,251,50,204,0.199,442,0.568,41,0.626,6.3,302,71,231,0.235,604,0.5,52,0.547,7.1,2014-15,Regular%20Season
2588,Matt Bonner,1610612759,SAS,50,36,14,773.0,29,14,15,0.483,64,0.453,2,0.468,12.3,84,24,62,0.286,181,0.464,13,0.5,6.2,113,38,77,0.336,245,0.461,15,0.491,7.7,2014-15,Regular%20Season
203521,Matthew Dellavedova,1610612739,CLE,49,31,18,1107.0,35,10,25,0.286,100,0.35,3,0.361,14.1,87,14,72,0.161,197,0.442,19,0.489,9.2,122,24,97,0.197,297,0.411,22,0.444,10.7,2014-15,Regular%20Season
203090,Maurice Harkless,1610612753,ORL,38,9,29,623.0,38,22,14,0.579,85,0.447,3,0.463,5.4,68,19,49,0.279,123,0.553,14,0.624,7.6,106,41,63,0.387,208,0.51,17,0.555,6.8,2014-15,Regular%20Season
203086,Meyers Leonard,1610612757,POR,49,26,23,830.0,46,26,21,0.565,127,0.362,4,0.374,8.4,204,63,141,0.309,314,0.65,27,0.711,4.8,250,89,162,0.356,441,0.567,31,0.61,5.5,2014-15,Regular%20Season
201563,Michael Beasley,1610612748,MIA,23,10,13,491.0,12,4,6,0.333,39,0.308,1,0.316,6.0,77,26,51,0.338,133,0.579,10,0.626,5.7,89,30,57,0.337,172,0.517,11,0.553,5.7,2014-15,Regular%20Season
203487,Michael Carter-Williams,1610612749,MIL,64,20,44,2099.0,64,35,28,0.547,233,0.275,8,0.284,11.0,289,63,228,0.218,493,0.586,31,0.626,7.3,353,98,256,0.278,726,0.486,39,0.514,8.0,2014-15,Regular%20Season
203077,Michael Kidd-Gilchrist,1610612766,CHA,55,27,28,1587.0,109,58,50,0.532,297,0.367,10,0.38,8.1,307,86,218,0.28,502,0.612,48,0.676,5.2,416,144,268,0.346,799,0.521,58,0.561,6.0,2014-15,Regular%20Season
201144,Mike Conley,1610612763,MEM,64,43,21,2051.0,29,8,21,0.276,123,0.236,7,0.25,14.0,180,24,159,0.133,338,0.533,32,0.588,9.6,209,32,180,0.153,461,0.453,39,0.495,10.1,2014-15,Regular%20Season
2399,Mike Dunleavy,1610612741,CHI,63,41,22,1838.0,28,17,12,0.607,135,0.207,5,0.215,7.7,220,43,178,0.195,426,0.516,54,0.591,7.4,248,60,190,0.242,561,0.442,59,0.494,7.5,2014-15,Regular%20Season
2034,Mike Miller,1610612739,CLE,40,23,17,627.0,4,1,3,0.25,27,0.148,2,0.16,18.1,87,15,72,0.172,143,0.608,10,0.654,6.9,91,16,75,0.176,170,0.535,12,0.576,7.4,2014-15,Regular%20Season
203488,Mike Muscala,1610612737,ATL,33,20,13,466.0,52,30,21,0.577,101,0.515,1,0.52,7.2,67,25,41,0.373,165,0.406,16,0.45,3.7,119,55,62,0.462,266,0.447,17,0.478,5.2,2014-15,Regular%20Season
203118,Mike Scott,1610612737,ATL,63,48,15,1049.0,45,29,16,0.644,99,0.455,2,0.464,6.9,154,55,99,0.357,269,0.572,19,0.616,5.9,199,84,115,0.422,368,0.541,21,0.573,6.1,2014-15,Regular%20Season
203101,Miles Plumlee,1610612749,MIL,70,34,36,1179.0,112,77,32,0.688,247,0.453,8,0.469,6.2,208,80,126,0.385,428,0.486,43,0.54,3.8,320,157,158,0.491,675,0.474,51,0.513,4.6,2014-15,Regular%20Season
203545,Miroslav Raduljica,1610612750,MIN,3,0,3,17.0,2,1,1,0.5,5,0.4,0,0.4,7.8,3,1,2,0.333,3,1.0,0,1.0,4.6,5,2,3,0.4,8,0.625,0,0.625,5.9,2014-15,Regular%20Season
203141,Mirza Teletovic,1610612751,BKN,39,16,23,881.0,27,16,12,0.593,79,0.342,2,0.351,6.5,167,56,109,0.335,308,0.542,22,0.584,4.9,194,72,121,0.371,387,0.501,24,0.534,5.1,2014-15,Regular%20Season
203956,Mitch McGary,1610612760,OKC,31,19,12,484.0,53,35,18,0.66,113,0.469,0,0.469,6.6,112,37,73,0.33,189,0.593,25,0.683,5.1,165,72,91,0.436,302,0.546,25,0.596,5.6,2014-15,Regular%20Season
2590,Mo Williams,1610612766,CHA,56,17,39,1678.0,21,4,18,0.19,72,0.292,5,0.313,16.6,150,20,134,0.133,269,0.558,18,0.598,9.5,171,24,152,0.14,341,0.501,23,0.538,10.4,2014-15,Regular%20Season
101145,Monta Ellis,1610612742,DAL,69,42,27,2324.0,34,13,20,0.382,161,0.211,8,0.222,11.9,156,23,134,0.147,303,0.515,17,0.545,9.4,190,36,154,0.189,464,0.409,25,0.433,9.8,2014-15,Regular%20Season
101126,Nate Robinson,1610612743,DEN,24,13,11,369.0,17,2,14,0.118,42,0.405,1,0.415,17.6,33,4,30,0.121,49,0.673,0,0.673,14.4,50,6,44,0.12,91,0.549,1,0.556,15.5,2014-15,Regular%20Season
203489,Nate Wolters,1610612749,MIL,15,11,4,218.0,8,5,3,0.625,20,0.4,1,0.421,15.1,26,5,22,0.192,45,0.578,2,0.605,8.2,34,10,25,0.294,65,0.523,3,0.548,9.8,2014-15,Regular%20Season
1737,Nazr Mohammed,1610612741,CHI,16,9,7,115.0,11,7,4,0.636,18,0.611,1,0.647,6.3,27,12,13,0.444,39,0.692,2,0.73,4.3,38,19,17,0.5,57,0.667,3,0.704,4.9,2014-15,Regular%20Season
2403,Nene,1610612764,WAS,66,36,30,1687.0,84,47,37,0.56,249,0.337,11,0.353,8.8,261,101,156,0.387,438,0.596,35,0.648,5.4,345,148,193,0.429,687,0.502,46,0.538,6.2,2014-15,Regular%20Season
203457,Nerlens Noel,1610612755,PHI,75,18,57,2311.0,185,105,75,0.568,449,0.412,13,0.424,6.0,426,151,271,0.354,729,0.584,58,0.635,4.7,611,256,346,0.419,1178,0.519,71,0.552,5.1,2014-15,Regular%20Season
201979,Nick Calathes,1610612763,MEM,47,29,18,764.0,19,12,7,0.632,64,0.297,1,0.302,7.1,86,19,68,0.221,159,0.541,16,0.601,8.3,105,31,75,0.295,223,0.471,17,0.51,8.1,2014-15,Regular%20Season
2555,Nick Collison,1610612760,OKC,62,37,25,1068.0,90,59,30,0.656,202,0.446,6,0.459,5.8,160,71,87,0.444,305,0.525,28,0.578,5.5,250,130,117,0.52,507,0.493,34,0.529,5.6,2014-15,Regular%20Season
203910,Nick Johnson,1610612745,HOU,16,11,5,212.0,13,7,6,0.538,33,0.394,0,0.394,7.1,26,9,16,0.346,51,0.51,5,0.565,7.9,39,16,22,0.41,84,0.464,5,0.494,7.6,2014-15,Regular%20Season
201156,Nick Young,1610612747,LAL,39,11,28,941.0,17,4,14,0.235,61,0.279,2,0.288,17.9,79,13,66,0.165,131,0.603,12,0.664,9.8,96,17,80,0.177,192,0.5,14,0.539,11.4,2014-15,Regular%20Season
201587,Nicolas Batum,1610612757,POR,70,42,28,2346.0,62,30,32,0.484,199,0.312,5,0.32,10.4,354,59,293,0.167,588,0.602,49,0.657,5.7,416,89,325,0.214,787,0.529,54,0.568,6.4,2014-15,Regular%20Season
203917,Nik Stauskas,1610612758,SAC,46,16,30,802.0,11,2,10,0.182,50,0.22,2,0.229,16.1,77,12,64,0.156,124,0.621,8,0.664,9.4,88,14,74,0.159,174,0.506,10,0.537,10.3,2014-15,Regular%20Season
202703,Nikola Mirotic,1610612741,CHI,73,47,26,1576.0,63,38,23,0.603,190,0.332,5,0.341,7.4,341,117,222,0.343,536,0.636,38,0.685,4.7,404,155,245,0.384,726,0.556,43,0.592,5.1,2014-15,Regular%20Season
201593,Nikola Pekovic,1610612750,MIN,30,9,21,787.0,85,62,21,0.729,209,0.407,8,0.423,5.1,136,58,78,0.426,227,0.599,22,0.663,4.4,221,120,99,0.543,436,0.507,30,0.544,4.7,2014-15,Regular%20Season
202696,Nikola Vucevic,1610612753,ORL,74,21,53,2529.0,238,158,74,0.664,416,0.572,3,0.576,5.1,572,221,346,0.386,807,0.709,58,0.764,4.2,810,379,420,0.468,1223,0.662,61,0.697,4.5,2014-15,Regular%20Season
203943,Noah Vonleh,1610612766,CHA,19,5,14,234.0,28,21,8,0.75,65,0.431,1,0.438,4.6,58,16,41,0.276,82,0.707,6,0.763,3.9,86,37,49,0.43,147,0.585,7,0.614,4.1,2014-15,Regular%20Season
202708,Norris Cole,1610612740,NOP,65,32,33,1604.0,12,3,8,0.25,89,0.135,8,0.148,18.8,145,16,132,0.11,286,0.507,18,0.541,10.8,157,19,140,0.121,375,0.419,26,0.45,11.3,2014-15,Regular%20Season
201564,O.J. Mayo,1610612749,MIL,63,34,29,1574.0,30,12,19,0.4,116,0.259,6,0.273,14.0,156,33,119,0.212,301,0.518,26,0.567,8.7,186,45,138,0.242,417,0.446,32,0.483,9.6,2014-15,Regular%20Season
203136,Ognjen Kuzmic,1610612744,GSW,12,10,2,66.0,7,7,0,1.0,14,0.5,1,0.538,7.5,10,5,7,0.5,26,0.385,4,0.455,4.1,17,12,7,0.706,40,0.425,5,0.486,5.4,2014-15,Regular%20Season
201600,Omer Asik,1610612740,NOP,76,43,33,1982.0,244,177,61,0.725,562,0.434,14,0.445,4.4,504,198,301,0.393,802,0.628,67,0.686,3.9,748,375,362,0.501,1364,0.548,81,0.583,4.1,2014-15,Regular%20Season
201956,Omri Casspi,1610612758,SAC,63,22,41,1373.0,54,33,19,0.611,204,0.265,6,0.273,7.0,206,34,174,0.165,351,0.587,33,0.648,6.4,260,67,193,0.258,555,0.468,39,0.504,6.5,2014-15,Regular%20Season
203490,Otto Porter Jr.,1610612764,WAS,67,36,31,1368.0,70,33,37,0.471,171,0.409,9,0.432,8.8,151,29,121,0.192,280,0.539,23,0.588,6.8,221,62,158,0.281,451,0.49,32,0.527,7.5,2014-15,Regular%20Season
200782,P.J. Tucker,1610612756,PHX,78,36,42,2383.0,114,75,36,0.658,281,0.406,12,0.424,7.0,388,103,281,0.265,613,0.633,47,0.686,5.6,502,178,317,0.355,894,0.562,59,0.601,5.9,2014-15,Regular%20Season
203798,PJ Hairston,1610612766,CHA,36,18,18,587.0,22,11,11,0.5,65,0.338,0,0.338,13.1,70,11,58,0.157,111,0.631,11,0.7,6.6,92,22,69,0.239,176,0.523,11,0.558,8.2,2014-15,Regular%20Season
203143,Pablo Prigioni,1610612745,HOU,54,20,34,1062.0,30,10,22,0.333,85,0.353,7,0.385,13.7,89,5,86,0.056,168,0.53,5,0.546,10.8,119,15,108,0.126,253,0.47,12,0.494,11.6,2014-15,Regular%20Season
201976,Patrick Beverley,1610612745,HOU,56,35,21,1727.0,67,34,33,0.507,207,0.324,3,0.328,11.6,170,35,132,0.206,331,0.514,37,0.578,8.7,237,69,165,0.291,538,0.441,40,0.476,9.5,2014-15,Regular%20Season
203565,Patrick Christopher,1610612763,MEM,3,1,2,23.0,2,1,1,0.5,5,0.4,1,0.5,11.8,4,1,3,0.25,6,0.667,0,0.667,5.6,6,2,4,0.333,11,0.545,1,0.6,7.7,2014-15,Regular%20Season
202335,Patrick Patterson,1610612761,TOR,80,49,31,2141.0,127,66,60,0.52,239,0.531,2,0.536,8.7,306,102,203,0.333,551,0.555,46,0.606,5.0,433,168,263,0.388,790,0.548,48,0.584,6.1,2014-15,Regular%20Season
201988,Patty Mills,1610612759,SAS,41,31,10,687.0,21,7,14,0.333,58,0.362,0,0.362,15.2,54,12,43,0.222,130,0.415,11,0.454,10.8,75,19,57,0.253,188,0.399,11,0.424,12.0,2014-15,Regular%20Season
2200,Pau Gasol,1610612741,CHI,78,48,30,2681.0,220,124,89,0.564,465,0.473,11,0.485,7.0,699,252,443,0.361,1163,0.601,90,0.651,4.4,919,376,532,0.409,1628,0.564,101,0.602,5.0,2014-15,Regular%20Season
202331,Paul George,1610612754,IND,6,5,1,91.0,4,4,0,1.0,8,0.5,0,0.5,5.3,18,2,16,0.111,26,0.692,1,0.72,6.9,22,6,16,0.273,34,0.647,1,0.667,6.6,2014-15,Regular%20Season
200794,Paul Millsap,1610612737,ATL,73,55,18,2390.0,139,103,34,0.741,366,0.38,8,0.388,5.4,431,175,252,0.406,752,0.573,35,0.601,4.8,570,278,286,0.488,1118,0.51,43,0.53,4.9,2014-15,Regular%20Season
1718,Paul Pierce,1610612764,WAS,70,38,32,1842.0,45,24,17,0.533,123,0.366,8,0.391,9.2,249,42,208,0.169,412,0.604,26,0.645,7.2,294,66,225,0.224,535,0.55,34,0.587,7.5,2014-15,Regular%20Season
203544,Pero Antic,1610612737,ATL,55,39,16,927.0,58,39,19,0.672,145,0.4,3,0.408,5.0,131,55,76,0.42,255,0.514,19,0.555,5.9,189,94,95,0.497,400,0.473,22,0.5,5.6,2014-15,Regular%20Season
203103,Perry Jones III,1610612760,OKC,28,15,13,562.0,6,3,3,0.5,38,0.158,3,0.171,7.7,70,16,54,0.229,108,0.648,6,0.686,7.4,76,19,57,0.25,146,0.521,9,0.555,7.4,2014-15,Regular%20Season
203515,Phil Pressey,1610612738,BOS,36,17,19,546.0,13,2,10,0.154,61,0.213,0,0.213,17.2,67,8,58,0.119,120,0.558,9,0.604,9.5,80,10,68,0.125,181,0.442,9,0.465,10.7,2014-15,Regular%20Season
203112,Quincy Acy,1610612752,NYK,66,12,54,1282.0,79,46,29,0.582,226,0.35,10,0.366,7.4,222,56,166,0.252,366,0.607,27,0.655,5.1,301,102,195,0.339,592,0.508,37,0.542,5.7,2014-15,Regular%20Season
203113,Quincy Miller,1610612765,DET,8,1,7,104.0,4,1,3,0.25,22,0.182,3,0.211,7.7,16,1,15,0.063,35,0.457,4,0.516,5.0,20,2,18,0.1,57,0.351,7,0.4,5.5,2014-15,Regular%20Season
202347,Quincy Pondexter,1610612740,NOP,62,39,23,1561.0,53,29,26,0.547,170,0.312,7,0.325,11.0,142,26,113,0.183,259,0.548,23,0.602,8.9,195,55,139,0.282,429,0.455,30,0.489,9.5,2014-15,Regular%20Season
200765,Rajon Rondo,1610612742,DAL,66,32,34,1996.0,73,33,38,0.452,219,0.333,3,0.338,9.5,300,42,258,0.14,499,0.601,39,0.652,7.2,373,75,296,0.201,718,0.519,42,0.552,7.7,2014-15,Regular%20Season
201196,Ramon Sessions,1610612764,WAS,50,21,29,1027.0,23,7,15,0.304,74,0.311,3,0.324,13.3,120,16,104,0.133,196,0.612,6,0.632,9.6,143,23,119,0.161,270,0.53,9,0.548,10.2,2014-15,Regular%20Season
200751,Randy Foye,1610612743,DEN,35,12,23,863.0,9,1,8,0.111,45,0.2,3,0.214,19.4,76,7,71,0.092,148,0.514,14,0.567,11.0,85,8,79,0.094,193,0.44,17,0.483,11.9,2014-15,Regular%20Season
2446,Rasual Butler,1610612764,WAS,65,37,28,1463.0,27,11,16,0.407,75,0.36,6,0.391,15.1,170,32,139,0.188,274,0.62,18,0.664,7.5,197,43,155,0.218,349,0.564,24,0.606,8.6,2014-15,Regular%20Season
203492,Ray McCallum,1610612758,SAC,58,18,40,1353.0,52,23,24,0.442,140,0.371,7,0.391,11.4,128,22,107,0.172,222,0.577,9,0.601,9.7,180,45,131,0.25,362,0.497,16,0.52,10.2,2014-15,Regular%20Season
101109,Raymond Felton,1610612742,DAL,12,8,4,174.0,2,0,2,0.0,8,0.25,1,0.286,19.7,24,3,21,0.125,38,0.632,1,0.649,11.9,26,3,23,0.115,46,0.565,2,0.591,12.5,2014-15,Regular%20Season
203493,Reggie Bullock Jr.,1610612756,PHX,26,15,11,278.0,1,1,0,1.0,10,0.1,0,0.1,5.7,49,8,43,0.163,74,0.662,5,0.71,7.3,50,9,43,0.18,84,0.595,5,0.633,7.3,2014-15,Regular%20Season
2501,Reggie Evans,1610612758,SAC,45,16,29,752.0,97,69,27,0.711,254,0.382,11,0.399,5.4,202,64,135,0.317,331,0.61,22,0.654,4.5,299,133,162,0.445,585,0.511,33,0.542,4.8,2014-15,Regular%20Season
202704,Reggie Jackson,1610612765,DET,76,37,39,2254.0,56,14,40,0.25,193,0.29,15,0.315,12.1,271,37,235,0.137,467,0.58,40,0.635,8.4,327,51,275,0.156,660,0.495,55,0.54,9.1,2014-15,Regular%20Season
202130,Reggie Williams,1610612759,SAS,9,7,2,75.0,5,3,2,0.6,9,0.556,1,0.625,12.6,12,3,9,0.25,19,0.632,1,0.667,5.7,17,6,11,0.353,28,0.607,2,0.654,7.7,2014-15,Regular%20Season
2210,Richard Jefferson,1610612742,DAL,63,41,22,1109.0,23,9,14,0.391,99,0.232,4,0.242,11.9,158,39,122,0.247,272,0.581,19,0.625,6.8,181,48,136,0.265,371,0.488,23,0.52,7.4,2014-15,Regular%20Season
203495,Ricky Ledo,1610612752,NYK,15,4,11,240.0,16,9,8,0.563,44,0.364,2,0.381,8.6,20,2,19,0.1,34,0.588,1,0.606,6.0,36,11,27,0.306,78,0.462,3,0.48,7.1,2014-15,Regular%20Season
201937,Ricky Rubio,1610612750,MIN,22,7,15,692.0,19,9,9,0.474,53,0.358,3,0.38,12.5,106,17,90,0.16,168,0.631,13,0.684,7.4,125,26,99,0.208,221,0.566,16,0.61,8.1,2014-15,Regular%20Season
203133,Robbie Hummel,1610612750,MIN,38,4,34,689.0,31,17,13,0.548,88,0.352,2,0.36,7.6,103,31,73,0.301,185,0.557,16,0.609,5.3,134,48,86,0.358,273,0.491,18,0.525,5.8,2014-15,Regular%20Season
203496,Robert Covington,1610612755,PHI,69,18,51,1954.0,65,37,28,0.569,216,0.301,10,0.316,8.1,251,78,171,0.311,472,0.532,42,0.584,6.1,316,115,199,0.364,688,0.459,52,0.497,6.5,2014-15,Regular%20Season
203135,Robert Sacre,1610612747,LAL,59,17,42,1049.0,89,53,35,0.596,206,0.432,7,0.447,6.6,144,40,103,0.278,300,0.48,29,0.531,6.0,233,93,138,0.399,506,0.46,36,0.496,6.2,2014-15,Regular%20Season
201577,Robin Lopez,1610612757,POR,58,38,20,1613.0,190,145,36,0.763,455,0.418,12,0.429,4.6,204,92,113,0.451,481,0.424,60,0.485,5.1,394,237,149,0.602,936,0.421,72,0.456,4.9,2014-15,Regular%20Season
203918,Rodney Hood,1610612762,UTA,45,24,21,987.0,9,1,8,0.111,54,0.167,4,0.18,15.8,108,21,86,0.194,203,0.532,11,0.563,6.6,117,22,94,0.188,257,0.455,15,0.483,7.3,2014-15,Regular%20Season
201155,Rodney Stuckey,1610612754,IND,66,31,35,1790.0,36,14,22,0.389,142,0.254,4,0.261,15.0,212,27,181,0.127,327,0.648,23,0.697,8.2,248,41,203,0.165,469,0.529,27,0.561,9.2,2014-15,Regular%20Season
101179,Ronnie Price,1610612747,LAL,33,10,23,772.0,19,2,15,0.105,63,0.302,2,0.311,16.4,50,10,41,0.2,112,0.446,8,0.481,11.4,69,12,56,0.174,175,0.394,10,0.418,12.6,2014-15,Regular%20Season
201579,Roy Hibbert,1610612754,IND,76,34,42,1926.0,156,103,47,0.66,360,0.433,4,0.438,5.5,384,117,263,0.305,686,0.56,64,0.617,4.8,540,220,310,0.407,1046,0.516,68,0.552,5.0,2014-15,Regular%20Season
200752,Rudy Gay,1610612758,SAC,68,25,43,2408.0,98,57,37,0.582,297,0.33,8,0.339,8.0,301,70,227,0.233,500,0.602,28,0.638,6.8,399,127,264,0.318,797,0.501,36,0.524,7.1,2014-15,Regular%20Season
203497,Rudy Gobert,1610612762,UTA,82,38,44,2158.0,265,189,67,0.713,531,0.499,10,0.509,5.4,510,184,323,0.361,865,0.59,77,0.647,3.8,775,373,390,0.481,1396,0.555,87,0.592,4.3,2014-15,Regular%20Season
203893,Russ Smith,1610612763,MEM,4,1,3,45.0,1,0,1,0.0,3,0.333,0,0.333,13.9,5,2,3,0.4,8,0.625,0,0.625,7.3,6,2,4,0.333,11,0.545,0,0.545,8.4,2014-15,Regular%20Season
201566,Russell Westbrook,1610612760,OKC,66,40,26,2293.0,124,58,59,0.468,393,0.316,11,0.325,10.0,364,79,289,0.217,529,0.688,22,0.718,8.4,488,137,348,0.281,922,0.529,33,0.549,8.8,2014-15,Regular%20Season
201583,Ryan Anderson,1610612740,NOP,61,33,28,1675.0,108,82,24,0.759,247,0.437,10,0.456,5.5,187,84,100,0.449,335,0.558,31,0.615,5.6,295,166,124,0.563,582,0.507,41,0.545,5.5,2014-15,Regular%20Season
200797,Ryan Hollins,1610612758,SAC,32,9,23,364.0,36,22,10,0.611,81,0.444,0,0.444,4.8,67,21,45,0.313,142,0.472,16,0.532,4.5,103,43,55,0.417,223,0.462,16,0.498,4.6,2014-15,Regular%20Season
203527,Ryan Kelly,1610612747,LAL,49,10,39,1196.0,13,5,8,0.385,73,0.178,2,0.183,9.4,133,24,107,0.18,224,0.594,18,0.646,7.0,146,29,115,0.199,297,0.492,20,0.527,7.3,2014-15,Regular%20Season
2223,Samuel Dalembert,1610612752,NYK,32,5,27,544.0,53,38,13,0.717,107,0.495,1,0.5,6.9,115,50,64,0.435,215,0.535,18,0.584,3.3,168,88,77,0.524,322,0.522,19,0.554,4.4,2014-15,Regular%20Season
203930,Sean Kilpatrick,1610612750,MIN,4,2,2,72.0,1,1,0,1.0,3,0.333,0,0.333,1.4,5,1,4,0.2,13,0.385,0,0.385,6.4,6,2,4,0.333,16,0.375,0,0.375,5.6,2014-15,Regular%20Season
2742,Sebastian Telfair,1610612760,OKC,14,3,11,303.0,2,0,2,0.0,13,0.154,0,0.154,4.3,28,0,28,0.0,38,0.737,0,0.737,12.1,30,0,30,0.0,51,0.588,0,0.588,11.6,2014-15,Regular%20Season
201586,Serge Ibaka,1610612760,OKC,63,34,29,2090.0,135,79,51,0.585,315,0.429,16,0.452,6.5,364,129,233,0.354,708,0.514,68,0.569,4.0,499,208,284,0.417,1023,0.488,84,0.531,4.7,2014-15,Regular%20Season
203508,Sergey Karasev,1610612751,BKN,26,10,16,519.0,22,7,16,0.318,55,0.4,0,0.4,10.1,44,4,40,0.091,91,0.484,12,0.557,6.7,66,11,56,0.167,146,0.452,12,0.493,8.1,2014-15,Regular%20Season
203552,Seth Curry,1610612756,PHX,1,1,0,7.0,0,0,0,0.0,0,0.0,0,0.0,0.0,2,0,2,0.0,3,0.667,0,0.667,6.0,2,0,2,0.0,3,0.667,0,0.667,6.0,2014-15,Regular%20Season
203498,Shabazz Muhammad,1610612750,MIN,32,5,27,769.0,61,42,14,0.689,157,0.389,4,0.399,6.4,91,31,61,0.341,143,0.636,10,0.684,5.9,152,73,75,0.48,300,0.507,14,0.531,6.1,2014-15,Regular%20Season
203894,Shabazz Napier,1610612748,MIA,44,20,24,941.0,17,8,9,0.471,72,0.236,2,0.243,12.2,96,11,86,0.115,184,0.522,21,0.589,9.8,113,19,95,0.168,256,0.441,23,0.485,10.1,2014-15,Regular%20Season
203499,Shane Larkin,1610612752,NYK,67,13,54,1699.0,29,7,22,0.241,89,0.326,2,0.333,18.1,146,19,131,0.13,298,0.49,37,0.559,8.6,175,26,153,0.149,387,0.452,39,0.503,10.2,2014-15,Regular%20Season
200769,Shannon Brown,1610612748,MIA,2,0,2,34.0,0,0,0,0.0,5,0.0,0,0.0,0.0,1,0,2,0.0,4,0.25,1,0.333,8.3,1,0,2,0.0,9,0.111,1,0.125,8.3,2014-15,Regular%20Season
2733,Shaun Livingston,1610612744,GSW,67,56,11,1307.0,43,19,24,0.442,131,0.328,5,0.341,8.5,139,32,110,0.23,268,0.519,11,0.541,9.4,182,51,134,0.28,399,0.456,16,0.475,9.3,2014-15,Regular%20Season
101183,Shavlik Randolph,1610612756,PHX,15,8,7,108.0,16,12,4,0.75,39,0.41,1,0.421,3.9,22,10,11,0.455,45,0.489,7,0.579,3.7,38,22,15,0.579,84,0.452,8,0.5,3.8,2014-15,Regular%20Season
1890,Shawn Marion,1610612739,CLE,53,34,19,1064.0,61,36,21,0.59,155,0.394,7,0.412,6.7,136,28,107,0.206,223,0.61,14,0.651,6.3,197,64,128,0.325,378,0.521,21,0.552,6.4,2014-15,Regular%20Season
200761,Shawne Williams,1610612765,DET,50,22,28,960.0,33,11,21,0.333,86,0.384,4,0.402,9.9,127,39,83,0.307,247,0.514,13,0.543,5.4,160,50,104,0.313,333,0.48,17,0.506,6.3,2014-15,Regular%20Season
203963,Shayne Whittington,1610612754,IND,14,6,8,95.0,10,7,3,0.7,25,0.4,0,0.4,5.8,19,5,14,0.263,33,0.576,2,0.613,3.7,29,12,17,0.414,58,0.5,2,0.518,4.4,2014-15,Regular%20Season
202714,Shelvin Mack,1610612737,ATL,43,29,14,731.0,8,2,6,0.25,55,0.145,1,0.148,12.3,71,11,60,0.155,131,0.542,5,0.563,8.5,79,13,66,0.165,186,0.425,6,0.439,8.9,2014-15,Regular%20Season
204021,Sim Bhullar,1610612758,SAC,1,0,1,1.0,0,0,0,0.0,1,0.0,0,0.0,0.0,1,0,1,0.0,1,1.0,0,1.0,5.6,1,0,1,0.0,2,0.5,0,0.5,5.6,2014-15,Regular%20Season
203524,Solomon Hill,1610612754,IND,80,37,43,2342.0,70,44,26,0.629,239,0.293,13,0.31,8.3,244,55,185,0.225,451,0.541,36,0.588,7.7,314,99,211,0.315,690,0.455,49,0.49,7.8,2014-15,Regular%20Season
203915,Spencer Dinwiddie,1610612765,DET,23,7,16,369.0,4,3,1,0.75,25,0.16,0,0.16,10.2,44,6,38,0.136,66,0.667,3,0.698,10.0,48,9,39,0.188,91,0.527,3,0.545,10.0,2014-15,Regular%20Season
201150,Spencer Hawes,1610612746,LAC,69,49,20,1247.0,30,19,12,0.633,113,0.265,2,0.27,7.1,228,77,151,0.338,435,0.524,49,0.591,4.7,258,96,163,0.372,548,0.471,51,0.519,5.0,2014-15,Regular%20Season
201939,Stephen Curry,1610612744,GSW,79,66,13,2579.0,56,22,36,0.393,266,0.211,9,0.218,11.9,285,54,233,0.189,565,0.504,33,0.536,9.4,341,76,269,0.223,831,0.41,42,0.432,9.8,2014-15,Regular%20Season
2581,Steve Blake,1610612757,POR,64,44,20,1258.0,16,5,11,0.313,48,0.333,0,0.333,17.0,121,10,112,0.083,258,0.469,25,0.519,10.5,137,15,123,0.109,306,0.448,25,0.488,11.2,2014-15,Regular%20Season
200779,Steve Novak,1610612760,OKC,16,6,10,117.0,2,0,2,0.0,4,0.5,0,0.5,22.4,20,4,15,0.2,30,0.667,0,0.667,5.9,22,4,17,0.182,34,0.647,0,0.647,7.5,2014-15,Regular%20Season
203500,Steven Adams,1610612760,OKC,69,36,33,1757.0,199,137,56,0.688,493,0.404,15,0.416,5.2,324,111,209,0.343,550,0.589,47,0.644,4.2,523,248,265,0.474,1043,0.501,62,0.533,4.6,2014-15,Regular%20Season
203933,T.J. Warren,1610612756,PHX,34,13,21,593.0,41,26,15,0.634,102,0.402,2,0.41,6.7,44,14,30,0.318,96,0.458,3,0.473,7.2,85,40,45,0.471,198,0.429,5,0.44,7.0,2014-15,Regular%20Season
201959,Taj Gibson,1610612741,CHI,61,37,24,1678.0,162,119,39,0.735,377,0.43,16,0.449,5.5,234,82,149,0.35,461,0.508,44,0.561,6.0,396,201,188,0.508,838,0.473,60,0.509,5.8,2014-15,Regular%20Season
204028,Tarik Black,1610612747,LAL,61,23,38,1175.0,138,88,48,0.638,292,0.473,3,0.478,5.7,224,81,142,0.362,405,0.553,39,0.612,4.8,362,169,190,0.467,697,0.519,42,0.553,5.1,2014-15,Regular%20Season
2419,Tayshaun Prince,1610612765,DET,56,26,30,1365.0,52,25,27,0.481,123,0.423,5,0.441,8.9,158,46,108,0.291,259,0.61,23,0.669,7.1,210,71,135,0.338,382,0.55,28,0.593,7.6,2014-15,Regular%20Season
203093,Terrence Jones,1610612745,HOU,31,23,8,858.0,78,51,23,0.654,165,0.473,4,0.484,6.1,142,46,94,0.324,259,0.548,15,0.582,5.9,220,97,117,0.441,424,0.519,19,0.543,5.9,2014-15,Regular%20Season
203082,Terrence Ross,1610612761,TOR,76,46,30,1948.0,32,6,26,0.188,87,0.368,4,0.386,17.7,194,40,152,0.206,346,0.561,15,0.586,7.0,226,46,178,0.204,433,0.522,19,0.546,8.5,2014-15,Regular%20Season
200757,Thabo Sefolosha,1610612737,ATL,50,41,9,961.0,53,25,28,0.472,134,0.396,5,0.411,10.0,170,24,144,0.141,246,0.691,22,0.759,6.9,223,49,172,0.22,380,0.587,27,0.632,7.6,2014-15,Regular%20Season
201152,Thaddeus Young,1610612751,BKN,74,25,49,2376.0,126,81,42,0.643,331,0.381,13,0.396,8.0,282,81,203,0.287,532,0.53,35,0.567,7.2,408,162,245,0.397,863,0.473,48,0.501,7.4,2014-15,Regular%20Season
203080,Thomas Robinson,1610612755,PHI,51,24,27,782.0,95,65,32,0.684,256,0.371,10,0.386,5.6,208,87,121,0.418,312,0.667,24,0.722,4.8,303,152,153,0.502,568,0.533,34,0.567,5.1,2014-15,Regular%20Season
201168,Tiago Splitter,1610612759,SAS,51,34,17,1022.0,91,61,27,0.67,210,0.433,5,0.444,5.2,161,64,98,0.398,298,0.54,35,0.612,4.8,252,125,125,0.496,508,0.496,40,0.538,4.9,2014-15,Regular%20Season
1495,Tim Duncan,1610612759,SAS,77,53,24,2227.0,170,106,60,0.624,389,0.437,17,0.457,7.0,534,225,301,0.421,884,0.604,69,0.655,4.2,704,331,361,0.47,1273,0.553,86,0.593,4.9,2014-15,Regular%20Season
204025,Tim Frazier,1610612757,POR,8,2,6,222.0,6,1,5,0.167,27,0.222,0,0.222,12.6,22,6,16,0.273,54,0.407,13,0.537,7.1,28,7,21,0.25,81,0.346,13,0.412,8.3,2014-15,Regular%20Season
203501,Tim Hardaway Jr.,1610612752,NYK,56,13,43,1434.0,12,5,7,0.417,84,0.143,3,0.148,15.6,140,34,108,0.243,230,0.609,14,0.648,9.4,152,39,115,0.257,314,0.484,17,0.512,9.9,2014-15,Regular%20Season
202389,Timofey Mozgov,1610612739,CLE,81,49,32,2046.0,203,132,66,0.65,500,0.406,14,0.418,5.5,388,181,206,0.466,716,0.542,69,0.6,4.0,591,313,272,0.53,1216,0.486,83,0.522,4.5,2014-15,Regular%20Season
202699,Tobias Harris,1610612753,ORL,67,20,47,2352.0,73,40,30,0.548,226,0.323,6,0.332,8.7,357,81,276,0.227,522,0.684,33,0.73,6.1,430,121,306,0.281,748,0.575,39,0.606,6.5,2014-15,Regular%20Season
201962,Toney Douglas,1610612740,NOP,10,5,5,160.0,2,1,1,0.5,13,0.154,0,0.154,10.8,20,2,18,0.1,33,0.606,3,0.667,8.3,22,3,19,0.136,46,0.478,3,0.512,8.5,2014-15,Regular%20Season
2754,Tony Allen,1610612763,MEM,61,44,17,1598.0,103,72,29,0.699,320,0.322,10,0.332,5.2,177,38,139,0.215,270,0.656,15,0.694,7.3,280,110,168,0.393,590,0.475,25,0.496,6.5,2014-15,Regular%20Season
2225,Tony Parker,1610612759,SAS,55,38,17,1639.0,15,6,11,0.4,126,0.119,7,0.126,17.4,114,11,103,0.096,214,0.533,17,0.579,10.5,129,17,114,0.132,340,0.379,24,0.408,11.3,2014-15,Regular%20Season
203503,Tony Snell,1610612741,CHI,59,35,24,1355.0,31,8,23,0.258,93,0.333,5,0.352,13.1,145,34,113,0.234,256,0.566,18,0.609,8.0,176,42,136,0.239,349,0.504,23,0.54,8.9,2014-15,Regular%20Season
203100,Tony Wroten,1610612755,PHI,29,4,25,871.0,22,14,10,0.636,106,0.208,4,0.216,9.3,64,11,53,0.172,130,0.492,10,0.533,7.9,86,25,63,0.291,236,0.364,14,0.387,8.3,2014-15,Regular%20Season
203315,Toure' Murry,1610612762,UTA,1,0,1,9.0,1,0,1,0.0,1,1.0,0,1.0,9.0,0,0,0,0.0,1,0.0,1,0.0,0.0,1,0,1,0.0,2,0.5,1,1.0,9.0,2014-15,Regular%20Season
204037,Travis Wear,1610612752,NYK,37,5,32,572.0,30,17,13,0.567,84,0.357,5,0.38,8.2,72,16,55,0.222,151,0.477,14,0.526,6.2,102,33,68,0.324,235,0.434,19,0.472,6.8,2014-15,Regular%20Season
2772,Trevor Ariza,1610612745,HOU,81,55,26,2896.0,76,33,38,0.434,303,0.251,15,0.264,11.8,378,79,297,0.209,617,0.613,53,0.67,5.9,454,112,335,0.247,920,0.493,68,0.533,6.8,2014-15,Regular%20Season
202344,Trevor Booker,1610612762,UTA,75,36,39,1523.0,139,73,64,0.525,295,0.471,11,0.489,7.4,258,79,176,0.306,423,0.61,32,0.66,5.0,397,152,240,0.383,718,0.553,43,0.588,5.8,2014-15,Regular%20Season
203504,Trey Burke,1610612762,UTA,70,32,38,2132.0,31,6,29,0.194,134,0.231,5,0.24,15.0,173,20,157,0.116,331,0.523,21,0.558,11.2,204,26,186,0.127,465,0.439,26,0.465,12.0,2014-15,Regular%20Season
202684,Tristan Thompson,1610612739,CLE,80,52,28,2138.0,270,202,59,0.748,666,0.405,22,0.419,4.8,378,129,248,0.341,660,0.573,54,0.624,5.0,648,331,307,0.511,1326,0.489,76,0.518,4.9,2014-15,Regular%20Season
203584,Troy Daniels,1610612766,CHA,19,2,17,271.0,8,3,5,0.375,23,0.348,0,0.348,12.0,25,5,22,0.2,49,0.51,6,0.581,5.9,33,8,27,0.242,72,0.458,6,0.5,7.3,2014-15,Regular%20Season
201951,Ty Lawson,1610612743,DEN,71,27,44,2547.0,42,7,35,0.167,179,0.235,11,0.25,18.8,192,21,174,0.109,337,0.57,22,0.61,11.4,234,28,209,0.12,516,0.453,33,0.484,12.7,2014-15,Regular%20Season
203898,Tyler Ennis,1610612749,MIL,21,3,18,304.0,7,3,4,0.429,18,0.389,0,0.389,7.6,28,6,23,0.214,46,0.609,3,0.651,7.4,35,9,27,0.257,64,0.547,3,0.574,7.4,2014-15,Regular%20Season
201946,Tyler Hansbrough,1610612761,TOR,70,43,27,1036.0,106,76,28,0.717,236,0.449,9,0.467,5.7,159,59,98,0.371,286,0.556,14,0.585,5.5,265,135,126,0.509,522,0.508,23,0.531,5.6,2014-15,Regular%20Season
204020,Tyler Johnson,1610612748,MIA,26,12,14,550.0,13,12,2,0.923,56,0.232,2,0.241,7.1,67,18,49,0.269,125,0.536,9,0.578,9.2,80,30,51,0.375,181,0.442,11,0.471,8.8,2014-15,Regular%20Season
203092,Tyler Zeller,1610612738,BOS,80,39,41,1710.0,146,103,43,0.705,398,0.367,11,0.377,5.6,318,135,185,0.425,593,0.536,57,0.593,5.1,464,238,228,0.513,991,0.468,68,0.503,5.3,2014-15,Regular%20Season
201936,Tyreke Evans,1610612740,NOP,79,43,36,2690.0,82,51,29,0.622,340,0.241,15,0.252,8.8,334,65,268,0.195,562,0.594,40,0.64,7.3,416,116,297,0.279,902,0.461,55,0.491,7.6,2014-15,Regular%20Season
2199,Tyson Chandler,1610612742,DAL,74,47,27,2284.0,294,209,78,0.711,549,0.536,9,0.544,5.3,570,205,356,0.36,956,0.596,71,0.644,4.2,864,414,434,0.479,1505,0.574,80,0.606,4.6,2014-15,Regular%20Season
2617,Udonis Haslem,1610612748,MIA,55,29,26,940.0,70,47,25,0.671,198,0.354,6,0.365,6.4,184,63,120,0.342,328,0.561,30,0.617,4.5,254,110,145,0.433,526,0.483,36,0.518,5.0,2014-15,Regular%20Season
203505,Vander Blue,1610612747,LAL,2,0,2,74.0,2,0,2,0.0,7,0.286,0,0.286,3.3,7,1,6,0.143,13,0.538,0,0.538,9.2,9,1,8,0.111,20,0.45,0,0.45,7.9,2014-15,Regular%20Season
201964,Victor Claver,1610612757,POR,7,4,3,70.0,3,3,0,1.0,4,0.75,0,0.75,5.6,17,12,5,0.706,25,0.68,2,0.739,5.2,20,15,5,0.75,29,0.69,2,0.741,5.2,2014-15,Regular%20Season
203506,Victor Oladipo,1610612753,ORL,72,22,50,2573.0,51,24,27,0.471,257,0.198,19,0.214,9.7,251,61,189,0.243,480,0.523,40,0.57,7.4,302,85,216,0.281,737,0.41,59,0.445,7.8,2014-15,Regular%20Season
1713,Vince Carter,1610612763,MEM,58,40,18,988.0,27,16,11,0.593,87,0.31,2,0.318,7.7,106,26,79,0.245,215,0.493,26,0.561,6.9,133,42,90,0.316,302,0.44,28,0.485,7.0,2014-15,Regular%20Season
201961,Wayne Ellington,1610612747,LAL,63,18,45,1637.0,30,11,19,0.367,119,0.252,1,0.254,14.6,179,29,150,0.162,295,0.607,22,0.656,8.2,209,40,169,0.191,414,0.505,23,0.535,9.2,2014-15,Regular%20Season
202325,Wesley Johnson,1610612747,LAL,75,20,55,2217.0,67,28,37,0.418,209,0.321,6,0.33,9.8,252,47,198,0.187,416,0.606,33,0.658,6.8,319,75,235,0.235,625,0.51,39,0.544,7.5,2014-15,Regular%20Season
202083,Wesley Matthews,1610612757,POR,59,40,19,1990.0,38,13,25,0.342,125,0.304,5,0.317,14.1,184,37,148,0.201,354,0.52,37,0.58,7.5,222,50,173,0.225,479,0.463,42,0.508,8.6,2014-15,Regular%20Season
203115,Will Barton,1610612743,DEN,46,22,24,884.0,26,14,12,0.538,104,0.25,1,0.252,13.1,136,22,114,0.162,209,0.651,18,0.712,5.8,162,36,126,0.222,313,0.518,19,0.551,7.0,2014-15,Regular%20Season
101198,Will Bynum,1610612764,WAS,2,1,1,40.0,2,0,2,0.0,3,0.667,0,0.667,19.8,4,0,4,0.0,5,0.8,0,0.8,8.4,6,0,6,0.0,8,0.75,0,0.75,12.2,2014-15,Regular%20Season
203805,Will Cherry,1610612761,TOR,4,4,0,37.0,1,1,0,1.0,2,0.5,0,0.5,3.8,4,1,3,0.25,11,0.364,1,0.4,10.8,5,2,3,0.4,13,0.385,1,0.417,9.4,2014-15,Regular%20Season
2584,Willie Green,1610612753,ORL,35,9,26,685.0,14,6,7,0.429,46,0.304,3,0.326,13.3,65,13,52,0.2,112,0.58,9,0.631,9.0,79,19,59,0.241,158,0.5,12,0.541,9.7,2014-15,Regular%20Season
201163,Wilson Chandler,1610612743,DEN,77,28,49,2438.0,96,63,26,0.656,283,0.339,4,0.344,6.2,379,98,281,0.259,624,0.607,53,0.664,5.3,475,161,307,0.339,907,0.524,57,0.559,5.5,2014-15,Regular%20Season
202333,Xavier Henry,1610612747,LAL,3,0,3,35.0,2,0,2,0.0,5,0.4,0,0.4,14.7,2,0,2,0.0,5,0.4,1,0.5,3.1,4,0,4,0.0,10,0.4,1,0.444,8.9,2014-15,Regular%20Season
203897,Zach LaVine,1610612750,MIN,66,11,55,1766.0,27,10,19,0.37,120,0.225,4,0.233,11.5,184,32,150,0.174,327,0.563,24,0.607,7.5,211,42,169,0.199,447,0.472,28,0.504,8.1,2014-15,Regular%20Season
2216,Zach Randolph,1610612763,MEM,71,51,20,2304.0,225,187,31,0.831,552,0.408,12,0.417,4.3,522,160,358,0.307,818,0.638,58,0.687,4.7,747,347,389,0.465,1370,0.545,70,0.575,4.5,2014-15,Regular%20Season
2585,Zaza Pachulia,1610612749,MIL,71,33,38,1688.0,190,129,55,0.679,430,0.442,19,0.462,5.6,296,111,183,0.375,525,0.564,59,0.635,4.5,486,240,238,0.494,955,0.509,78,0.554,4.9,2014-15,Regular%20Season
204054,Zoran Dragic,1610612748,MIA,5,3,2,52.0,5,2,3,0.4,14,0.357,1,0.385,13.5,3,1,2,0.333,5,0.6,0,0.6,7.7,8,3,5,0.375,19,0.421,1,0.444,11.4,2014-15,Regular%20Season
201166,Aaron Brooks,1610612741,CHI,9,4,5,104.0,3,0,3,0.0,12,0.25,0,0.25,18.4,15,3,12,0.2,21,0.714,1,0.75,10.1,18,3,15,0.167,33,0.545,1,0.563,11.5,2014-15,Playoffs
201143,Al Horford,1610612737,ATL,16,8,8,522.0,40,26,13,0.65,69,0.58,0,0.58,7.8,98,45,53,0.459,171,0.573,17,0.636,5.9,138,71,66,0.514,240,0.575,17,0.619,6.4,2014-15,Playoffs
202329,Al-Farouq Aminu,1610612742,DAL,5,1,4,150.0,14,7,7,0.5,23,0.609,1,0.636,7.0,22,6,15,0.273,34,0.647,2,0.688,7.5,36,13,22,0.361,57,0.632,3,0.667,7.3,2014-15,Playoffs
101187,Alan Anderson,1610612751,BKN,6,2,4,142.0,2,2,0,1.0,8,0.25,0,0.25,6.2,19,4,15,0.211,34,0.559,1,0.576,6.8,21,6,15,0.286,42,0.5,1,0.512,6.7,2014-15,Playoffs
201582,Alexis Ajinca,1610612740,NOP,1,0,1,4.0,0,0,0,0.0,1,0.0,0,0.0,0.0,1,1,0,1.0,2,0.5,0,0.5,3.7,1,1,0,1.0,3,0.333,0,0.333,3.7,2014-15,Playoffs
203459,Allen Crabbe,1610612757,POR,2,0,2,39.0,0,0,0,0.0,1,0.0,0,0.0,0.0,3,0,3,0.0,4,0.75,1,1.0,14.1,3,0,3,0.0,5,0.6,1,0.75,14.1,2014-15,Playoffs
202087,Alonzo Gee,1610612757,POR,1,0,1,3.0,0,0,0,0.0,0,0.0,0,0.0,0.0,1,0,1,0.0,1,1.0,0,1.0,4.9,1,0,1,0.0,1,1.0,0,1.0,4.9,2014-15,Playoffs
2405,Amar'e Stoudemire,1610612742,DAL,5,1,4,75.0,7,4,3,0.571,20,0.35,0,0.35,9.2,9,2,7,0.222,25,0.36,4,0.429,7.5,16,6,10,0.375,45,0.356,4,0.39,8.2,2014-15,Playoffs
101161,Amir Johnson,1610612761,TOR,4,0,4,112.0,7,5,2,0.714,26,0.269,1,0.28,9.7,21,10,11,0.476,43,0.488,2,0.512,4.4,28,15,13,0.536,69,0.406,3,0.424,5.7,2014-15,Playoffs
2738,Andre Iguodala,1610612744,GSW,20,16,4,598.0,14,2,12,0.143,44,0.318,1,0.326,13.5,74,10,68,0.135,112,0.661,4,0.685,8.3,88,12,80,0.136,156,0.564,5,0.583,9.1,2014-15,Playoffs
101106,Andrew Bogut,1610612744,GSW,18,14,4,414.0,40,30,11,0.75,66,0.606,0,0.606,5.9,103,39,61,0.379,167,0.617,10,0.656,3.9,143,69,72,0.483,233,0.614,10,0.641,4.5,2014-15,Playoffs
203076,Anthony Davis,1610612740,NOP,4,0,4,172.0,9,5,4,0.556,28,0.321,0,0.321,7.4,35,8,25,0.229,55,0.636,1,0.648,5.4,44,13,29,0.295,83,0.53,1,0.537,5.9,2014-15,Playoffs
203382,Aron Baynes,1610612759,SAS,3,2,1,39.0,3,3,0,1.0,13,0.231,1,0.25,2.5,7,3,4,0.429,17,0.412,3,0.5,2.5,10,6,4,0.6,30,0.333,4,0.385,2.5,2014-15,Playoffs
201167,Arron Afflalo,1610612757,POR,2,1,1,46.0,0,0,0,0.0,3,0.0,0,0.0,0.0,7,0,7,0.0,8,0.875,0,0.875,6.1,7,0,7,0.0,11,0.636,0,0.636,6.1,2014-15,Playoffs
203085,Austin Rivers,1610612746,LAC,11,5,6,196.0,6,3,2,0.5,21,0.286,0,0.286,6.7,18,2,16,0.111,35,0.514,1,0.529,7.0,24,5,18,0.208,56,0.429,1,0.436,6.9,2014-15,Playoffs
202340,Avery Bradley,1610612738,BOS,4,0,4,133.0,3,1,2,0.333,8,0.375,0,0.375,10.9,12,3,8,0.25,25,0.48,1,0.5,4.9,15,4,10,0.267,33,0.455,1,0.469,6.2,2014-15,Playoffs
2757,Beno Udrih,1610612763,MEM,8,5,3,154.0,4,1,3,0.25,14,0.286,2,0.333,10.6,16,4,11,0.25,30,0.533,3,0.593,7.4,20,5,14,0.25,44,0.455,5,0.513,8.0,2014-15,Playoffs
201933,Blake Griffin,1610612746,LAC,14,7,7,557.0,38,21,15,0.553,105,0.362,3,0.373,5.5,140,51,87,0.364,187,0.749,12,0.8,4.8,178,72,102,0.404,292,0.61,15,0.643,5.0,2014-15,Playoffs
202711,Bojan Bogdanovic,1610612751,BKN,6,2,4,206.0,3,0,3,0.0,11,0.273,0,0.273,21.1,20,3,17,0.15,34,0.588,4,0.667,6.9,23,3,20,0.13,45,0.511,4,0.561,8.7,2014-15,Playoffs
2564,Boris Diaw,1610612759,SAS,7,3,4,198.0,13,5,7,0.385,29,0.448,1,0.464,7.3,30,3,27,0.1,51,0.588,5,0.652,7.2,43,8,34,0.186,80,0.538,6,0.581,7.2,2014-15,Playoffs
203078,Bradley Beal,1610612764,WAS,10,6,4,418.0,14,7,7,0.5,46,0.304,4,0.333,10.7,41,5,36,0.122,71,0.577,2,0.594,7.6,55,12,43,0.218,117,0.47,6,0.495,8.4,2014-15,Playoffs
101138,Brandon Bass,1610612738,BOS,4,0,4,86.0,3,2,0,0.667,8,0.375,1,0.429,10.9,5,3,2,0.6,12,0.417,0,0.417,4.3,8,5,2,0.625,20,0.4,1,0.421,6.2,2014-15,Playoffs
201575,Brandon Rush,1610612744,GSW,2,2,0,6.0,1,1,0,1.0,4,0.25,0,0.25,2.0,2,0,2,0.0,3,0.667,1,1.0,8.8,3,1,2,0.333,7,0.429,1,0.5,6.5,2014-15,Playoffs
201572,Brook Lopez,1610612751,BKN,6,2,4,234.0,20,15,5,0.75,38,0.526,0,0.526,5.2,34,15,19,0.441,64,0.531,7,0.596,6.7,54,30,24,0.556,102,0.529,7,0.568,6.2,2014-15,Playoffs
203468,CJ McCollum,1610612757,POR,5,1,4,166.0,1,1,0,1.0,18,0.056,0,0.056,1.9,19,3,14,0.158,39,0.487,1,0.5,6.9,20,4,14,0.2,57,0.351,1,0.357,6.6,2014-15,Playoffs
202718,Chandler Parsons,1610612742,DAL,1,0,1,37.0,0,0,0,0.0,4,0.0,0,0.0,0.0,6,2,4,0.333,9,0.667,0,0.667,5.7,6,2,4,0.333,13,0.462,0,0.462,5.7,2014-15,Playoffs
101111,Charlie Villanueva,1610612742,DAL,4,1,3,42.0,4,3,0,0.75,6,0.667,0,0.667,5.5,9,2,8,0.222,16,0.563,1,0.6,4.2,13,5,8,0.385,22,0.591,1,0.619,4.5,2014-15,Playoffs
2549,Chris Kaman,1610612757,POR,3,0,3,37.0,5,3,2,0.6,9,0.556,0,0.556,4.3,9,2,7,0.222,14,0.643,2,0.75,3.9,14,5,9,0.357,23,0.609,2,0.667,4.1,2014-15,Playoffs
101108,Chris Paul,1610612746,LAC,12,6,6,445.0,7,2,5,0.286,31,0.226,0,0.226,11.0,46,7,42,0.152,84,0.548,4,0.575,9.8,53,9,47,0.17,115,0.461,4,0.477,9.9,2014-15,Playoffs
203991,Clint Capela,1610612745,HOU,16,9,7,123.0,13,8,5,0.615,30,0.433,0,0.433,9.1,29,13,16,0.448,49,0.592,4,0.644,3.9,42,21,21,0.5,79,0.532,4,0.56,5.5,2014-15,Playoffs
201147,Corey Brewer,1610612745,HOU,14,8,6,358.0,11,8,3,0.727,61,0.18,2,0.186,8.0,36,6,32,0.167,68,0.529,5,0.571,9.9,47,14,35,0.298,129,0.364,7,0.385,9.4,2014-15,Playoffs
202709,Cory Joseph,1610612759,SAS,1,0,1,12.0,0,0,0,0.0,2,0.0,0,0.0,0.0,1,0,1,0.0,1,1.0,0,1.0,13.7,1,0,1,0.0,3,0.333,0,0.333,13.7,2014-15,Playoffs
201584,Courtney Lee,1610612763,MEM,11,6,5,367.0,3,1,2,0.333,16,0.188,1,0.2,12.1,25,4,21,0.16,55,0.455,6,0.51,10.2,28,5,23,0.179,71,0.394,7,0.438,10.4,2014-15,Playoffs
2563,Dahntay Jones,1610612746,LAC,1,0,1,1.0,0,0,0,0.0,0,0.0,0,0.0,0.0,1,0,1,0.0,1,1.0,0,1.0,10.2,1,0,1,0.0,1,1.0,0,1.0,10.2,2014-15,Playoffs
203081,Damian Lillard,1610612757,POR,5,1,4,201.0,2,0,2,0.0,10,0.2,0,0.2,23.1,18,2,16,0.111,33,0.545,2,0.581,8.2,20,2,18,0.1,43,0.465,2,0.488,9.7,2014-15,Playoffs
201980,Danny Green,1610612759,SAS,6,3,3,178.0,7,2,6,0.286,11,0.636,0,0.636,11.8,15,1,14,0.067,41,0.366,7,0.441,6.0,22,3,20,0.136,52,0.423,7,0.489,8.0,2014-15,Playoffs
201967,Dante Cunningham,1610612740,NOP,4,0,4,75.0,4,2,1,0.5,4,1.0,0,1.0,4.2,14,3,12,0.214,30,0.467,2,0.5,6.1,18,5,13,0.278,34,0.529,2,0.563,5.8,2014-15,Playoffs
101135,David Lee,1610612744,GSW,11,8,3,105.0,11,3,9,0.273,33,0.333,1,0.344,6.9,23,9,13,0.391,36,0.639,4,0.719,4.3,34,12,22,0.353,69,0.493,5,0.531,5.2,2014-15,Playoffs
201599,DeAndre Jordan,1610612746,LAC,14,7,7,482.0,49,36,12,0.735,97,0.505,3,0.521,5.5,138,45,92,0.326,201,0.687,17,0.75,4.9,187,81,104,0.433,298,0.628,20,0.673,5.0,2014-15,Playoffs
201942,DeMar DeRozan,1610612761,TOR,4,0,4,159.0,5,2,2,0.4,16,0.313,0,0.313,11.4,20,3,17,0.15,22,0.909,1,0.952,5.7,25,5,19,0.2,38,0.658,1,0.676,6.6,2014-15,Playoffs
201960,DeMarre Carroll,1610612737,ATL,16,8,8,558.0,26,20,6,0.769,83,0.313,0,0.313,6.3,71,11,60,0.155,122,0.582,6,0.612,6.9,97,31,66,0.32,205,0.473,6,0.487,6.8,2014-15,Playoffs
203471,Dennis Schroder,1610612737,ATL,11,5,6,207.0,5,2,3,0.4,16,0.313,1,0.333,21.0,24,0,24,0.0,49,0.49,2,0.511,8.6,29,2,27,0.069,65,0.446,3,0.468,10.7,2014-15,Playoffs
101114,Deron Williams,1610612751,BKN,6,2,4,192.0,3,2,1,0.667,15,0.2,2,0.231,5.9,34,3,31,0.088,53,0.642,5,0.708,8.3,37,5,32,0.135,68,0.544,7,0.607,8.1,2014-15,Playoffs
201565,Derrick Rose,1610612741,CHI,11,5,6,427.0,13,3,10,0.231,49,0.265,1,0.271,14.5,45,4,39,0.089,81,0.556,5,0.592,9.8,58,7,49,0.121,130,0.446,6,0.468,10.8,2014-15,Playoffs
2734,Devin Harris,1610612742,DAL,4,1,3,74.0,1,0,1,0.0,9,0.111,1,0.125,20.8,7,2,5,0.286,13,0.538,2,0.636,9.8,8,2,6,0.25,22,0.364,3,0.421,11.2,2014-15,Playoffs
1717,Dirk Nowitzki,1610612742,DAL,5,1,4,181.0,4,4,0,1.0,12,0.333,1,0.364,5.9,48,18,30,0.375,70,0.686,6,0.75,3.7,52,22,30,0.423,82,0.634,7,0.693,3.9,2014-15,Playoffs
203926,Doug McDermott,1610612741,CHI,2,1,1,8.0,1,0,1,0.0,1,1.0,0,1.0,23.2,1,0,1,0.0,1,1.0,0,1.0,4.3,2,0,2,0.0,2,1.0,0,1.0,13.7,2014-15,Playoffs
203110,Draymond Green,1610612744,GSW,20,16,4,740.0,44,27,15,0.614,101,0.436,6,0.463,8.0,158,78,76,0.494,259,0.61,18,0.656,4.6,202,105,91,0.52,360,0.561,24,0.601,5.3,2014-15,Playoffs
2400,Drew Gooden,1610612764,WAS,10,6,4,178.0,13,6,4,0.462,27,0.481,0,0.481,6.4,42,15,27,0.357,62,0.677,3,0.712,4.7,55,21,31,0.382,89,0.618,3,0.64,5.0,2014-15,Playoffs
2730,Dwight Howard,1610612745,HOU,17,9,8,574.0,62,47,13,0.758,139,0.446,2,0.453,5.0,176,51,119,0.29,258,0.682,21,0.743,3.8,238,98,132,0.412,397,0.599,23,0.636,4.1,2014-15,Playoffs
203939,Dwight Powell,1610612742,DAL,1,0,1,2.0,0,0,0,0.0,0,0.0,0,0.0,0.0,1,0,1,0.0,1,1.0,0,1.0,3.9,1,0,1,0.0,1,1.0,0,1.0,3.9,2014-15,Playoffs
202734,E'Twaun Moore,1610612741,CHI,1,1,0,4.0,0,0,0,0.0,0,0.0,0,0.0,0.0,3,0,3,0.0,4,0.75,0,0.75,13.7,3,0,3,0.0,4,0.75,0,0.75,13.7,2014-15,Playoffs
201947,Earl Clark,1610612751,BKN,2,0,2,13.0,0,0,0,0.0,1,0.0,0,0.0,0.0,2,1,1,0.5,4,0.5,0,0.5,4.1,2,1,1,0.5,5,0.4,0,0.4,4.1,2014-15,Playoffs
202327,Ekpe Udoh,1610612746,LAC,2,2,0,7.0,0,0,0,0.0,0,0.0,0,0.0,0.0,3,1,2,0.333,1,3.0,0,3.0,5.6,3,1,2,0.333,1,3.0,0,3.0,5.6,2014-15,Playoffs
1882,Elton Brand,1610612737,ATL,1,1,0,4.0,0,0,0,0.0,0,0.0,0,0.0,0.0,1,1,0,1.0,2,0.5,0,0.5,3.2,1,1,0,1.0,2,0.5,0,0.5,3.2,2014-15,Playoffs
201569,Eric Gordon,1610612740,NOP,3,0,3,105.0,2,2,0,1.0,6,0.333,0,0.333,12.6,7,1,6,0.143,11,0.636,0,0.636,9.4,9,3,6,0.333,17,0.529,0,0.529,10.1,2014-15,Playoffs
101141,Ersan Ilyasova,1610612749,MIL,6,2,4,142.0,6,4,3,0.667,21,0.286,1,0.3,6.3,17,6,11,0.353,39,0.436,4,0.486,4.9,23,10,14,0.435,60,0.383,5,0.418,5.4,2014-15,Playoffs
202323,Evan Turner,1610612738,BOS,4,0,4,118.0,2,2,0,1.0,13,0.154,0,0.154,2.7,27,4,23,0.148,37,0.73,2,0.771,5.8,29,6,23,0.207,50,0.58,2,0.604,5.6,2014-15,Playoffs
203105,Festus Ezeli,1610612744,GSW,16,13,3,167.0,24,18,6,0.75,56,0.429,3,0.453,5.5,38,19,17,0.5,66,0.576,9,0.667,4.4,62,37,23,0.597,122,0.508,12,0.564,4.8,2014-15,Playoffs
202066,Garrett Temple,1610612764,WAS,3,1,2,22.0,1,0,1,0.0,4,0.25,0,0.25,5.1,2,0,2,0.0,3,0.667,0,0.667,12.9,3,0,3,0.0,7,0.429,0,0.429,10.3,2014-15,Playoffs
2222,Gerald Wallace,1610612738,BOS,1,0,1,4.0,0,0,0,0.0,2,0.0,0,0.0,0.0,1,0,1,0.0,2,0.5,0,0.5,2.3,1,0,1,0.0,4,0.25,0,0.25,2.3,2014-15,Playoffs
203507,Giannis Antetokounmpo,1610612749,MIL,6,2,4,201.0,12,10,2,0.833,39,0.308,2,0.324,4.9,30,9,21,0.3,49,0.612,4,0.667,6.5,42,19,23,0.452,88,0.477,6,0.512,6.1,2014-15,Playoffs
203540,Gigi Datome,1610612738,BOS,1,0,1,4.0,0,0,0,0.0,0,0.0,0,0.0,0.0,1,0,1,0.0,1,1.0,0,1.0,6.6,1,0,1,0.0,1,1.0,0,1.0,6.6,2014-15,Playoffs
201175,Glen Davis,1610612746,LAC,10,4,6,104.0,9,7,2,0.778,24,0.375,1,0.391,3.5,18,13,5,0.722,37,0.486,3,0.529,3.9,27,20,7,0.741,61,0.443,4,0.474,3.8,2014-15,Playoffs
202349,Greivis Vasquez,1610612761,TOR,4,0,4,101.0,0,0,0,0.0,6,0.0,1,0.0,0.0,7,0,7,0.0,20,0.35,2,0.389,11.0,7,0,7,0.0,26,0.269,3,0.304,11.0,2014-15,Playoffs
203084,Harrison Barnes,1610612744,GSW,19,15,4,607.0,40,19,18,0.475,98,0.408,4,0.426,8.6,63,18,45,0.286,121,0.521,5,0.543,6.4,103,37,63,0.359,219,0.47,9,0.49,7.2,2014-15,Playoffs
2045,Hedo Turkoglu,1610612746,LAC,5,3,2,28.0,1,0,1,0.0,2,0.5,0,0.5,20.0,6,3,3,0.5,6,1.0,0,1.0,6.1,7,3,4,0.429,8,0.875,0,0.875,8.1,2014-15,Playoffs
202697,Iman Shumpert,1610612739,CLE,19,13,6,659.0,23,4,18,0.174,63,0.365,4,0.39,14.4,72,12,61,0.167,113,0.637,4,0.661,7.7,95,16,79,0.168,176,0.54,8,0.565,9.2,2014-15,Playoffs
202738,Isaiah Thomas,1610612738,BOS,3,0,3,89.0,0,0,0,0.0,8,0.0,2,0.0,0.0,11,2,10,0.182,17,0.647,0,0.647,11.2,11,2,10,0.182,25,0.44,2,0.478,11.2,2014-15,Playoffs
200826,J.J. Barea,1610612742,DAL,5,1,4,154.0,5,0,5,0.0,19,0.263,1,0.278,19.8,19,2,17,0.105,32,0.594,4,0.679,8.9,24,2,22,0.083,51,0.471,5,0.522,11.2,2014-15,Playoffs
200755,JJ Redick,1610612746,LAC,13,6,7,501.0,0,0,0,0.0,16,0.0,0,0.0,0.0,30,6,24,0.2,56,0.536,8,0.625,11.3,30,6,24,0.2,72,0.417,8,0.469,11.3,2014-15,Playoffs
2747,JR Smith,1610612739,CLE,16,11,5,506.0,9,1,8,0.111,40,0.225,1,0.231,13.8,72,14,58,0.194,107,0.673,4,0.699,7.3,81,15,66,0.185,147,0.551,5,0.57,8.0,2014-15,Playoffs
203210,JaMychal Green,1610612763,MEM,3,0,3,7.0,0,0,0,0.0,0,0.0,0,0.0,0.0,3,0,3,0.0,3,1.0,1,1.5,5.1,3,0,3,0.0,3,1.0,1,1.5,5.1,2014-15,Playoffs
203109,Jae Crowder,1610612738,BOS,4,0,4,100.0,8,7,1,0.875,12,0.667,0,0.667,5.6,12,2,8,0.167,16,0.75,0,0.75,7.5,20,9,9,0.45,28,0.714,0,0.714,6.7,2014-15,Playoffs
2037,Jamal Crawford,1610612746,LAC,10,6,4,275.0,6,1,4,0.167,11,0.545,0,0.545,19.9,24,5,18,0.208,34,0.706,4,0.8,9.7,30,6,22,0.2,45,0.667,4,0.732,11.5,2014-15,Playoffs
201935,James Harden,1610612745,HOU,17,9,8,636.0,12,8,4,0.667,52,0.231,0,0.231,10.4,85,11,73,0.129,118,0.72,11,0.794,7.9,97,19,77,0.196,170,0.571,11,0.61,8.2,2014-15,Playoffs
201949,James Johnson,1610612761,TOR,1,0,1,5.0,0,0,0,0.0,0,0.0,0,0.0,0.0,2,0,2,0.0,2,1.0,0,1.0,6.2,2,0,2,0.0,2,1.0,0,1.0,6.2,2014-15,Playoffs
2592,James Jones,1610612739,CLE,15,9,6,254.0,1,0,1,0.0,10,0.1,1,0.111,15.4,26,9,18,0.346,78,0.333,7,0.366,6.2,27,9,19,0.333,88,0.307,8,0.338,6.6,2014-15,Playoffs
203949,James Michael McAdoo,1610612744,GSW,4,4,0,8.0,1,1,0,1.0,2,0.5,0,0.5,20.0,3,1,2,0.333,1,3.0,0,3.0,8.3,4,2,2,0.5,3,1.333,0,1.333,11.2,2014-15,Playoffs
201162,Jared Dudley,1610612749,MIL,5,2,3,90.0,3,1,2,0.333,11,0.273,0,0.273,5.7,8,3,5,0.375,32,0.25,4,0.286,7.4,11,4,7,0.364,43,0.256,4,0.282,7.0,2014-15,Playoffs
203096,Jared Sullinger,1610612738,BOS,4,0,4,80.0,9,8,0,0.889,14,0.643,0,0.643,3.9,19,11,7,0.579,35,0.543,2,0.576,3.8,28,19,7,0.679,49,0.571,2,0.596,3.8,2014-15,Playoffs
101127,Jarrett Jack,1610612751,BKN,6,2,4,153.0,2,0,2,0.0,11,0.182,1,0.2,19.7,23,2,21,0.087,36,0.639,4,0.719,8.2,25,2,23,0.08,47,0.532,5,0.595,9.2,2014-15,Playoffs
1891,Jason Terry,1610612745,HOU,14,8,6,408.0,6,2,5,0.333,22,0.273,0,0.273,15.1,32,4,32,0.125,52,0.615,3,0.653,12.1,38,6,37,0.158,74,0.514,3,0.535,13.3,2014-15,Playoffs
201965,Jeff Ayres,1610612759,SAS,1,1,0,8.0,0,0,0,0.0,1,0.0,0,0.0,0.0,3,1,2,0.333,5,0.6,0,0.6,1.9,3,1,2,0.333,6,0.5,0,0.5,1.9,2014-15,Playoffs
201145,Jeff Green,1610612763,MEM,11,6,5,298.0,9,3,6,0.333,32,0.281,0,0.281,8.4,43,13,32,0.302,58,0.741,5,0.811,7.1,52,16,38,0.308,90,0.578,5,0.612,7.2,2014-15,Playoffs
201952,Jeff Teague,1610612737,ATL,16,8,8,529.0,10,6,4,0.6,39,0.256,2,0.27,7.3,41,2,40,0.049,68,0.603,4,0.641,10.5,51,8,44,0.157,107,0.477,6,0.505,9.9,2014-15,Playoffs
202366,Jerome Jordan,1610612751,BKN,1,0,1,5.0,1,1,0,1.0,1,1.0,0,1.0,6.1,1,1,0,1.0,1,1.0,0,1.0,13.6,2,2,0,1.0,2,1.0,0,1.0,9.9,2014-15,Playoffs
201573,Jerryd Bayless,1610612749,MIL,6,2,4,120.0,4,0,4,0.0,13,0.308,1,0.333,19.5,11,1,10,0.091,17,0.647,2,0.733,9.6,15,1,14,0.067,30,0.5,3,0.556,12.2,2014-15,Playoffs
202710,Jimmy Butler,1610612741,CHI,12,6,6,506.0,18,8,10,0.444,52,0.346,1,0.353,12.7,49,16,33,0.327,96,0.51,6,0.544,6.0,67,24,43,0.358,148,0.453,7,0.475,7.8,2014-15,Playoffs
201149,Joakim Noah,1610612741,CHI,12,6,6,395.0,45,37,8,0.822,113,0.398,4,0.413,4.4,87,33,53,0.379,163,0.534,13,0.58,4.2,132,70,61,0.53,276,0.478,17,0.51,4.2,2014-15,Playoffs
203925,Joe Harris,1610612739,CLE,1,1,0,6.0,0,0,0,0.0,0,0.0,0,0.0,0.0,1,0,1,0.0,1,1.0,0,1.0,7.6,1,0,1,0.0,1,1.0,0,1.0,7.6,2014-15,Playoffs
2207,Joe Johnson,1610612751,BKN,6,2,4,249.0,5,5,0,1.0,16,0.313,0,0.313,5.5,41,13,28,0.317,65,0.631,6,0.695,6.8,46,18,28,0.391,81,0.568,6,0.613,6.7,2014-15,Playoffs
200777,Joel Freeland,1610612757,POR,1,0,1,4.0,0,0,0,0.0,0,0.0,0,0.0,0.0,1,1,0,1.0,2,0.5,1,1.0,4.7,1,1,0,1.0,2,0.5,1,1.0,4.7,2014-15,Playoffs
201595,Joey Dorsey,1610612745,HOU,2,0,2,9.0,1,1,0,1.0,2,0.5,0,0.5,2.7,3,0,3,0.0,4,0.75,0,0.75,3.6,4,1,3,0.25,6,0.667,0,0.667,3.4,2014-15,Playoffs
203089,John Henson,1610612749,MIL,6,2,4,152.0,21,15,5,0.714,31,0.677,0,0.677,6.0,27,10,16,0.37,46,0.587,4,0.643,5.2,48,25,21,0.521,77,0.623,4,0.658,5.5,2014-15,Playoffs
203098,John Jenkins,1610612737,ATL,2,0,2,17.0,1,0,1,0.0,1,1.0,0,1.0,19.8,2,0,2,0.0,5,0.4,0,0.4,7.0,3,0,3,0.0,6,0.5,0,0.5,11.3,2014-15,Playoffs
202322,John Wall,1610612764,WAS,7,5,2,273.0,5,3,3,0.6,19,0.263,1,0.278,17.8,28,4,24,0.143,57,0.491,4,0.528,8.1,33,7,27,0.212,76,0.434,5,0.465,9.8,2014-15,Playoffs
203948,Johnny O'Bryant III,1610612749,MIL,1,0,1,12.0,1,0,1,0.0,2,0.5,0,0.5,6.8,2,0,2,0.0,3,0.667,0,0.667,2.1,3,0,3,0.0,5,0.6,0,0.6,3.7,2014-15,Playoffs
202720,Jon Leuer,1610612763,MEM,3,1,2,7.0,2,2,0,1.0,4,0.5,0,0.5,2.8,3,1,2,0.333,4,0.75,0,0.75,5.0,5,3,2,0.6,8,0.625,0,0.625,4.1,2014-15,Playoffs
201973,Jonas Jerebko,1610612738,BOS,4,0,4,68.0,4,3,1,0.75,12,0.333,0,0.333,3.1,10,1,9,0.1,17,0.588,2,0.667,4.2,14,4,10,0.286,29,0.483,2,0.519,3.9,2014-15,Playoffs
202685,Jonas Valanciunas,1610612761,TOR,4,0,4,106.0,9,6,3,0.667,28,0.321,1,0.333,6.1,28,11,16,0.393,33,0.848,2,0.903,3.3,37,17,19,0.459,61,0.607,3,0.638,4.0,2014-15,Playoffs
203919,Jordan Adams,1610612763,MEM,1,0,1,6.0,0,0,0,0.0,0,0.0,0,0.0,0.0,1,0,1,0.0,1,1.0,0,1.0,6.7,1,0,1,0.0,1,1.0,0,1.0,6.7,2014-15,Playoffs
203268,Jorge Gutierrez,1610612749,MIL,1,0,1,12.0,0,0,0,0.0,1,0.0,0,0.0,0.0,1,0,1,0.0,1,1.0,0,1.0,19.8,1,0,1,0.0,2,0.5,0,0.5,19.8,2014-15,Playoffs
2746,Josh Smith,1610612745,HOU,17,9,8,396.0,26,13,13,0.5,64,0.406,0,0.406,8.7,70,13,58,0.186,121,0.579,11,0.636,6.5,96,26,71,0.271,185,0.519,11,0.552,7.1,2014-15,Playoffs
201950,Jrue Holiday,1610612740,NOP,2,0,2,38.0,2,1,1,0.5,3,0.667,0,0.667,16.9,1,1,0,1.0,6,0.167,0,0.167,2.5,3,2,1,0.667,9,0.333,0,0.333,12.1,2014-15,Playoffs
203200,Justin Holiday,1610612744,GSW,1,1,0,4.0,0,0,0,0.0,1,0.0,0,0.0,0.0,1,0,1,0.0,1,1.0,0,1.0,3.3,1,0,1,0.0,2,0.5,0,0.5,3.3,2014-15,Playoffs
202695,Kawhi Leonard,1610612759,SAS,7,3,4,250.0,13,6,6,0.462,29,0.448,3,0.5,8.5,39,5,33,0.128,54,0.722,2,0.75,6.2,52,11,39,0.212,83,0.627,5,0.667,6.7,2014-15,Playoffs
203482,Kelly Olynyk,1610612738,BOS,3,0,3,51.0,2,1,1,0.5,6,0.333,0,0.333,3.6,3,2,2,0.667,10,0.3,0,0.3,26.8,5,3,3,0.6,16,0.313,0,0.313,19.1,2014-15,Playoffs
2570,Kendrick Perkins,1610612739,CLE,6,5,1,29.0,2,2,0,1.0,5,0.4,0,0.4,3.4,7,2,5,0.286,12,0.583,0,0.583,3.2,9,4,5,0.444,17,0.529,0,0.529,3.3,2014-15,Playoffs
203145,Kent Bazemore,1610612737,ATL,14,7,7,268.0,3,2,1,0.667,21,0.143,1,0.15,12.3,50,10,40,0.2,75,0.667,10,0.769,5.8,53,12,41,0.226,96,0.552,11,0.624,6.1,2014-15,Playoffs
201567,Kevin Love,1610612739,CLE,4,4,0,107.0,6,4,3,0.667,17,0.353,2,0.4,10.9,22,4,18,0.182,34,0.647,5,0.759,4.7,28,8,21,0.286,51,0.549,7,0.636,6.2,2014-15,Playoffs
202338,Kevin Seraphin,1610612764,WAS,5,3,2,66.0,3,0,3,0.0,11,0.273,0,0.273,8.6,15,4,11,0.267,23,0.652,2,0.714,4.8,18,4,14,0.222,34,0.529,2,0.563,5.4,2014-15,Playoffs
203114,Khris Middleton,1610612749,MIL,6,2,4,232.0,7,3,4,0.429,18,0.389,1,0.412,14.4,15,3,12,0.2,33,0.455,3,0.5,7.4,22,6,16,0.273,51,0.431,4,0.468,9.6,2014-15,Playoffs
2550,Kirk Hinrich,1610612741,CHI,3,2,1,53.0,0,0,0,0.0,1,0.0,0,0.0,0.0,5,1,4,0.2,7,0.714,1,0.833,8.2,5,1,4,0.2,8,0.625,1,0.714,8.2,2014-15,Playoffs
202691,Klay Thompson,1610612744,GSW,20,16,4,715.0,9,2,7,0.222,49,0.184,1,0.188,17.0,67,19,47,0.284,119,0.563,7,0.598,7.9,76,21,54,0.276,168,0.452,8,0.475,9.0,2014-15,Playoffs
201585,Kosta Koufos,1610612763,MEM,11,6,5,127.0,19,14,5,0.737,40,0.475,2,0.5,5.9,20,6,14,0.3,34,0.588,2,0.625,4.6,39,20,19,0.513,74,0.527,4,0.557,5.2,2014-15,Playoffs
203123,Kostas Papanikolaou,1610612745,HOU,2,1,1,11.0,0,0,0,0.0,0,0.0,0,0.0,0.0,2,0,2,0.0,3,0.667,0,0.667,5.0,2,0,2,0.0,3,0.667,0,0.667,5.0,2014-15,Playoffs
2743,Kris Humphries,1610612764,WAS,1,1,0,5.0,0,0,0,0.0,0,0.0,0,0.0,0.0,3,0,2,0.0,3,1.0,0,1.0,3.4,3,0,2,0.0,3,1.0,0,1.0,3.4,2014-15,Playoffs
2594,Kyle Korver,1610612737,ATL,14,8,6,526.0,1,0,1,0.0,22,0.045,0,0.045,23.8,69,24,42,0.348,129,0.535,15,0.605,5.6,70,24,43,0.343,151,0.464,15,0.515,5.9,2014-15,Playoffs
200768,Kyle Lowry,1610612761,TOR,4,0,4,131.0,7,3,4,0.429,28,0.25,1,0.259,7.7,15,1,14,0.067,26,0.577,3,0.652,10.0,22,4,18,0.182,54,0.407,4,0.44,9.3,2014-15,Playoffs
202681,Kyrie Irving,1610612739,CLE,12,9,3,430.0,10,5,5,0.5,43,0.233,6,0.27,12.0,37,7,31,0.189,84,0.44,5,0.468,9.1,47,12,36,0.255,127,0.37,11,0.405,9.7,2014-15,Playoffs
200746,LaMarcus Aldridge,1610612757,POR,5,1,4,208.0,21,15,5,0.714,37,0.568,1,0.583,4.2,35,11,24,0.314,57,0.614,6,0.686,5.0,56,26,29,0.464,94,0.596,7,0.644,4.7,2014-15,Playoffs
2544,LeBron James,1610612739,CLE,19,13,6,794.0,33,21,9,0.636,114,0.289,5,0.303,9.1,177,49,129,0.277,233,0.76,9,0.79,6.0,210,70,138,0.333,347,0.605,14,0.631,6.5,2014-15,Playoffs
2571,Leandro Barbosa,1610612744,GSW,13,10,3,152.0,7,3,3,0.429,23,0.304,0,0.304,10.8,19,1,18,0.053,29,0.655,0,0.655,11.4,26,4,21,0.154,52,0.5,0,0.5,11.2,2014-15,Playoffs
201991,Lester Hudson,1610612746,LAC,1,0,1,8.0,0,0,0,0.0,0,0.0,0,0.0,0.0,1,0,1,0.0,1,1.0,0,1.0,6.9,1,0,1,0.0,1,1.0,0,1.0,6.9,2014-15,Playoffs
101150,Lou Williams,1610612761,TOR,4,0,4,102.0,2,2,0,1.0,6,0.333,0,0.333,4.3,5,0,5,0.0,11,0.455,1,0.5,13.3,7,2,5,0.286,17,0.412,1,0.438,10.8,2014-15,Playoffs
1938,Manu Ginobili,1610612759,SAS,7,3,4,131.0,4,2,3,0.5,13,0.308,0,0.308,14.1,20,2,18,0.1,25,0.8,0,0.8,7.7,24,4,21,0.167,38,0.632,0,0.632,9.0,2014-15,Playoffs
201188,Marc Gasol,1610612763,MEM,11,6,5,416.0,19,10,8,0.526,51,0.373,2,0.388,7.8,94,28,65,0.298,141,0.667,11,0.723,4.6,113,38,73,0.336,192,0.589,13,0.631,5.1,2014-15,Playoffs
101162,Marcin Gortat,1610612764,WAS,10,6,4,307.0,27,18,7,0.667,58,0.466,0,0.466,5.9,61,22,39,0.361,128,0.477,8,0.508,4.5,88,40,46,0.455,186,0.473,8,0.494,4.9,2014-15,Playoffs
201158,Marco Belinelli,1610612759,SAS,7,3,4,116.0,2,0,2,0.0,3,0.667,0,0.667,16.9,11,2,10,0.182,21,0.524,3,0.611,6.4,13,2,12,0.154,24,0.542,3,0.619,7.9,2014-15,Playoffs
203935,Marcus Smart,1610612738,BOS,4,0,4,90.0,5,3,2,0.6,6,0.833,0,0.833,5.0,6,2,4,0.333,12,0.5,1,0.545,6.5,11,5,6,0.455,18,0.611,1,0.647,5.8,2014-15,Playoffs
203900,Markel Brown,1610612751,BKN,2,0,2,10.0,2,2,0,1.0,2,1.0,0,1.0,2.3,0,0,0,0.0,1,0.0,0,0.0,0.0,2,2,0,1.0,3,0.667,0,0.667,2.3,2014-15,Playoffs
201578,Marreese Speights,1610612744,GSW,8,6,2,61.0,8,5,4,0.625,20,0.4,0,0.4,6.0,13,2,9,0.154,17,0.765,3,0.929,3.7,21,7,13,0.333,37,0.568,3,0.618,4.7,2014-15,Playoffs
203486,Mason Plumlee,1610612751,BKN,3,1,2,30.0,2,2,0,1.0,4,0.5,0,0.5,3.1,6,1,5,0.167,13,0.462,4,0.667,6.2,8,3,5,0.375,17,0.471,4,0.615,5.5,2014-15,Playoffs
2440,Matt Barnes,1610612746,LAC,13,7,6,389.0,16,7,9,0.438,35,0.457,2,0.485,8.5,55,8,47,0.145,98,0.561,8,0.611,6.6,71,15,56,0.211,133,0.534,10,0.577,7.0,2014-15,Playoffs
2588,Matt Bonner,1610612759,SAS,4,3,1,29.0,0,0,0,0.0,2,0.0,0,0.0,0.0,6,0,6,0.0,7,0.857,1,1.0,5.6,6,0,6,0.0,9,0.667,1,0.75,5.6,2014-15,Playoffs
203521,Matthew Dellavedova,1610612739,CLE,15,10,5,377.0,9,5,4,0.556,24,0.375,1,0.391,12.9,27,5,22,0.185,55,0.491,4,0.529,10.6,36,10,26,0.278,79,0.456,5,0.486,11.2,2014-15,Playoffs
203086,Meyers Leonard,1610612757,POR,4,1,3,101.0,6,3,3,0.5,10,0.6,0,0.6,7.2,27,5,20,0.185,45,0.6,5,0.675,5.9,33,8,23,0.242,55,0.6,5,0.66,6.2,2014-15,Playoffs
203487,Michael Carter-Williams,1610612749,MIL,6,2,4,191.0,1,1,0,1.0,13,0.077,2,0.091,2.8,26,6,20,0.231,39,0.667,0,0.667,7.8,27,7,20,0.259,52,0.519,2,0.54,7.6,2014-15,Playoffs
201144,Mike Conley,1610612763,MEM,6,4,2,178.0,0,0,0,0.0,7,0.0,1,0.0,0.0,9,1,11,0.111,24,0.375,2,0.409,10.3,9,1,11,0.111,31,0.29,3,0.321,10.3,2014-15,Playoffs
2399,Mike Dunleavy,1610612741,CHI,11,6,5,368.0,7,2,5,0.286,31,0.226,1,0.233,18.3,41,14,29,0.341,77,0.532,4,0.562,7.7,48,16,34,0.333,108,0.444,5,0.466,9.2,2014-15,Playoffs
2034,Mike Miller,1610612739,CLE,2,1,1,29.0,0,0,0,0.0,1,0.0,0,0.0,0.0,9,1,8,0.111,13,0.692,2,0.818,5.9,9,1,8,0.111,14,0.643,2,0.75,5.9,2014-15,Playoffs
203488,Mike Muscala,1610612737,ATL,8,5,3,87.0,8,6,2,0.75,17,0.471,0,0.471,8.7,10,4,6,0.4,26,0.385,4,0.455,3.4,18,10,8,0.556,43,0.419,4,0.462,5.8,2014-15,Playoffs
203118,Mike Scott,1610612737,ATL,10,3,7,169.0,16,8,8,0.5,29,0.552,1,0.571,5.5,30,5,25,0.167,41,0.732,1,0.75,7.4,46,13,33,0.283,70,0.657,2,0.676,6.7,2014-15,Playoffs
203101,Miles Plumlee,1610612749,MIL,1,0,1,16.0,3,3,0,1.0,8,0.375,0,0.375,3.1,3,0,3,0.0,7,0.429,0,0.429,2.8,6,3,3,0.5,15,0.4,0,0.4,3.0,2014-15,Playoffs
203141,Mirza Teletovic,1610612751,BKN,3,1,2,16.0,0,0,0,0.0,0,0.0,0,0.0,0.0,4,1,3,0.25,6,0.667,0,0.667,6.0,4,1,3,0.25,6,0.667,0,0.667,6.0,2014-15,Playoffs
101145,Monta Ellis,1610612742,DAL,4,1,3,158.0,4,1,3,0.25,10,0.4,0,0.4,13.7,12,1,11,0.083,20,0.6,3,0.706,7.9,16,2,14,0.125,30,0.533,3,0.593,9.4,2014-15,Playoffs
1737,Nazr Mohammed,1610612741,CHI,3,1,2,14.0,3,3,0,1.0,5,0.6,0,0.6,2.1,2,0,2,0.0,10,0.2,4,0.333,7.1,5,3,2,0.6,15,0.333,4,0.455,4.1,2014-15,Playoffs
2403,Nene,1610612764,WAS,10,6,4,257.0,25,14,10,0.56,54,0.463,1,0.472,7.4,41,20,21,0.488,89,0.461,12,0.532,6.6,66,34,31,0.515,143,0.462,13,0.508,6.9,2014-15,Playoffs
201979,Nick Calathes,1610612763,MEM,7,2,5,122.0,1,0,1,0.0,12,0.083,0,0.083,13.1,15,3,13,0.2,24,0.625,1,0.652,8.8,16,3,14,0.188,36,0.444,1,0.457,9.1,2014-15,Playoffs
203910,Nick Johnson,1610612745,HOU,3,1,2,25.0,1,0,1,0.0,5,0.2,1,0.25,1.9,3,0,3,0.0,3,1.0,0,1.0,13.1,4,0,4,0.0,8,0.5,1,0.571,10.3,2014-15,Playoffs
201587,Nicolas Batum,1610612757,POR,5,1,4,209.0,6,2,4,0.333,21,0.286,0,0.286,11.2,37,8,30,0.216,57,0.649,5,0.712,4.7,43,10,34,0.233,78,0.551,5,0.589,5.6,2014-15,Playoffs
202703,Nikola Mirotic,1610612741,CHI,10,4,6,161.0,7,5,3,0.714,26,0.269,0,0.269,5.7,23,7,17,0.304,48,0.479,3,0.511,4.4,30,12,20,0.4,74,0.405,3,0.423,4.8,2014-15,Playoffs
202708,Norris Cole,1610612740,NOP,3,0,3,87.0,1,1,0,1.0,4,0.25,0,0.25,2.3,6,0,6,0.0,11,0.545,1,0.6,12.6,7,1,6,0.143,15,0.467,1,0.5,11.1,2014-15,Playoffs
201564,O.J. Mayo,1610612749,MIL,6,2,4,156.0,1,0,1,0.0,13,0.077,1,0.083,21.5,19,7,12,0.368,33,0.576,2,0.613,9.1,20,7,13,0.35,46,0.435,3,0.465,9.8,2014-15,Playoffs
201600,Omer Asik,1610612740,NOP,4,0,4,79.0,12,8,4,0.667,25,0.48,0,0.48,5.2,17,4,13,0.235,24,0.708,3,0.81,3.5,29,12,17,0.414,49,0.592,3,0.63,4.3,2014-15,Playoffs
203490,Otto Porter Jr.,1610612764,WAS,10,6,4,331.0,24,14,10,0.583,72,0.333,2,0.343,7.6,56,14,41,0.25,84,0.667,2,0.683,6.9,80,28,51,0.35,156,0.513,4,0.526,7.1,2014-15,Playoffs
203143,Pablo Prigioni,1610612745,HOU,11,6,5,213.0,6,1,5,0.167,24,0.25,1,0.261,11.8,13,3,11,0.231,36,0.361,3,0.394,9.3,19,4,16,0.211,60,0.317,4,0.339,10.1,2014-15,Playoffs
202335,Patrick Patterson,1610612761,TOR,4,0,4,106.0,4,3,1,0.75,11,0.364,0,0.364,8.6,10,5,5,0.5,31,0.323,3,0.357,4.0,14,8,6,0.571,42,0.333,3,0.359,5.3,2014-15,Playoffs
201988,Patty Mills,1610612759,SAS,7,3,4,112.0,4,2,2,0.5,9,0.444,1,0.5,13.4,15,3,10,0.2,20,0.75,0,0.75,10.8,19,5,12,0.263,29,0.655,1,0.679,11.4,2014-15,Playoffs
2200,Pau Gasol,1610612741,CHI,10,6,4,317.0,17,13,4,0.765,45,0.378,1,0.386,5.0,77,41,35,0.532,127,0.606,8,0.647,4.0,94,54,39,0.574,172,0.547,9,0.577,4.2,2014-15,Playoffs
200794,Paul Millsap,1610612737,ATL,16,8,8,566.0,36,22,13,0.611,99,0.364,1,0.367,6.2,103,41,62,0.398,187,0.551,22,0.624,5.0,139,63,75,0.453,286,0.486,23,0.529,5.3,2014-15,Playoffs
1718,Paul Pierce,1610612764,WAS,10,6,4,298.0,0,0,0,0.0,13,0.0,1,0.0,0.0,42,11,31,0.262,79,0.532,7,0.583,5.4,42,11,31,0.262,92,0.457,8,0.5,5.4,2014-15,Playoffs
203544,Pero Antic,1610612737,ATL,14,8,6,199.0,9,6,3,0.667,32,0.281,0,0.281,2.2,34,14,19,0.412,60,0.567,6,0.63,5.1,43,20,22,0.465,92,0.467,6,0.5,4.5,2014-15,Playoffs
203515,Phil Pressey,1610612738,BOS,1,0,1,1.0,1,0,1,0.0,1,1.0,0,1.0,30.8,0,0,0,0.0,0,0.0,0,0.0,0.0,1,0,1,0.0,1,1.0,0,1.0,30.8,2014-15,Playoffs
202347,Quincy Pondexter,1610612740,NOP,4,0,4,124.0,3,2,1,0.667,11,0.273,1,0.3,10.3,17,4,13,0.235,29,0.586,0,0.586,5.7,20,6,14,0.3,40,0.5,1,0.513,6.4,2014-15,Playoffs
200765,Rajon Rondo,1610612742,DAL,1,0,1,10.0,1,0,1,0.0,1,1.0,0,1.0,18.8,1,0,1,0.0,2,0.5,0,0.5,12.1,2,0,2,0.0,3,0.667,0,0.667,15.5,2014-15,Playoffs
201196,Ramon Sessions,1610612764,WAS,10,6,4,218.0,2,0,2,0.0,14,0.143,1,0.154,21.4,22,3,19,0.136,38,0.579,3,0.629,11.0,24,3,21,0.125,52,0.462,4,0.5,11.8,2014-15,Playoffs
2446,Rasual Butler,1610612764,WAS,1,1,0,7.0,0,0,0,0.0,0,0.0,0,0.0,0.0,1,0,2,0.0,2,0.5,0,0.5,9.4,1,0,2,0.0,2,0.5,0,0.5,9.4,2014-15,Playoffs
101109,Raymond Felton,1610612742,DAL,3,1,2,36.0,1,1,0,1.0,3,0.333,1,0.5,0.8,6,1,5,0.167,9,0.667,0,0.667,9.7,7,2,5,0.286,12,0.583,1,0.636,8.5,2014-15,Playoffs
2210,Richard Jefferson,1610612742,DAL,2,0,2,16.0,0,0,0,0.0,1,0.0,0,0.0,0.0,2,0,2,0.0,5,0.4,0,0.4,6.0,2,0,2,0.0,6,0.333,0,0.333,6.0,2014-15,Playoffs
201577,Robin Lopez,1610612757,POR,5,1,4,117.0,9,8,1,0.889,30,0.3,0,0.3,3.0,13,2,11,0.154,27,0.481,2,0.52,4.8,22,10,12,0.455,57,0.386,2,0.4,4.1,2014-15,Playoffs
201583,Ryan Anderson,1610612740,NOP,4,0,4,95.0,7,7,1,1.0,14,0.5,0,0.5,3.3,10,5,5,0.5,18,0.556,3,0.667,7.6,17,12,6,0.706,32,0.531,3,0.586,5.7,2014-15,Playoffs
2733,Shaun Livingston,1610612744,GSW,17,15,2,319.0,13,6,7,0.462,37,0.351,1,0.361,6.3,37,15,24,0.405,73,0.507,11,0.597,8.3,50,21,31,0.42,110,0.455,12,0.51,7.8,2014-15,Playoffs
1890,Shawn Marion,1610612739,CLE,2,2,0,8.0,1,1,0,1.0,1,1.0,0,1.0,6.4,4,1,3,0.25,7,0.571,0,0.571,5.8,5,2,3,0.4,8,0.625,0,0.625,5.9,2014-15,Playoffs
202714,Shelvin Mack,1610612737,ATL,5,2,3,85.0,2,1,1,0.5,5,0.4,0,0.4,4.1,9,2,7,0.222,14,0.643,0,0.643,10.3,11,3,8,0.273,19,0.579,0,0.579,9.2,2014-15,Playoffs
201150,Spencer Hawes,1610612746,LAC,5,2,3,50.0,3,2,1,0.667,7,0.429,0,0.429,8.6,10,4,6,0.4,13,0.769,0,0.769,6.3,13,6,7,0.462,20,0.65,0,0.65,6.8,2014-15,Playoffs
201939,Stephen Curry,1610612744,GSW,20,16,4,784.0,20,7,12,0.35,78,0.256,2,0.263,12.4,79,17,63,0.215,151,0.523,10,0.56,8.1,99,24,75,0.242,229,0.432,12,0.456,8.9,2014-15,Playoffs
2581,Steve Blake,1610612757,POR,1,1,0,9.0,0,0,0,0.0,0,0.0,0,0.0,0.0,1,0,1,0.0,2,0.5,0,0.5,7.0,1,0,1,0.0,2,0.5,0,0.5,7.0,2014-15,Playoffs
201959,Taj Gibson,1610612741,CHI,12,6,6,276.0,25,15,8,0.6,70,0.357,2,0.368,6.0,41,18,24,0.439,78,0.526,7,0.577,5.2,66,33,32,0.5,148,0.446,9,0.475,5.5,2014-15,Playoffs
203093,Terrence Jones,1610612745,HOU,16,9,7,374.0,28,17,11,0.607,81,0.346,1,0.35,6.7,51,11,39,0.216,85,0.6,9,0.671,8.0,79,28,50,0.354,166,0.476,10,0.506,7.5,2014-15,Playoffs
203082,Terrence Ross,1610612761,TOR,3,0,3,82.0,0,0,0,0.0,2,0.0,0,0.0,0.0,6,2,4,0.333,11,0.545,0,0.545,8.0,6,2,4,0.333,13,0.462,0,0.462,8.0,2014-15,Playoffs
201152,Thaddeus Young,1610612751,BKN,6,2,4,190.0,17,15,2,0.882,37,0.459,0,0.459,4.2,26,10,16,0.385,44,0.591,5,0.667,5.7,43,25,18,0.581,81,0.531,5,0.566,5.1,2014-15,Playoffs
201168,Tiago Splitter,1610612759,SAS,7,3,4,123.0,13,4,9,0.308,35,0.371,0,0.371,7.2,18,0,17,0.0,28,0.643,0,0.643,6.8,31,4,26,0.129,63,0.492,0,0.492,7.0,2014-15,Playoffs
1495,Tim Duncan,1610612759,SAS,7,3,4,250.0,19,9,8,0.474,48,0.396,2,0.413,7.6,59,17,43,0.288,98,0.602,12,0.686,4.0,78,26,51,0.333,146,0.534,14,0.591,4.8,2014-15,Playoffs
202389,Timofey Mozgov,1610612739,CLE,18,13,5,490.0,55,41,14,0.745,122,0.451,2,0.458,5.1,80,23,58,0.288,153,0.523,12,0.567,4.9,135,64,72,0.474,275,0.491,14,0.517,5.0,2014-15,Playoffs
2754,Tony Allen,1610612763,MEM,9,6,3,273.0,14,9,4,0.643,49,0.286,1,0.292,8.1,38,5,34,0.132,50,0.76,2,0.792,7.3,52,14,38,0.269,99,0.525,3,0.542,7.6,2014-15,Playoffs
2225,Tony Parker,1610612759,SAS,7,3,4,210.0,4,1,3,0.25,14,0.286,1,0.308,11.4,19,0,19,0.0,26,0.731,1,0.76,10.6,23,1,22,0.043,40,0.575,2,0.605,10.8,2014-15,Playoffs
203503,Tony Snell,1610612741,CHI,8,3,5,108.0,1,0,1,0.0,4,0.25,0,0.25,15.7,16,3,13,0.188,22,0.727,1,0.762,6.6,17,3,14,0.176,26,0.654,1,0.68,7.2,2014-15,Playoffs
2772,Trevor Ariza,1610612745,HOU,17,9,8,655.0,18,9,9,0.5,59,0.305,4,0.327,11.8,91,19,74,0.209,131,0.695,7,0.734,6.7,109,28,83,0.257,190,0.574,11,0.609,7.5,2014-15,Playoffs
202684,Tristan Thompson,1610612739,CLE,19,13,6,687.0,81,58,23,0.716,218,0.372,6,0.382,5.0,121,40,78,0.331,229,0.528,15,0.565,4.9,202,98,101,0.485,447,0.452,21,0.474,4.9,2014-15,Playoffs
203898,Tyler Ennis,1610612749,MIL,1,0,1,16.0,3,1,2,0.333,4,0.75,0,0.75,18.0,1,0,1,0.0,3,0.333,1,0.5,13.4,4,1,3,0.25,7,0.571,1,0.667,16.9,2014-15,Playoffs
201946,Tyler Hansbrough,1610612761,TOR,2,0,2,23.0,1,0,1,0.0,6,0.167,0,0.167,14.6,5,0,5,0.0,8,0.625,0,0.625,9.7,6,0,6,0.0,14,0.429,0,0.429,10.5,2014-15,Playoffs
203092,Tyler Zeller,1610612738,BOS,4,0,4,90.0,2,1,1,0.5,20,0.1,1,0.105,6.6,16,6,10,0.375,28,0.571,1,0.593,4.8,18,7,11,0.389,48,0.375,2,0.391,5.0,2014-15,Playoffs
201936,Tyreke Evans,1610612740,NOP,4,0,4,125.0,3,3,0,1.0,14,0.214,0,0.214,2.5,17,3,13,0.176,32,0.531,3,0.586,8.4,20,6,13,0.3,46,0.435,3,0.465,7.5,2014-15,Playoffs
2199,Tyson Chandler,1610612742,DAL,5,1,4,160.0,27,18,9,0.667,49,0.551,2,0.574,5.0,27,13,13,0.481,54,0.5,5,0.551,3.8,54,31,22,0.574,103,0.524,7,0.563,4.4,2014-15,Playoffs
1713,Vince Carter,1610612763,MEM,11,6,5,196.0,13,7,4,0.538,33,0.394,0,0.394,6.5,34,9,24,0.265,54,0.63,1,0.642,6.5,47,16,28,0.34,87,0.54,1,0.547,6.5,2014-15,Playoffs
101198,Will Bynum,1610612764,WAS,1,0,1,14.0,2,1,1,0.5,3,0.667,0,0.667,1.7,1,0,1,0.0,2,0.5,0,0.5,5.3,3,1,2,0.333,5,0.6,0,0.6,2.9,2014-15,Playoffs
2216,Zach Randolph,1610612763,MEM,11,6,5,382.0,32,21,11,0.656,83,0.386,2,0.395,5.6,61,11,49,0.18,98,0.622,7,0.67,5.5,93,32,60,0.344,181,0.514,9,0.541,5.5,2014-15,Playoffs
2585,Zaza Pachulia,1610612749,MIL,6,2,4,129.0,11,5,5,0.455,34,0.324,0,0.324,7.8,29,5,23,0.172,42,0.69,2,0.725,5.2,40,10,28,0.25,76,0.526,2,0.541,5.9,2014-15,Playoffs
201166,Aaron Brooks,1610612741,CHI,46,25,21,793.0,21,5,16,0.238,89,0.236,6,0.253,13.7,80,12,68,0.15,140,0.571,10,0.615,10.7,101,17,84,0.168,229,0.441,16,0.474,11.3,2015-16,Regular%20Season
203932,Aaron Gordon,1610612753,ORL,77,32,45,1857.0,154,113,36,0.734,318,0.484,6,0.494,5.7,352,99,248,0.281,517,0.681,34,0.729,5.3,506,212,284,0.419,835,0.606,40,0.636,5.4,2015-16,Regular%20Season
1626151,Aaron Harrison,1610612766,CHA,10,6,4,53.0,3,1,2,0.333,5,0.6,0,0.6,14.1,11,0,11,0.0,14,0.786,1,0.846,8.8,14,1,13,0.071,19,0.737,1,0.778,9.9,2015-16,Regular%20Season
203940,Adreian Payne,1610612750,MIN,37,13,24,418.0,20,11,9,0.55,42,0.476,3,0.513,6.1,91,29,62,0.319,137,0.664,5,0.689,5.2,111,40,71,0.36,179,0.62,8,0.649,5.3,2015-16,Regular%20Season
201143,Al Horford,1610612737,ATL,82,48,34,2631.0,148,87,57,0.588,329,0.45,4,0.455,7.3,448,145,300,0.324,865,0.518,75,0.567,6.0,596,232,357,0.389,1194,0.499,79,0.535,6.3,2015-16,Regular%20Season
2744,Al Jefferson,1610612766,CHA,47,33,14,1096.0,57,35,22,0.614,157,0.363,8,0.383,5.9,244,62,181,0.254,388,0.629,40,0.701,4.0,301,97,203,0.322,545,0.552,48,0.606,4.4,2015-16,Regular%20Season
202329,Al-Farouq Aminu,1610612757,POR,82,44,38,2341.0,98,45,49,0.459,270,0.363,12,0.38,8.8,401,102,298,0.254,641,0.626,48,0.676,6.0,499,147,347,0.295,911,0.548,60,0.586,6.5,2015-16,Regular%20Season
101187,Alan Anderson,1610612764,WAS,11,7,4,173.0,1,0,1,0.0,12,0.083,0,0.083,35.4,26,5,21,0.192,47,0.553,6,0.634,5.7,27,5,22,0.185,59,0.458,6,0.509,6.8,2015-16,Regular%20Season
1626210,Alan Williams,1610612756,PHX,8,3,5,65.0,14,10,3,0.714,30,0.467,2,0.5,4.9,24,11,13,0.458,30,0.8,1,0.828,3.3,38,21,16,0.553,60,0.633,3,0.667,3.8,2015-16,Regular%20Season
202692,Alec Burks,1610612762,UTA,30,12,18,778.0,16,3,12,0.188,82,0.195,2,0.2,14.3,93,20,74,0.215,174,0.534,12,0.574,7.5,109,23,86,0.211,256,0.426,14,0.45,8.4,2015-16,Regular%20Season
203458,Alex Len,1610612756,PHX,77,23,54,1819.0,178,113,55,0.635,424,0.42,9,0.429,5.9,416,143,269,0.344,701,0.593,56,0.645,4.2,594,256,324,0.431,1125,0.528,65,0.56,4.7,2015-16,Regular%20Season
1627293,Alex Stepheson,1610612763,MEM,6,1,5,69.0,19,14,5,0.737,31,0.613,0,0.613,4.5,9,5,4,0.556,21,0.429,3,0.5,5.2,28,19,9,0.679,52,0.538,3,0.571,4.7,2015-16,Regular%20Season
201582,Alexis Ajinca,1610612740,NOP,52,19,33,826.0,75,50,23,0.667,149,0.503,3,0.514,5.4,194,56,137,0.289,308,0.63,24,0.683,4.0,269,106,160,0.394,457,0.589,27,0.626,4.4,2015-16,Regular%20Season
203459,Allen Crabbe,1610612757,POR,73,38,35,1914.0,27,7,20,0.259,113,0.239,3,0.245,14.5,189,33,153,0.175,309,0.612,37,0.695,7.6,216,40,173,0.185,422,0.512,40,0.565,8.5,2015-16,Regular%20Season
202087,Alonzo Gee,1610612740,NOP,63,25,38,1493.0,60,28,29,0.467,175,0.343,1,0.345,7.5,185,52,131,0.281,305,0.607,22,0.654,7.0,245,80,160,0.327,480,0.51,23,0.536,7.1,2015-16,Regular%20Season
2405,Amar'e Stoudemire,1610612748,MIA,49,28,21,731.0,65,53,12,0.815,153,0.425,0,0.425,4.7,157,40,117,0.255,303,0.518,27,0.569,4.2,222,93,129,0.419,456,0.487,27,0.517,4.3,2015-16,Regular%20Season
101161,Amir Johnson,1610612738,BOS,76,43,33,1746.0,177,114,60,0.644,375,0.472,6,0.48,5.8,321,135,182,0.421,589,0.545,60,0.607,4.9,498,249,242,0.5,964,0.517,66,0.555,5.2,2015-16,Regular%20Season
2760,Anderson Varejao,1610612744,GSW,44,35,9,437.0,37,21,15,0.568,90,0.411,3,0.425,5.9,104,31,72,0.298,161,0.646,12,0.698,4.1,141,52,87,0.369,251,0.562,15,0.597,4.6,2015-16,Regular%20Season
203083,Andre Drummond,1610612765,DET,81,43,38,2665.0,395,287,86,0.727,700,0.564,7,0.57,4.8,803,307,492,0.382,1133,0.709,76,0.76,3.4,1198,594,578,0.496,1833,0.654,83,0.685,3.8,2015-16,Regular%20Season
2738,Andre Iguodala,1610612744,GSW,63,57,6,1684.0,52,25,27,0.481,121,0.43,2,0.437,12.1,211,41,170,0.194,339,0.622,24,0.67,8.4,263,66,197,0.251,460,0.572,26,0.606,9.1,2015-16,Regular%20Season
1889,Andre Miller,1610612759,SAS,21,11,10,348.0,12,7,5,0.583,32,0.375,0,0.375,7.2,39,8,31,0.205,68,0.574,2,0.591,9.5,51,15,36,0.294,100,0.51,2,0.52,8.9,2015-16,Regular%20Season
203460,Andre Roberson,1610612760,OKC,68,47,21,1516.0,79,52,27,0.658,213,0.371,8,0.385,7.3,172,42,133,0.244,312,0.551,23,0.595,6.5,251,94,160,0.375,525,0.478,31,0.508,6.8,2015-16,Regular%20Season
200745,Andrea Bargnani,1610612751,BKN,37,7,30,565.0,28,16,11,0.571,55,0.509,0,0.509,7.2,69,22,49,0.319,135,0.511,6,0.535,5.7,97,38,60,0.392,190,0.511,6,0.527,6.1,2015-16,Regular%20Season
101106,Andrew Bogut,1610612744,GSW,69,61,8,1434.0,121,91,29,0.752,202,0.599,3,0.608,5.1,371,136,234,0.367,640,0.58,54,0.633,3.9,492,227,263,0.461,842,0.584,57,0.627,4.2,2015-16,Regular%20Season
202726,Andrew Goudelock,1610612745,HOU,2,1,1,13.0,1,1,0,1.0,3,0.333,0,0.333,28.9,1,1,0,1.0,5,0.2,0,0.2,5.0,2,2,0,1.0,8,0.25,0,0.25,16.9,2015-16,Regular%20Season
203094,Andrew Nicholson,1610612753,ORL,51,20,31,803.0,34,14,19,0.412,86,0.395,4,0.415,8.3,167,60,107,0.359,251,0.665,12,0.699,4.1,201,74,126,0.368,337,0.596,16,0.626,4.8,2015-16,Regular%20Season
203952,Andrew Wiggins,1610612750,MIN,75,27,48,2651.0,105,60,44,0.571,334,0.314,12,0.326,8.0,186,53,135,0.285,348,0.534,14,0.557,8.3,291,113,179,0.388,682,0.427,26,0.444,8.2,2015-16,Regular%20Season
203461,Anthony Bennett,1610612761,TOR,12,7,5,65.0,6,5,1,0.833,15,0.4,0,0.4,5.6,17,4,13,0.235,18,0.944,1,1.0,5.2,23,9,14,0.391,33,0.697,1,0.719,5.3,2015-16,Regular%20Season
1626148,Anthony Brown,1610612747,LAL,24,4,20,581.0,9,2,8,0.222,43,0.209,3,0.225,17.5,61,14,49,0.23,112,0.545,9,0.592,7.2,70,16,57,0.229,155,0.452,12,0.49,8.6,2015-16,Regular%20Season
203076,Anthony Davis,1610612740,NOP,61,24,37,2164.0,130,87,37,0.669,250,0.52,4,0.528,6.7,497,161,332,0.324,667,0.745,34,0.785,4.9,627,248,369,0.396,917,0.684,38,0.713,5.3,2015-16,Regular%20Season
201627,Anthony Morrow,1610612760,OKC,35,25,10,596.0,10,3,9,0.3,32,0.313,0,0.313,14.5,52,15,37,0.288,89,0.584,3,0.605,9.3,62,18,46,0.29,121,0.512,3,0.525,10.5,2015-16,Regular%20Season
201229,Anthony Tolliver,1610612765,DET,65,33,32,1267.0,39,10,26,0.256,98,0.398,3,0.411,13.3,190,50,135,0.263,327,0.581,35,0.651,5.9,229,60,161,0.262,425,0.539,38,0.592,7.1,2015-16,Regular%20Season
203462,Archie Goodwin,1610612756,PHX,50,12,38,1068.0,27,13,11,0.481,134,0.201,10,0.218,8.4,115,25,91,0.217,194,0.593,18,0.653,6.7,142,38,102,0.268,328,0.433,28,0.473,7.0,2015-16,Regular%20Season
203382,Aron Baynes,1610612765,DET,77,42,35,1189.0,140,97,39,0.693,337,0.415,4,0.42,5.4,244,97,149,0.398,415,0.588,40,0.651,4.7,384,194,188,0.505,752,0.511,44,0.542,5.0,2015-16,Regular%20Season
201167,Arron Afflalo,1610612752,NYK,70,27,43,2341.0,23,7,17,0.304,150,0.153,6,0.16,15.3,243,27,217,0.111,418,0.581,34,0.633,8.5,266,34,234,0.128,568,0.468,40,0.504,9.1,2015-16,Regular%20Season
203085,Austin Rivers,1610612746,LAC,55,35,20,1244.0,22,11,11,0.5,87,0.253,3,0.262,11.5,108,10,100,0.093,227,0.476,17,0.514,8.9,130,21,111,0.162,314,0.414,20,0.442,9.4,2015-16,Regular%20Season
202340,Avery Bradley,1610612738,BOS,72,43,29,2415.0,48,13,35,0.271,152,0.316,5,0.327,13.2,169,16,153,0.095,336,0.503,25,0.543,7.6,217,29,188,0.134,488,0.445,30,0.474,8.8,2015-16,Regular%20Season
1626253,Axel Toupane,1610612743,DEN,17,6,11,252.0,8,2,6,0.25,21,0.381,0,0.381,12.2,23,3,19,0.13,44,0.523,2,0.548,11.7,31,5,25,0.161,65,0.477,2,0.492,11.8,2015-16,Regular%20Season
203463,Ben McLemore,1610612758,SAC,56,24,32,1256.0,33,12,21,0.364,109,0.303,8,0.327,11.2,111,15,96,0.135,241,0.461,33,0.534,8.2,144,27,117,0.188,350,0.411,41,0.466,8.9,2015-16,Regular%20Season
2757,Beno Udrih,1610612763,MEM,30,18,12,542.0,8,0,8,0.0,41,0.195,3,0.211,17.3,63,10,56,0.159,107,0.589,7,0.63,11.2,71,10,64,0.141,148,0.48,10,0.514,11.8,2015-16,Regular%20Season
202687,Bismack Biyombo,1610612761,TOR,81,55,26,1787.0,180,131,48,0.728,439,0.41,11,0.421,5.2,469,173,296,0.369,775,0.605,65,0.661,3.9,649,304,344,0.468,1214,0.535,76,0.57,4.2,2015-16,Regular%20Season
201933,Blake Griffin,1610612746,LAC,35,22,13,1170.0,51,29,19,0.569,130,0.392,11,0.429,6.8,243,79,161,0.325,412,0.59,23,0.625,5.1,294,108,180,0.367,542,0.542,34,0.579,5.3,2015-16,Regular%20Season
1626246,Boban Marjanovic,1610612759,SAS,40,34,6,475.0,72,59,9,0.819,133,0.541,4,0.558,3.9,120,46,74,0.383,177,0.678,8,0.71,3.7,192,105,83,0.547,310,0.619,12,0.644,3.7,2015-16,Regular%20Season
1626171,Bobby Portis,1610612741,CHI,59,27,32,1079.0,123,80,41,0.65,276,0.446,8,0.459,5.6,214,55,161,0.257,339,0.631,26,0.684,4.6,337,135,202,0.401,615,0.548,34,0.58,5.0,2015-16,Regular%20Season
202711,Bojan Bogdanovic,1610612751,BKN,77,20,57,2058.0,36,14,22,0.389,184,0.196,11,0.208,13.3,219,33,181,0.151,332,0.66,22,0.706,7.9,255,47,203,0.184,516,0.494,33,0.528,8.7,2015-16,Regular%20Season
2564,Boris Diaw,1610612759,SAS,71,62,9,1316.0,58,27,32,0.466,157,0.369,5,0.382,8.8,175,60,114,0.343,332,0.527,27,0.574,5.6,233,87,146,0.373,489,0.476,32,0.51,6.4,2015-16,Regular%20Season
203078,Bradley Beal,1610612764,WAS,53,27,26,1652.0,41,19,23,0.463,138,0.297,6,0.311,14.1,147,30,114,0.204,228,0.645,6,0.662,7.5,188,49,137,0.261,366,0.514,12,0.531,9.0,2015-16,Regular%20Season
201148,Brandan Wright,1610612763,MEM,11,6,5,206.0,14,11,3,0.786,35,0.4,0,0.4,5.9,29,12,16,0.414,53,0.547,4,0.592,6.0,43,23,19,0.535,88,0.489,4,0.512,6.0,2015-16,Regular%20Season
1626183,Branden Dawson,1610612746,LAC,2,2,0,15.0,2,1,1,0.5,4,0.5,0,0.5,8.8,2,2,0,1.0,4,0.5,1,0.667,3.9,4,3,1,0.75,8,0.5,1,0.571,6.3,2015-16,Regular%20Season
101138,Brandon Bass,1610612747,LAL,66,16,50,1342.0,104,57,45,0.548,248,0.419,6,0.43,7.7,181,46,131,0.254,344,0.526,29,0.575,6.2,285,103,176,0.361,592,0.481,35,0.512,6.7,2015-16,Regular%20Season
201943,Brandon Jennings,1610612753,ORL,39,19,20,726.0,16,5,10,0.313,44,0.364,0,0.364,15.7,80,6,76,0.075,134,0.597,11,0.65,9.0,96,11,86,0.115,178,0.539,11,0.575,10.0,2015-16,Regular%20Season
202688,Brandon Knight,1610612756,PHX,50,16,34,1803.0,36,11,23,0.306,125,0.288,7,0.305,15.8,166,27,138,0.163,315,0.527,20,0.563,8.1,202,38,161,0.188,440,0.459,27,0.489,9.4,2015-16,Regular%20Season
201575,Brandon Rush,1610612744,GSW,61,53,8,996.0,21,8,12,0.381,64,0.328,2,0.339,12.1,160,41,118,0.256,259,0.618,25,0.684,6.3,181,49,130,0.271,323,0.56,27,0.611,6.9,2015-16,Regular%20Season
203148,Brian Roberts,1610612757,POR,28,13,15,333.0,6,0,5,0.0,16,0.375,0,0.375,24.8,35,2,33,0.057,57,0.614,1,0.625,8.4,41,2,38,0.049,73,0.562,1,0.569,10.5,2015-16,Regular%20Season
1627362,Briante Weber,1610612748,MIA,7,3,4,169.0,8,2,4,0.25,13,0.615,1,0.667,20.6,17,3,14,0.176,32,0.531,3,0.586,8.4,25,5,18,0.2,45,0.556,4,0.61,11.6,2015-16,Regular%20Season
201572,Brook Lopez,1610612751,BKN,73,21,52,2457.0,204,148,49,0.725,406,0.502,10,0.515,5.7,369,147,217,0.398,653,0.565,64,0.626,5.9,573,295,266,0.515,1059,0.541,74,0.582,5.8,2015-16,Regular%20Season
203998,Bruno Caboclo,1610612761,TOR,2,2,0,36.0,1,1,0,1.0,3,0.333,0,0.333,3.3,1,0,1,0.0,4,0.25,0,0.25,3.6,2,1,1,0.5,7,0.286,0,0.286,3.5,2015-16,Regular%20Season
1626214,Bryce Dejean-Jones,1610612740,NOP,12,6,6,277.0,8,2,6,0.25,22,0.364,1,0.381,10.2,40,11,29,0.275,64,0.625,6,0.69,6.7,48,13,35,0.271,86,0.558,7,0.608,7.3,2015-16,Regular%20Season
201228,C.J. Watson,1610612753,ORL,26,14,12,545.0,10,4,6,0.4,26,0.385,1,0.4,15.1,56,6,51,0.107,88,0.636,7,0.691,10.0,66,10,57,0.152,114,0.579,8,0.623,10.7,2015-16,Regular%20Season
203912,C.J. Wilcox,1610612746,LAC,8,5,3,90.0,1,0,1,0.0,3,0.333,0,0.333,23.6,11,2,9,0.182,19,0.579,2,0.647,9.8,12,2,10,0.167,22,0.545,2,0.6,11.0,2015-16,Regular%20Season
203468,CJ McCollum,1610612757,POR,78,44,34,2708.0,47,13,34,0.277,222,0.212,10,0.222,14.3,212,31,181,0.146,408,0.52,36,0.57,9.3,259,44,215,0.17,630,0.411,46,0.443,10.2,2015-16,Regular%20Season
101139,CJ Miles,1610612754,IND,59,29,30,1376.0,25,16,10,0.64,88,0.284,2,0.291,8.4,150,41,113,0.273,284,0.528,27,0.584,6.2,175,57,123,0.326,372,0.47,29,0.51,6.5,2015-16,Regular%20Season
203946,Cameron Bairstow,1610612765,DET,14,3,11,92.0,4,3,1,0.75,25,0.16,0,0.16,2.4,24,6,18,0.25,38,0.632,1,0.649,6.3,28,9,19,0.321,63,0.444,1,0.452,5.7,2015-16,Regular%20Season
1626166,Cameron Payne,1610612760,OKC,39,30,9,585.0,9,3,6,0.333,46,0.196,1,0.2,13.2,76,6,72,0.079,123,0.618,7,0.655,6.8,85,9,78,0.106,169,0.503,8,0.528,7.4,2015-16,Regular%20Season
201171,Carl Landry,1610612755,PHI,31,4,27,527.0,49,34,15,0.694,96,0.51,2,0.521,5.4,97,19,77,0.196,159,0.61,19,0.693,5.1,146,53,92,0.363,255,0.573,21,0.624,5.2,2015-16,Regular%20Season
2546,Carmelo Anthony,1610612752,NYK,72,32,40,2530.0,98,66,26,0.673,288,0.34,8,0.35,6.9,458,82,374,0.179,646,0.709,35,0.75,6.3,556,148,400,0.266,934,0.595,43,0.624,6.4,2015-16,Regular%20Season
2406,Caron Butler,1610612758,SAC,9,2,7,125.0,5,2,3,0.4,9,0.556,0,0.556,17.4,17,3,14,0.176,34,0.5,3,0.548,7.2,22,5,17,0.227,43,0.512,3,0.55,9.5,2015-16,Regular%20Season
202718,Chandler Parsons,1610612742,DAL,61,29,32,1799.0,29,6,24,0.207,134,0.216,12,0.238,15.7,256,48,209,0.188,401,0.638,25,0.681,6.5,285,54,233,0.189,535,0.533,37,0.572,7.5,2015-16,Regular%20Season
101112,Channing Frye,1610612739,CLE,64,33,31,1123.0,34,18,16,0.529,63,0.54,1,0.548,9.7,193,56,133,0.29,342,0.564,25,0.609,4.4,227,74,149,0.326,405,0.56,26,0.599,5.2,2015-16,Regular%20Season
101111,Charlie Villanueva,1610612742,DAL,47,22,25,606.0,24,17,8,0.708,69,0.348,4,0.369,8.3,127,25,102,0.197,187,0.679,10,0.718,5.1,151,42,110,0.278,256,0.59,14,0.624,5.6,2015-16,Regular%20Season
201978,Chase Budinger,1610612756,PHX,54,25,29,813.0,43,16,25,0.372,87,0.494,1,0.5,8.4,107,25,83,0.234,178,0.601,18,0.669,7.3,150,41,108,0.273,265,0.566,19,0.61,7.6,2015-16,Regular%20Season
2365,Chris Andersen,1610612763,MEM,24,8,16,388.0,36,29,7,0.806,73,0.493,0,0.493,4.9,62,21,43,0.339,106,0.585,9,0.639,4.1,98,50,50,0.51,179,0.547,9,0.576,4.4,2015-16,Regular%20Season
2547,Chris Bosh,1610612748,MIA,53,29,24,1778.0,48,30,18,0.625,120,0.4,2,0.407,9.1,342,94,245,0.275,544,0.629,38,0.676,5.3,390,124,263,0.318,664,0.587,40,0.625,5.8,2015-16,Regular%20Season
203142,Chris Copeland,1610612749,MIL,7,3,4,58.0,1,1,0,1.0,8,0.125,0,0.125,2.5,9,2,7,0.222,19,0.474,2,0.529,4.9,10,3,7,0.3,27,0.37,2,0.4,4.6,2015-16,Regular%20Season
203187,Chris Johnson,1610612762,UTA,48,27,21,732.0,27,10,16,0.37,58,0.466,3,0.491,12.8,105,25,81,0.238,174,0.603,14,0.656,7.2,132,35,97,0.265,232,0.569,17,0.614,8.3,2015-16,Regular%20Season
2549,Chris Kaman,1610612757,POR,11,6,5,97.0,7,4,3,0.571,12,0.583,0,0.583,7.4,17,8,9,0.471,36,0.472,3,0.515,3.9,24,12,12,0.5,48,0.5,3,0.533,4.9,2015-16,Regular%20Season
1626191,Chris McCullough,1610612751,BKN,22,6,16,345.0,25,11,13,0.44,61,0.41,0,0.41,7.9,43,11,33,0.256,91,0.473,11,0.538,5.8,68,22,46,0.324,152,0.447,11,0.482,6.5,2015-16,Regular%20Season
101108,Chris Paul,1610612746,LAC,73,50,23,2389.0,39,11,27,0.282,167,0.234,13,0.253,14.4,271,51,223,0.188,523,0.518,30,0.55,9.5,310,62,250,0.2,690,0.449,43,0.479,10.1,2015-16,Regular%20Season
1626174,Christian Wood,1610612755,PHI,11,0,11,124.0,13,4,8,0.308,25,0.52,0,0.52,4.8,25,11,15,0.44,44,0.568,5,0.641,5.4,38,15,23,0.395,69,0.551,5,0.594,5.2,2015-16,Regular%20Season
101236,Chuck Hayes,1610612746,LAC,2,1,1,24.0,0,0,0,0.0,1,0.0,0,0.0,0.0,8,4,4,0.5,13,0.615,0,0.615,3.0,8,4,4,0.5,14,0.571,0,0.571,3.0,2015-16,Regular%20Season
203921,Cleanthony Early,1610612752,NYK,8,3,5,128.0,4,2,2,0.5,19,0.211,0,0.211,8.5,22,3,19,0.136,39,0.564,4,0.629,6.1,26,5,21,0.192,58,0.448,4,0.481,6.5,2015-16,Regular%20Season
1626146,Cliff Alexander,1610612757,POR,2,1,1,20.0,2,2,0,1.0,4,0.5,0,0.5,3.1,4,1,3,0.25,6,0.667,1,0.8,7.0,6,3,3,0.5,10,0.6,1,0.667,5.7,2015-16,Regular%20Season
203991,Clint Capela,1610612745,HOU,77,39,38,1471.0,194,153,40,0.789,410,0.473,10,0.485,5.0,300,123,178,0.41,536,0.56,33,0.596,4.5,494,276,218,0.559,946,0.522,43,0.547,4.7,2015-16,Regular%20Season
203469,Cody Zeller,1610612766,CHA,73,42,31,1774.0,138,93,45,0.674,384,0.359,10,0.369,5.7,317,112,201,0.353,594,0.534,60,0.594,4.9,455,205,246,0.451,978,0.465,70,0.501,5.2,2015-16,Regular%20Season
202332,Cole Aldrich,1610612746,LAC,55,36,19,769.0,86,53,32,0.616,186,0.462,2,0.467,6.1,202,65,132,0.322,318,0.635,25,0.689,4.2,288,118,164,0.41,504,0.571,27,0.604,4.8,2015-16,Regular%20Season
201147,Corey Brewer,1610612745,HOU,71,34,37,1489.0,42,12,28,0.286,153,0.275,3,0.28,11.8,157,36,121,0.229,290,0.541,30,0.604,8.6,199,48,149,0.241,443,0.449,33,0.485,9.2,2015-16,Regular%20Season
203928,Cory Jefferson,1610612756,PHX,6,1,5,50.0,6,5,1,0.833,17,0.353,0,0.353,16.1,10,5,4,0.5,17,0.588,3,0.714,4.2,16,10,5,0.625,34,0.471,3,0.516,8.9,2015-16,Regular%20Season
202709,Cory Joseph,1610612761,TOR,73,49,24,1851.0,38,14,24,0.368,191,0.199,8,0.208,11.2,169,36,137,0.213,367,0.46,21,0.488,8.1,207,50,161,0.242,558,0.371,29,0.391,8.6,2015-16,Regular%20Season
1626262,Coty Clarke,1610612738,BOS,1,0,1,3.0,0,0,0,0.0,0,0.0,0,0.0,0.0,1,1,0,1.0,1,1.0,0,1.0,5.9,1,1,0,1.0,1,1.0,0,1.0,5.9,2015-16,Regular%20Season
201584,Courtney Lee,1610612766,CHA,72,43,29,2136.0,28,8,20,0.286,100,0.28,5,0.295,16.5,176,27,148,0.153,275,0.64,13,0.672,8.9,204,35,168,0.172,375,0.544,18,0.571,10.0,2015-16,Regular%20Season
1626245,Cristiano Felicio,1610612741,CHI,25,12,13,305.0,30,16,14,0.533,91,0.33,0,0.33,6.2,72,25,47,0.347,130,0.554,9,0.595,4.2,102,41,61,0.402,221,0.462,9,0.481,4.8,2015-16,Regular%20Season
1626156,D'Angelo Russell,1610612747,LAL,77,17,60,2190.0,47,22,26,0.468,223,0.211,8,0.219,12.6,227,26,201,0.115,410,0.554,31,0.599,8.4,274,48,227,0.175,633,0.433,39,0.461,9.2,2015-16,Regular%20Season
201571,D.J. Augustin,1610612743,DEN,50,27,23,1019.0,8,1,7,0.125,72,0.111,4,0.118,15.5,87,6,86,0.069,156,0.558,10,0.596,10.4,95,7,93,0.074,228,0.417,14,0.444,10.8,2015-16,Regular%20Season
2563,Dahntay Jones,1610612739,CLE,1,0,1,42.0,1,0,1,0.0,9,0.111,0,0.111,6.3,4,0,4,0.0,10,0.4,1,0.444,9.0,5,0,5,0.0,19,0.263,1,0.278,8.5,2015-16,Regular%20Season
203081,Damian Lillard,1610612757,POR,74,39,35,2645.0,45,14,34,0.311,236,0.191,13,0.202,14.6,257,37,226,0.144,474,0.542,38,0.589,8.7,302,51,260,0.169,710,0.425,51,0.458,9.6,2015-16,Regular%20Season
203996,Damien Inglis,1610612749,MIL,13,2,11,137.0,2,1,1,0.5,16,0.125,0,0.125,12.2,29,7,22,0.241,42,0.69,1,0.707,5.7,31,8,23,0.258,58,0.534,1,0.544,6.1,2015-16,Regular%20Season
204014,Damjan Rudez,1610612750,MIN,14,6,8,142.0,5,1,4,0.2,9,0.556,0,0.556,11.7,15,5,10,0.333,25,0.6,0,0.6,8.4,20,6,14,0.3,34,0.588,0,0.588,9.2,2015-16,Regular%20Season
201568,Danilo Gallinari,1610612743,DEN,53,22,31,1839.0,52,31,21,0.596,173,0.301,4,0.308,7.3,229,51,178,0.223,374,0.612,36,0.678,6.6,281,82,199,0.292,547,0.514,40,0.554,6.7,2015-16,Regular%20Season
201980,Danny Green,1610612759,SAS,76,62,14,2003.0,48,23,25,0.479,124,0.387,4,0.4,10.8,255,59,194,0.231,520,0.49,43,0.535,5.8,303,82,219,0.271,644,0.47,47,0.508,6.6,2015-16,Regular%20Season
201967,Dante Cunningham,1610612740,NOP,75,27,48,1889.0,57,22,33,0.386,161,0.354,6,0.368,10.9,179,27,151,0.151,320,0.559,21,0.599,7.0,236,49,184,0.208,481,0.491,27,0.52,7.9,2015-16,Regular%20Season
201589,Darrell Arthur,1610612743,DEN,67,24,43,1471.0,86,39,43,0.453,185,0.465,3,0.473,8.3,207,62,146,0.3,386,0.536,45,0.607,5.5,293,101,189,0.345,571,0.513,48,0.56,6.3,2015-16,Regular%20Season
201954,Darren Collison,1610612758,SAC,64,26,38,1962.0,28,9,18,0.321,160,0.175,6,0.182,12.1,140,12,125,0.086,254,0.551,22,0.603,11.7,168,21,143,0.125,414,0.406,28,0.435,11.7,2015-16,Regular%20Season
1626199,Darrun Hilliard,1610612765,DET,20,10,10,274.0,4,0,4,0.0,20,0.2,0,0.2,22.1,40,8,32,0.2,60,0.667,2,0.69,7.7,44,8,36,0.182,80,0.55,2,0.564,9.0,2015-16,Regular%20Season
101135,David Lee,1610612742,DAL,54,26,28,888.0,100,69,27,0.69,227,0.441,5,0.45,6.3,202,58,141,0.287,352,0.574,28,0.623,4.3,302,127,168,0.421,579,0.522,33,0.553,5.0,2015-16,Regular%20Season
2561,David West,1610612759,SAS,76,62,14,1373.0,72,51,21,0.708,186,0.387,6,0.4,6.9,237,80,156,0.338,425,0.558,41,0.617,5.4,309,131,177,0.424,611,0.506,47,0.548,5.7,2015-16,Regular%20Season
201599,DeAndre Jordan,1610612746,LAC,77,51,26,2598.0,267,182,79,0.682,511,0.523,13,0.536,5.6,792,214,571,0.27,1147,0.69,72,0.737,4.6,1059,396,650,0.374,1658,0.639,85,0.673,4.9,2015-16,Regular%20Season
201971,DeJuan Blair,1610612764,WAS,21,8,13,195.0,20,14,5,0.7,44,0.455,1,0.465,6.3,37,16,21,0.432,51,0.725,6,0.822,4.4,57,30,26,0.526,95,0.6,7,0.648,5.0,2015-16,Regular%20Season
201942,DeMar DeRozan,1610612761,TOR,75,51,24,2691.0,62,34,30,0.548,233,0.266,10,0.278,10.7,276,54,222,0.196,467,0.591,32,0.634,7.9,338,88,252,0.26,700,0.483,42,0.514,8.4,2015-16,Regular%20Season
202326,DeMarcus Cousins,1610612758,SAC,64,29,35,2221.0,154,108,34,0.701,402,0.383,12,0.395,5.0,586,212,372,0.362,871,0.673,47,0.711,4.5,740,320,406,0.432,1273,0.581,59,0.61,4.6,2015-16,Regular%20Season
201960,DeMarre Carroll,1610612761,TOR,26,16,10,786.0,31,18,12,0.581,100,0.31,4,0.323,8.9,91,17,73,0.187,162,0.562,15,0.619,7.9,122,35,85,0.287,262,0.466,19,0.502,8.1,2015-16,Regular%20Season
1626153,Delon Wright,1610612761,TOR,16,13,3,201.0,8,4,4,0.5,31,0.258,0,0.258,12.5,29,5,24,0.172,52,0.558,5,0.617,8.2,37,9,28,0.243,83,0.446,5,0.474,9.1,2015-16,Regular%20Season
203471,Dennis Schroder,1610612737,ATL,72,40,32,1471.0,25,10,15,0.4,129,0.194,6,0.203,13.0,179,22,160,0.123,332,0.539,22,0.577,8.5,204,32,175,0.157,461,0.443,28,0.471,9.1,2015-16,Regular%20Season
101114,Deron Williams,1610612742,DAL,59,28,31,1952.0,19,5,15,0.263,129,0.147,9,0.158,15.1,171,27,146,0.158,346,0.494,25,0.533,9.3,190,32,161,0.168,475,0.4,34,0.431,9.9,2015-16,Regular%20Season
202324,Derrick Favors,1610612762,UTA,62,30,32,1983.0,169,120,49,0.71,390,0.433,8,0.442,6.3,334,125,205,0.374,570,0.586,49,0.641,4.6,503,245,254,0.487,960,0.524,57,0.557,5.2,2015-16,Regular%20Season
201565,Derrick Rose,1610612741,CHI,62,31,31,2017.0,46,26,21,0.565,259,0.178,10,0.185,9.5,179,25,159,0.14,340,0.526,20,0.559,10.4,225,51,180,0.227,599,0.376,30,0.395,10.2,2015-16,Regular%20Season
202682,Derrick Williams,1610612752,NYK,76,30,46,1394.0,47,23,22,0.489,138,0.341,3,0.348,9.4,249,44,206,0.177,358,0.696,19,0.735,5.4,296,67,228,0.226,496,0.597,22,0.624,6.0,2015-16,Regular%20Season
1626164,Devin Booker,1610612756,PHX,61,14,47,1844.0,27,10,18,0.37,138,0.196,7,0.206,13.1,160,27,133,0.169,331,0.483,26,0.525,8.2,187,37,151,0.198,469,0.399,33,0.429,8.9,2015-16,Regular%20Season
2734,Devin Harris,1610612742,DAL,55,33,22,1154.0,18,3,15,0.167,64,0.281,0,0.281,14.4,119,25,91,0.21,220,0.541,22,0.601,7.6,137,28,106,0.204,284,0.482,22,0.523,8.5,2015-16,Regular%20Season
203906,Devyn Marble,1610612753,ORL,12,5,7,181.0,5,1,3,0.2,13,0.385,0,0.385,16.7,32,4,28,0.125,44,0.727,3,0.78,6.9,37,5,31,0.135,57,0.649,3,0.685,8.0,2015-16,Regular%20Season
203473,Dewayne Dedmon,1610612753,ORL,47,18,29,666.0,67,43,20,0.642,136,0.493,5,0.511,6.4,161,52,110,0.323,234,0.688,16,0.739,4.4,228,95,130,0.417,370,0.616,21,0.653,5.0,2015-16,Regular%20Season
203079,Dion Waiters,1610612760,OKC,69,48,21,1921.0,36,9,25,0.25,119,0.303,3,0.31,13.8,166,27,138,0.163,279,0.595,31,0.669,8.0,202,36,163,0.178,398,0.508,34,0.555,9.0,2015-16,Regular%20Season
1717,Dirk Nowitzki,1610612742,DAL,75,38,37,2364.0,52,36,16,0.692,130,0.4,11,0.437,10.8,437,138,299,0.316,720,0.607,64,0.666,4.6,489,174,315,0.356,850,0.575,75,0.631,5.3,2015-16,Regular%20Season
202388,Donald Sloan,1610612751,BKN,48,12,36,1155.0,17,4,13,0.235,70,0.243,6,0.266,15.8,155,18,137,0.116,240,0.646,11,0.677,8.3,172,22,150,0.128,310,0.555,17,0.587,9.0,2015-16,Regular%20Season
202700,Donatas Motiejunas,1610612745,HOU,32,18,14,508.0,37,23,14,0.622,67,0.552,1,0.561,8.2,72,17,55,0.236,146,0.493,12,0.537,5.2,109,40,69,0.367,213,0.512,13,0.545,6.2,2015-16,Regular%20Season
203926,Doug McDermott,1610612741,CHI,74,38,36,1747.0,37,17,19,0.459,119,0.311,7,0.33,12.8,158,31,125,0.196,305,0.518,32,0.579,7.2,195,48,144,0.246,424,0.46,39,0.506,8.2,2015-16,Regular%20Season
203110,Draymond Green,1610612744,GSW,81,73,8,2808.0,134,93,37,0.694,326,0.411,8,0.421,6.3,635,219,412,0.345,993,0.639,58,0.679,4.8,769,312,449,0.406,1319,0.583,66,0.614,5.0,2015-16,Regular%20Season
2400,Drew Gooden,1610612764,WAS,25,15,10,286.0,28,19,6,0.679,44,0.636,2,0.667,6.2,57,16,41,0.281,95,0.6,6,0.64,4.9,85,35,47,0.412,139,0.612,8,0.649,5.3,2015-16,Regular%20Season
1626251,Duje Dukan,1610612758,SAC,1,0,1,24.0,2,1,1,0.5,4,0.5,0,0.5,7.5,2,0,2,0.0,5,0.4,1,0.5,7.0,4,1,3,0.25,9,0.444,1,0.5,7.3,2015-16,Regular%20Season
2730,Dwight Howard,1610612745,HOU,71,34,37,2280.0,238,170,63,0.714,554,0.43,15,0.442,4.6,597,199,389,0.333,916,0.652,56,0.694,3.9,835,369,452,0.442,1470,0.568,71,0.597,4.1,2015-16,Regular%20Season
203939,Dwight Powell,1610612742,DAL,59,31,28,968.0,84,53,31,0.631,214,0.393,8,0.408,6.3,189,44,142,0.233,287,0.659,16,0.697,4.6,273,97,173,0.355,501,0.545,24,0.572,5.2,2015-16,Regular%20Season
2548,Dwyane Wade,1610612748,MIA,73,43,30,2227.0,82,47,33,0.573,241,0.34,8,0.352,7.5,220,47,174,0.214,389,0.566,30,0.613,8.3,302,94,207,0.311,630,0.479,38,0.51,8.1,2015-16,Regular%20Season
202734,E'Twaun Moore,1610612741,CHI,50,25,25,1145.0,19,9,10,0.474,69,0.275,2,0.284,12.0,114,25,90,0.219,203,0.562,24,0.637,9.6,133,34,100,0.256,272,0.489,26,0.541,9.9,2015-16,Regular%20Season
202334,Ed Davis,1610612757,POR,81,43,38,1684.0,224,150,66,0.67,513,0.437,15,0.45,5.6,375,137,242,0.365,660,0.568,68,0.633,4.5,599,287,308,0.479,1173,0.511,83,0.55,4.9,2015-16,Regular%20Season
204002,Edy Tavares,1610612737,ATL,8,6,2,60.0,7,3,4,0.429,17,0.412,0,0.412,3.8,14,5,9,0.357,23,0.609,5,0.778,4.2,21,8,13,0.381,40,0.525,5,0.6,4.1,2015-16,Regular%20Season
203901,Elfrid Payton,1610612753,ORL,69,30,39,2086.0,77,35,38,0.455,254,0.303,12,0.318,9.9,183,26,159,0.142,334,0.548,37,0.616,9.0,260,61,197,0.235,588,0.442,49,0.482,9.3,2015-16,Regular%20Season
202407,Elijah Millsap,1610612762,UTA,15,6,9,149.0,6,4,2,0.667,21,0.286,0,0.286,10.8,29,10,19,0.345,44,0.659,3,0.707,7.3,35,14,21,0.4,65,0.538,3,0.565,7.9,2015-16,Regular%20Season
202343,Elliot Williams,1610612766,CHA,1,1,0,20.0,1,0,1,0.0,2,0.5,0,0.5,17.6,3,1,2,0.333,3,1.0,0,1.0,5.2,4,1,3,0.25,5,0.8,0,0.8,8.3,2015-16,Regular%20Season
1882,Elton Brand,1610612755,PHI,15,2,13,200.0,9,6,3,0.667,21,0.429,0,0.429,7.8,54,16,37,0.296,79,0.684,2,0.701,6.3,63,22,40,0.349,100,0.63,2,0.643,6.5,2015-16,Regular%20Season
1626144,Emmanuel Mudiay,1610612743,DEN,64,26,38,1957.0,32,16,14,0.5,170,0.188,4,0.193,11.3,200,23,178,0.115,389,0.514,33,0.562,8.7,232,39,192,0.168,559,0.415,37,0.444,9.0,2015-16,Regular%20Season
202683,Enes Freedom,1610612760,OKC,82,55,27,1721.0,249,194,39,0.779,563,0.442,17,0.456,4.1,415,146,269,0.352,687,0.604,58,0.66,4.0,664,340,308,0.512,1250,0.531,75,0.565,4.0,2015-16,Regular%20Season
202339,Eric Bledsoe,1610612756,PHX,30,11,19,1021.0,18,7,12,0.389,97,0.186,4,0.194,11.8,106,19,86,0.179,193,0.549,19,0.609,9.0,124,26,98,0.21,290,0.428,23,0.464,9.3,2015-16,Regular%20Season
201569,Eric Gordon,1610612740,NOP,41,13,28,1386.0,10,1,9,0.1,63,0.159,0,0.159,18.3,89,9,81,0.101,166,0.536,11,0.574,8.8,99,10,90,0.101,229,0.432,11,0.454,9.7,2015-16,Regular%20Season
203961,Eric Moreland,1610612758,SAC,7,1,6,43.0,3,2,1,0.667,17,0.176,0,0.176,6.9,6,4,2,0.667,13,0.462,3,0.6,4.3,9,6,3,0.667,30,0.3,3,0.333,5.2,2015-16,Regular%20Season
203475,Erick Green,1610612743,DEN,5,3,2,33.0,3,0,3,0.0,4,0.75,0,0.75,21.8,3,0,3,0.0,7,0.429,1,0.5,5.7,6,0,6,0.0,11,0.545,1,0.6,13.7,2015-16,Regular%20Season
101141,Ersan Ilyasova,1610612753,ORL,73,35,38,1862.0,144,95,42,0.66,318,0.453,9,0.466,5.8,259,80,176,0.309,448,0.578,53,0.656,5.7,403,175,218,0.434,766,0.526,62,0.572,5.7,2015-16,Regular%20Season
203095,Evan Fournier,1610612753,ORL,75,32,43,2446.0,32,10,22,0.313,206,0.155,1,0.156,11.8,190,36,154,0.189,356,0.534,27,0.578,8.7,222,46,176,0.207,562,0.395,28,0.416,9.2,2015-16,Regular%20Season
202323,Evan Turner,1610612738,BOS,80,46,34,2244.0,50,23,25,0.46,205,0.244,6,0.251,13.4,346,56,289,0.162,511,0.677,33,0.724,6.3,396,79,314,0.199,716,0.553,39,0.585,7.2,2015-16,Regular%20Season
203105,Festus Ezeli,1610612744,GSW,45,42,3,763.0,91,66,21,0.725,226,0.403,4,0.41,4.6,166,72,92,0.434,313,0.53,35,0.597,3.8,257,138,113,0.537,539,0.477,39,0.514,4.1,2015-16,Regular%20Season
1626163,Frank Kaminsky,1610612766,CHA,77,45,32,1685.0,69,41,27,0.594,210,0.329,9,0.343,8.0,266,83,186,0.312,499,0.533,39,0.578,5.3,335,124,213,0.37,709,0.472,48,0.507,5.9,2015-16,Regular%20Season
202066,Garrett Temple,1610612764,WAS,70,36,34,1814.0,36,18,19,0.5,145,0.248,6,0.259,10.1,176,37,138,0.21,324,0.543,28,0.595,8.6,212,55,157,0.259,469,0.452,34,0.487,8.8,2015-16,Regular%20Season
203914,Gary Harris,1610612743,DEN,72,30,42,2315.0,54,22,33,0.407,173,0.312,9,0.329,11.7,166,20,146,0.12,284,0.585,25,0.641,10.4,220,42,179,0.191,457,0.481,34,0.52,10.8,2015-16,Regular%20Season
202390,Gary Neal,1610612764,WAS,34,14,20,701.0,11,4,6,0.364,34,0.324,2,0.344,13.1,72,6,68,0.083,134,0.537,10,0.581,7.6,83,10,74,0.12,168,0.494,12,0.532,8.2,2015-16,Regular%20Season
201588,George Hill,1610612754,IND,71,39,32,2422.0,58,34,24,0.586,176,0.33,6,0.341,10.4,240,32,206,0.133,455,0.527,32,0.567,8.2,298,66,230,0.221,631,0.472,38,0.503,8.7,2015-16,Regular%20Season
101123,Gerald Green,1610612748,MIA,57,31,26,1411.0,25,12,12,0.48,85,0.294,2,0.301,9.5,138,19,120,0.138,252,0.548,18,0.59,8.2,163,31,132,0.19,337,0.484,20,0.514,8.5,2015-16,Regular%20Season
201945,Gerald Henderson,1610612757,POR,63,36,27,1308.0,30,8,21,0.267,95,0.316,3,0.326,12.9,181,27,153,0.149,285,0.635,24,0.693,7.3,211,35,174,0.166,380,0.555,27,0.598,8.1,2015-16,Regular%20Season
203507,Giannis Antetokounmpo,1610612749,MIL,80,32,48,2823.0,113,74,35,0.655,360,0.314,15,0.328,6.9,499,140,353,0.281,800,0.624,47,0.663,5.9,612,214,388,0.35,1160,0.528,62,0.557,6.1,2015-16,Regular%20Season
203922,Glenn Robinson III,1610612754,IND,30,17,13,398.0,12,6,7,0.5,43,0.279,2,0.293,13.0,56,10,45,0.179,104,0.538,12,0.609,7.2,68,16,52,0.235,147,0.463,14,0.511,8.3,2015-16,Regular%20Season
201609,Goran Dragic,1610612748,MIA,70,43,27,2297.0,54,26,29,0.481,208,0.26,5,0.266,10.1,223,23,203,0.103,405,0.551,36,0.604,10.0,277,49,232,0.177,613,0.452,41,0.484,10.1,2015-16,Regular%20Season
202330,Gordon Hayward,1610612762,UTA,78,37,41,2843.0,61,23,39,0.377,236,0.258,11,0.271,12.1,336,50,284,0.149,533,0.63,45,0.689,8.3,397,73,323,0.184,769,0.516,56,0.557,8.9,2015-16,Regular%20Season
203476,Gorgui Dieng,1610612750,MIN,82,29,53,2220.0,157,97,58,0.618,393,0.399,6,0.406,7.1,428,131,291,0.306,700,0.611,61,0.67,5.4,585,228,349,0.39,1093,0.535,67,0.57,5.8,2015-16,Regular%20Season
202328,Greg Monroe,1610612749,MIL,79,32,47,2314.0,218,156,56,0.716,511,0.427,17,0.441,5.1,478,179,291,0.374,738,0.648,56,0.701,4.6,696,335,347,0.481,1249,0.557,73,0.592,4.7,2015-16,Regular%20Season
202962,Greg Smith,1610612750,MIN,16,7,9,188.0,12,7,6,0.583,36,0.333,1,0.343,8.1,30,6,23,0.2,47,0.638,3,0.682,3.7,42,13,29,0.31,83,0.506,4,0.532,5.1,2015-16,Regular%20Season
202349,Greivis Vasquez,1610612749,MIL,21,9,12,439.0,5,3,3,0.6,29,0.172,0,0.172,21.2,42,6,36,0.143,90,0.467,7,0.506,8.3,47,9,39,0.191,119,0.395,7,0.42,9.7,2015-16,Regular%20Season
203084,Harrison Barnes,1610612744,GSW,65,58,7,2019.0,77,39,35,0.506,206,0.374,9,0.391,9.0,248,59,189,0.238,486,0.51,57,0.578,6.8,325,98,224,0.302,692,0.47,66,0.519,7.3,2015-16,Regular%20Season
202355,Hassan Whiteside,1610612748,MIA,73,42,31,2125.0,238,182,48,0.765,530,0.449,8,0.456,4.2,627,237,385,0.378,955,0.657,53,0.695,4.0,865,419,433,0.484,1485,0.582,61,0.607,4.1,2015-16,Regular%20Season
203156,Henry Sims,1610612751,BKN,14,2,12,263.0,21,14,7,0.667,64,0.328,2,0.339,6.2,51,20,32,0.392,90,0.567,3,0.586,4.5,72,34,39,0.472,154,0.468,5,0.483,5.0,2015-16,Regular%20Season
203138,Hollis Thompson,1610612755,PHI,75,10,65,2109.0,54,24,26,0.444,153,0.353,9,0.375,9.7,218,43,174,0.197,389,0.56,28,0.604,6.9,272,67,200,0.246,542,0.502,37,0.539,7.4,2015-16,Regular%20Season
203546,Ian Clark,1610612744,GSW,40,38,2,422.0,13,7,7,0.538,36,0.361,1,0.371,13.6,55,11,46,0.2,95,0.579,7,0.625,9.1,68,18,53,0.265,131,0.519,8,0.553,10.0,2015-16,Regular%20Season
101133,Ian Mahinmi,1610612754,IND,70,40,30,1810.0,138,77,58,0.558,285,0.484,6,0.495,7.3,369,146,221,0.396,635,0.581,71,0.654,5.2,507,223,279,0.44,920,0.551,77,0.601,5.8,2015-16,Regular%20Season
202697,Iman Shumpert,1610612739,CLE,53,38,15,1299.0,32,17,15,0.531,89,0.36,7,0.39,11.7,171,26,145,0.152,272,0.629,14,0.663,6.6,203,43,160,0.212,361,0.562,21,0.597,7.4,2015-16,Regular%20Season
203477,Isaiah Canaan,1610612755,PHI,66,9,57,1741.0,20,6,14,0.3,93,0.215,4,0.225,12.4,154,16,137,0.104,287,0.537,18,0.572,9.3,174,22,151,0.126,380,0.458,22,0.486,9.7,2015-16,Regular%20Season
202738,Isaiah Thomas,1610612738,BOS,75,44,31,2431.0,46,17,29,0.37,264,0.174,13,0.183,12.5,191,21,171,0.11,366,0.522,28,0.565,10.8,237,38,200,0.16,630,0.376,41,0.402,11.2,2015-16,Regular%20Season
202397,Ish Smith,1610612755,PHI,74,15,59,2215.0,43,13,30,0.302,192,0.224,5,0.23,13.0,262,26,239,0.099,519,0.505,51,0.56,8.3,305,39,269,0.128,711,0.429,56,0.466,8.9,2015-16,Regular%20Season
200826,J.J. Barea,1610612742,DAL,61,34,27,1416.0,26,9,16,0.346,120,0.217,3,0.222,13.2,126,12,115,0.095,220,0.573,13,0.609,10.0,152,21,131,0.138,340,0.447,16,0.469,10.5,2015-16,Regular%20Season
201581,JJ Hickson,1610612764,WAS,29,13,16,423.0,39,25,15,0.641,91,0.429,3,0.443,6.1,93,30,62,0.323,145,0.641,14,0.71,4.2,132,55,77,0.417,236,0.559,17,0.603,4.8,2015-16,Regular%20Season
1626266,JJ O'Brien,1610612762,UTA,1,1,0,4.0,0,0,0,0.0,0,0.0,0,0.0,0.0,1,0,1,0.0,1,1.0,0,1.0,4.6,1,0,1,0.0,1,1.0,0,1.0,4.6,2015-16,Regular%20Season
200755,JJ Redick,1610612746,LAC,64,42,22,1828.0,10,1,9,0.1,70,0.143,2,0.147,19.7,128,12,118,0.094,265,0.483,22,0.527,9.7,138,13,127,0.094,335,0.412,24,0.444,10.4,2015-16,Regular%20Season
2747,JR Smith,1610612739,CLE,70,49,21,2207.0,43,9,31,0.209,107,0.402,6,0.426,16.9,174,19,157,0.109,288,0.604,27,0.667,8.2,217,28,188,0.129,395,0.549,33,0.599,9.9,2015-16,Regular%20Season
203960,JaKarr Sampson,1610612743,DEN,65,16,49,1106.0,46,29,17,0.63,130,0.354,4,0.365,5.8,144,35,111,0.243,270,0.533,22,0.581,6.3,190,64,128,0.337,400,0.475,26,0.508,6.2,2015-16,Regular%20Season
203210,JaMychal Green,1610612763,MEM,73,35,38,1405.0,139,101,32,0.727,292,0.476,13,0.498,5.9,233,69,163,0.296,368,0.633,30,0.689,4.7,372,170,195,0.457,660,0.564,43,0.603,5.1,2015-16,Regular%20Season
201580,JaVale McGee,1610612742,DAL,33,15,18,366.0,53,35,16,0.66,99,0.535,2,0.546,5.0,80,29,49,0.363,135,0.593,9,0.635,4.1,133,64,65,0.481,234,0.568,11,0.596,4.5,2015-16,Regular%20Season
203953,Jabari Parker,1610612749,MIL,76,32,44,2408.0,123,56,64,0.455,340,0.362,10,0.373,7.8,272,63,207,0.232,527,0.516,33,0.551,6.4,395,119,271,0.301,867,0.456,43,0.479,6.9,2015-16,Regular%20Season
203109,Jae Crowder,1610612738,BOS,72,42,30,2278.0,70,28,40,0.4,207,0.338,11,0.357,11.2,300,52,246,0.173,451,0.665,33,0.718,7.2,370,80,286,0.216,658,0.562,44,0.603,8.0,2015-16,Regular%20Season
1626143,Jahlil Okafor,1610612755,PHI,53,6,47,1591.0,122,78,42,0.639,313,0.39,6,0.397,6.1,251,99,151,0.394,471,0.533,50,0.596,4.7,373,177,193,0.475,784,0.476,56,0.512,5.1,2015-16,Regular%20Season
2037,Jamal Crawford,1610612746,LAC,63,42,21,1756.0,19,6,14,0.316,84,0.226,8,0.25,9.8,125,14,112,0.112,240,0.521,15,0.556,10.3,144,20,126,0.139,324,0.444,23,0.478,10.3,2015-16,Regular%20Season
2749,Jameer Nelson,1610612743,DEN,37,11,26,990.0,19,1,18,0.053,56,0.339,0,0.339,18.4,96,14,83,0.146,188,0.511,18,0.565,8.6,115,15,101,0.13,244,0.471,18,0.509,10.2,2015-16,Regular%20Season
202341,James Anderson,1610612758,SAC,37,14,23,623.0,13,6,7,0.462,38,0.342,0,0.342,10.1,72,18,54,0.25,124,0.581,7,0.615,7.4,85,24,61,0.282,162,0.525,7,0.548,7.8,2015-16,Regular%20Season
203516,James Ennis III,1610612740,NOP,13,5,8,304.0,21,10,10,0.476,42,0.5,1,0.512,8.0,21,7,14,0.333,44,0.477,4,0.525,6.6,42,17,24,0.405,86,0.488,5,0.519,7.3,2015-16,Regular%20Season
201935,James Harden,1610612745,HOU,82,41,41,3125.0,63,31,36,0.492,265,0.238,9,0.246,10.3,438,86,352,0.196,652,0.672,42,0.718,7.6,501,117,388,0.234,917,0.546,51,0.579,7.9,2015-16,Regular%20Season
201949,James Johnson,1610612761,TOR,47,28,19,814.0,28,10,17,0.357,89,0.315,3,0.326,8.2,98,19,79,0.194,183,0.536,17,0.59,6.1,126,29,96,0.23,272,0.463,20,0.5,6.6,2015-16,Regular%20Season
2592,James Jones,1610612739,CLE,25,16,9,316.0,8,2,5,0.25,19,0.421,0,0.421,19.6,42,6,36,0.143,65,0.646,4,0.689,7.6,50,8,41,0.16,84,0.595,4,0.625,9.3,2015-16,Regular%20Season
203949,James Michael McAdoo,1610612744,GSW,23,21,2,199.0,30,18,9,0.6,68,0.441,0,0.441,6.7,28,8,20,0.286,58,0.483,7,0.549,6.6,58,26,29,0.448,126,0.46,7,0.487,6.7,2015-16,Regular%20Season
203923,James Young,1610612738,BOS,14,7,7,162.0,4,1,3,0.25,13,0.308,0,0.308,15.8,22,7,16,0.318,31,0.71,2,0.759,6.2,26,8,19,0.308,44,0.591,2,0.619,7.6,2015-16,Regular%20Season
203099,Jared Cunningham,1610612739,CLE,18,12,6,300.0,3,0,3,0.0,25,0.12,3,0.136,15.5,35,8,27,0.229,53,0.66,1,0.673,11.5,38,8,30,0.211,78,0.487,4,0.514,11.8,2015-16,Regular%20Season
201162,Jared Dudley,1610612764,WAS,76,37,39,1993.0,53,25,26,0.472,175,0.303,8,0.317,10.7,232,59,175,0.254,582,0.399,69,0.452,7.6,285,84,201,0.295,757,0.376,77,0.419,8.2,2015-16,Regular%20Season
203096,Jared Sullinger,1610612738,BOS,80,46,34,1900.0,194,129,63,0.665,400,0.485,8,0.495,5.7,476,200,273,0.42,755,0.63,43,0.669,4.6,670,329,336,0.491,1155,0.58,51,0.607,4.9,2015-16,Regular%20Season
204067,Jarell Eddie,1610612764,WAS,10,3,7,114.0,2,1,1,0.5,5,0.4,0,0.4,27.1,21,2,19,0.095,26,0.808,1,0.84,8.5,23,3,20,0.13,31,0.742,1,0.767,10.1,2015-16,Regular%20Season
1626185,Jarell Martin,1610612763,MEM,21,6,15,349.0,39,23,17,0.59,94,0.415,2,0.424,6.1,47,12,37,0.255,98,0.48,11,0.54,5.5,86,35,54,0.407,192,0.448,13,0.48,5.9,2015-16,Regular%20Season
203950,Jarnell Stokes,1610612763,MEM,3,1,2,6.0,1,1,0,1.0,3,0.333,0,0.333,2.9,3,2,1,0.667,4,0.75,0,0.75,2.5,4,3,1,0.75,7,0.571,0,0.571,2.6,2015-16,Regular%20Season
101127,Jarrett Jack,1610612751,BKN,32,10,22,1027.0,9,4,6,0.444,48,0.188,4,0.205,20.2,127,13,117,0.102,214,0.593,24,0.668,8.5,136,17,123,0.125,262,0.519,28,0.581,9.3,2015-16,Regular%20Season
201160,Jason Smith,1610612753,ORL,70,31,39,1096.0,52,27,26,0.519,144,0.361,5,0.374,8.2,162,62,100,0.383,304,0.533,26,0.583,4.9,214,89,126,0.416,448,0.478,31,0.513,5.7,2015-16,Regular%20Season
1891,Jason Terry,1610612745,HOU,42,20,22,795.0,14,2,12,0.143,42,0.333,1,0.341,14.3,65,8,56,0.123,118,0.551,7,0.586,11.1,79,10,68,0.127,160,0.494,8,0.52,11.6,2015-16,Regular%20Season
201574,Jason Thompson,1610612761,TOR,37,31,6,433.0,32,16,15,0.5,77,0.416,2,0.427,6.8,101,25,76,0.248,163,0.62,14,0.678,4.8,133,41,91,0.308,240,0.554,16,0.594,5.2,2015-16,Regular%20Season
201965,Jeff Ayres,1610612746,LAC,13,7,6,99.0,4,4,0,1.0,18,0.222,1,0.235,3.8,18,5,13,0.278,29,0.621,1,0.643,4.3,22,9,13,0.409,47,0.468,2,0.489,4.2,2015-16,Regular%20Season
201145,Jeff Green,1610612746,LAC,77,46,31,2208.0,74,42,29,0.568,214,0.346,8,0.359,9.0,258,67,189,0.26,460,0.561,33,0.604,6.5,332,109,218,0.328,674,0.493,41,0.524,7.0,2015-16,Regular%20Season
201952,Jeff Teague,1610612737,ATL,73,45,28,2084.0,33,16,20,0.485,177,0.186,9,0.196,12.5,180,13,170,0.072,334,0.539,26,0.584,10.3,213,29,190,0.136,511,0.417,35,0.447,10.8,2015-16,Regular%20Season
203481,Jeff Withey,1610612762,UTA,39,17,22,622.0,56,34,21,0.607,144,0.389,8,0.412,5.9,117,41,74,0.35,226,0.518,25,0.582,4.5,173,75,95,0.434,370,0.468,33,0.513,5.0,2015-16,Regular%20Season
203924,Jerami Grant,1610612755,PHI,74,9,65,2020.0,99,56,44,0.566,257,0.385,6,0.394,6.4,262,74,187,0.282,526,0.498,46,0.546,5.6,361,130,231,0.36,783,0.461,52,0.494,5.8,2015-16,Regular%20Season
202379,Jeremy Evans,1610612742,DAL,17,9,8,210.0,11,7,4,0.636,27,0.407,1,0.423,12.0,43,14,29,0.326,64,0.672,6,0.741,4.9,54,21,33,0.389,91,0.593,7,0.643,6.4,2015-16,Regular%20Season
203087,Jeremy Lamb,1610612766,CHA,63,39,24,1216.0,44,23,23,0.523,110,0.4,2,0.407,7.8,208,33,176,0.159,358,0.581,34,0.642,5.6,252,56,199,0.222,468,0.538,36,0.583,6.1,2015-16,Regular%20Season
202391,Jeremy Lin,1610612766,CHA,71,42,29,1910.0,42,13,25,0.31,161,0.261,7,0.273,14.9,211,42,169,0.199,426,0.495,37,0.542,8.3,253,55,194,0.217,587,0.431,44,0.466,9.3,2015-16,Regular%20Season
1626170,Jerian Grant,1610612752,NYK,61,24,37,1111.0,22,6,16,0.273,101,0.218,3,0.224,12.0,119,21,100,0.176,231,0.515,31,0.595,8.3,141,27,116,0.191,332,0.425,34,0.473,8.8,2015-16,Regular%20Season
201573,Jerryd Bayless,1610612749,MIL,50,21,29,1449.0,21,4,17,0.19,65,0.323,4,0.344,19.1,120,15,104,0.125,233,0.515,20,0.563,8.8,141,19,121,0.135,298,0.473,24,0.515,10.3,2015-16,Regular%20Season
202710,Jimmy Butler,1610612741,CHI,67,37,30,2474.0,79,37,37,0.468,251,0.315,6,0.322,8.8,279,58,224,0.208,549,0.508,48,0.557,8.4,358,95,261,0.265,800,0.448,54,0.48,8.4,2015-16,Regular%20Season
201149,Joakim Noah,1610612741,CHI,29,15,14,635.0,87,62,24,0.713,194,0.448,5,0.46,4.4,168,70,100,0.417,273,0.615,17,0.656,4.1,255,132,124,0.518,467,0.546,22,0.573,4.2,2015-16,Regular%20Season
201975,Jodie Meeks,1610612765,DET,2,2,0,37.0,1,0,1,0.0,3,0.333,1,0.5,7.8,4,0,4,0.0,6,0.667,2,1.0,11.6,5,0,5,0.0,9,0.556,3,0.833,10.8,2015-16,Regular%20Season
203925,Joe Harris,1610612739,CLE,2,2,0,8.0,0,0,0,0.0,0,0.0,0,0.0,0.0,3,0,3,0.0,4,0.75,0,0.75,4.1,3,0,3,0.0,4,0.75,0,0.75,4.1,2015-16,Regular%20Season
204060,Joe Ingles,1610612762,UTA,62,30,32,1061.0,19,4,14,0.211,45,0.422,2,0.442,16.0,132,29,100,0.22,214,0.617,15,0.663,8.2,151,33,114,0.219,259,0.583,17,0.624,9.1,2015-16,Regular%20Season
2207,Joe Johnson,1610612748,MIA,76,28,48,2547.0,49,25,23,0.51,171,0.287,8,0.301,10.3,243,34,211,0.14,407,0.597,34,0.651,8.0,292,59,234,0.202,578,0.505,42,0.545,8.4,2015-16,Regular%20Season
1626202,Joe Young,1610612754,IND,24,12,12,308.0,6,0,6,0.0,23,0.261,0,0.261,18.2,44,5,39,0.114,71,0.62,4,0.657,9.1,50,5,45,0.1,94,0.532,4,0.556,10.2,2015-16,Regular%20Season
201202,Joel Anthony,1610612765,DET,10,7,3,72.0,7,5,1,0.714,18,0.389,1,0.412,8.0,13,4,9,0.308,30,0.433,5,0.52,4.9,20,9,10,0.45,48,0.417,6,0.476,5.9,2015-16,Regular%20Season
203530,Joffrey Lauvergne,1610612743,DEN,54,22,32,1016.0,77,47,26,0.61,211,0.365,4,0.372,6.5,213,57,153,0.268,332,0.642,22,0.687,4.3,290,104,179,0.359,543,0.534,26,0.561,4.9,2015-16,Regular%20Season
203089,John Henson,1610612749,MIL,54,22,32,940.0,87,56,30,0.644,183,0.475,5,0.489,4.9,134,65,68,0.485,274,0.489,24,0.536,4.6,221,121,98,0.548,457,0.484,29,0.516,4.7,2015-16,Regular%20Season
203098,John Jenkins,1610612756,PHX,27,10,17,374.0,8,3,5,0.375,22,0.364,2,0.4,13.5,49,7,42,0.143,84,0.583,9,0.653,8.4,57,10,47,0.175,106,0.538,11,0.6,9.1,2015-16,Regular%20Season
202322,John Wall,1610612764,WAS,77,37,40,2784.0,42,11,32,0.262,228,0.184,12,0.194,15.9,337,39,297,0.116,535,0.63,34,0.673,8.6,379,50,329,0.132,763,0.497,46,0.529,9.5,2015-16,Regular%20Season
203948,Johnny O'Bryant III,1610612749,MIL,54,19,35,798.0,65,46,17,0.708,135,0.481,6,0.504,5.0,111,38,75,0.342,212,0.524,14,0.561,6.3,176,84,92,0.477,347,0.507,20,0.538,5.9,2015-16,Regular%20Season
202720,Jon Leuer,1610612756,PHX,66,22,44,1244.0,76,46,27,0.605,194,0.392,6,0.404,6.5,297,82,212,0.276,457,0.65,37,0.707,3.9,373,128,239,0.343,651,0.573,43,0.613,4.4,2015-16,Regular%20Season
201973,Jonas Jerebko,1610612738,BOS,69,40,29,1104.0,74,45,29,0.608,189,0.392,6,0.404,8.3,208,48,159,0.231,336,0.619,22,0.662,5.5,282,93,188,0.33,525,0.537,28,0.567,6.2,2015-16,Regular%20Season
202685,Jonas Valanciunas,1610612761,TOR,59,39,20,1527.0,181,152,28,0.84,413,0.438,4,0.443,4.0,357,127,225,0.356,560,0.638,46,0.695,3.6,538,279,253,0.519,973,0.553,50,0.583,3.8,2015-16,Regular%20Season
203613,Jonathon Simmons,1610612759,SAS,37,30,7,634.0,16,6,10,0.375,56,0.286,4,0.308,16.0,80,14,65,0.175,120,0.667,11,0.734,7.6,96,20,75,0.208,176,0.545,15,0.596,9.0,2015-16,Regular%20Season
203919,Jordan Adams,1610612763,MEM,1,0,1,8.0,0,0,0,0.0,0,0.0,0,0.0,0.0,2,0,2,0.0,2,1.0,0,1.0,11.0,2,0,2,0.0,2,1.0,0,1.0,11.0,2015-16,Regular%20Season
203903,Jordan Clarkson,1610612747,LAL,77,17,60,2493.0,93,46,48,0.495,318,0.292,6,0.298,10.3,220,22,201,0.1,441,0.499,39,0.547,8.6,313,68,249,0.217,759,0.412,45,0.438,9.1,2015-16,Regular%20Season
200770,Jordan Farmar,1610612763,MEM,10,2,8,252.0,4,2,2,0.5,20,0.2,2,0.222,19.0,21,6,15,0.286,36,0.583,1,0.6,8.9,25,8,17,0.32,56,0.446,3,0.472,10.5,2015-16,Regular%20Season
202706,Jordan Hamilton,1610612740,NOP,11,4,7,304.0,12,8,4,0.667,36,0.333,2,0.353,9.7,50,7,43,0.14,88,0.568,9,0.633,5.7,62,15,47,0.242,124,0.5,11,0.549,6.4,2015-16,Regular%20Season
201941,Jordan Hill,1610612754,IND,73,40,33,1513.0,156,105,45,0.673,359,0.435,12,0.45,6.3,295,90,203,0.305,478,0.617,42,0.677,4.5,451,195,248,0.432,837,0.539,54,0.576,5.1,2015-16,Regular%20Season
203895,Jordan McRae,1610612739,CLE,11,3,8,164.0,4,2,3,0.5,13,0.308,0,0.308,9.0,16,0,16,0.0,26,0.615,4,0.727,8.9,20,2,19,0.1,39,0.513,4,0.571,8.9,2015-16,Regular%20Season
1626175,Jordan Mickey,1610612738,BOS,5,3,2,28.0,5,4,1,0.8,13,0.385,1,0.417,2.8,7,2,5,0.286,14,0.5,1,0.538,3.1,12,6,6,0.5,27,0.444,2,0.48,3.0,2015-16,Regular%20Season
203268,Jorge Gutierrez,1610612766,CHA,4,4,0,36.0,0,0,0,0.0,0,0.0,0,0.0,0.0,7,1,6,0.143,8,0.875,0,0.875,7.4,7,1,6,0.143,8,0.875,0,0.875,7.4,2015-16,Regular%20Season
101181,Jose Calderon,1610612752,NYK,65,26,39,1842.0,22,5,16,0.227,82,0.268,5,0.286,18.5,207,24,185,0.116,358,0.578,29,0.629,8.5,229,29,201,0.127,440,0.52,34,0.564,9.5,2015-16,Regular%20Season
203962,Josh Huestis,1610612760,OKC,4,1,3,50.0,2,2,0,1.0,7,0.286,2,0.4,7.8,8,3,5,0.375,13,0.615,2,0.727,5.6,10,5,5,0.5,20,0.5,4,0.625,6.0,2015-16,Regular%20Season
201177,Josh McRoberts,1610612748,MIA,36,22,14,569.0,22,10,12,0.455,48,0.458,1,0.468,8.4,83,28,56,0.337,164,0.506,10,0.539,5.7,105,38,68,0.362,212,0.495,11,0.522,6.3,2015-16,Regular%20Season
1626196,Josh Richardson,1610612748,MIA,44,24,20,1046.0,21,7,14,0.333,77,0.273,2,0.28,16.2,86,17,71,0.198,196,0.439,25,0.503,8.5,107,24,85,0.224,273,0.392,27,0.435,10.0,2015-16,Regular%20Season
2746,Josh Smith,1610612745,HOU,50,28,22,824.0,51,29,17,0.569,116,0.44,5,0.459,7.0,141,63,79,0.447,287,0.491,33,0.555,5.1,192,92,96,0.479,403,0.476,38,0.526,5.6,2015-16,Regular%20Season
201950,Jrue Holiday,1610612740,NOP,59,23,36,1660.0,27,19,9,0.704,133,0.203,7,0.214,9.6,168,27,141,0.161,296,0.568,30,0.632,7.7,195,46,150,0.236,429,0.455,37,0.497,8.0,2015-16,Regular%20Season
203944,Julius Randle,1610612747,LAL,81,17,64,2286.0,172,127,42,0.738,496,0.347,17,0.359,6.1,657,187,465,0.285,981,0.67,70,0.721,4.2,829,314,507,0.379,1477,0.561,87,0.596,4.6,2015-16,Regular%20Season
1626147,Justin Anderson,1610612742,DAL,42,20,22,599.0,18,5,13,0.278,50,0.36,2,0.375,12.2,114,24,89,0.211,168,0.679,12,0.731,4.7,132,29,102,0.22,218,0.606,14,0.647,5.7,2015-16,Regular%20Season
202712,Justin Harper,1610612751,BKN,1,1,0,16.0,0,0,0,0.0,0,0.0,0,0.0,0.0,1,1,0,1.0,1,1.0,0,1.0,4.9,1,1,0,1.0,1,1.0,0,1.0,4.9,2015-16,Regular%20Season
203200,Justin Holiday,1610612741,CHI,41,21,20,698.0,12,3,9,0.25,42,0.286,2,0.3,13.9,77,17,60,0.221,156,0.494,20,0.566,7.5,89,20,69,0.225,198,0.449,22,0.506,8.4,2015-16,Regular%20Season
1626159,Justise Winslow,1610612748,MIA,77,46,31,2209.0,81,43,37,0.531,259,0.313,11,0.327,7.1,322,92,229,0.286,612,0.526,63,0.587,6.0,403,135,266,0.335,871,0.463,74,0.506,6.2,2015-16,Regular%20Season
203994,Jusuf Nurkic,1610612743,DEN,31,14,17,544.0,65,49,16,0.754,157,0.414,1,0.417,4.7,110,35,69,0.318,207,0.531,25,0.604,4.3,175,84,85,0.48,364,0.481,26,0.518,4.5,2015-16,Regular%20Season
203909,KJ McDaniels,1610612745,HOU,20,12,8,192.0,16,9,8,0.563,28,0.571,0,0.571,4.9,26,8,18,0.308,53,0.491,3,0.52,6.8,42,17,26,0.405,81,0.519,3,0.538,6.1,2015-16,Regular%20Season
1626157,Karl-Anthony Towns,1610612750,MIN,82,29,53,2626.0,229,165,61,0.721,515,0.445,9,0.453,5.8,629,242,389,0.385,969,0.649,69,0.699,4.2,858,407,450,0.474,1484,0.578,78,0.61,4.6,2015-16,Regular%20Season
202695,Kawhi Leonard,1610612759,SAS,71,59,12,2350.0,95,41,49,0.432,192,0.495,9,0.519,10.9,398,100,297,0.251,551,0.722,41,0.78,6.4,493,141,346,0.286,743,0.664,50,0.711,7.2,2015-16,Regular%20Season
203951,Keith Appling,1610612753,ORL,1,0,1,6.0,0,0,0,0.0,0,0.0,0,0.0,0.0,1,0,1,0.0,3,0.333,0,0.333,7.9,1,0,1,0.0,3,0.333,0,0.333,7.9,2015-16,Regular%20Season
203482,Kelly Olynyk,1610612738,BOS,63,36,27,1299.0,71,41,29,0.577,213,0.333,8,0.346,6.9,206,48,157,0.233,363,0.567,35,0.628,5.3,277,89,186,0.321,576,0.481,43,0.52,5.7,2015-16,Regular%20Season
1626162,Kelly Oubre Jr.,1610612764,WAS,44,23,21,612.0,25,18,7,0.72,74,0.338,3,0.352,9.4,108,25,83,0.231,180,0.6,14,0.651,5.6,133,43,90,0.323,254,0.524,17,0.561,6.3,2015-16,Regular%20Season
202689,Kemba Walker,1610612766,CHA,80,46,34,2855.0,56,21,34,0.375,229,0.245,12,0.258,12.5,301,30,273,0.1,539,0.558,62,0.631,8.9,357,51,307,0.143,768,0.465,74,0.514,9.4,2015-16,Regular%20Season
203088,Kendall Marshall,1610612755,PHI,16,2,14,242.0,2,2,0,1.0,12,0.167,0,0.167,6.7,26,4,22,0.154,37,0.703,1,0.722,11.5,28,6,22,0.214,49,0.571,1,0.583,11.2,2015-16,Regular%20Season
2570,Kendrick Perkins,1610612740,NOP,33,12,21,527.0,24,15,7,0.625,73,0.329,2,0.338,4.2,103,18,84,0.175,177,0.582,15,0.636,4.8,127,33,91,0.26,250,0.508,17,0.545,4.7,2015-16,Regular%20Season
202702,Kenneth Faried,1610612743,DEN,67,26,41,1694.0,235,163,65,0.694,488,0.482,7,0.489,4.9,346,131,213,0.379,534,0.648,37,0.696,5.0,581,294,278,0.506,1022,0.568,44,0.594,4.9,2015-16,Regular%20Season
203145,Kent Bazemore,1610612737,ATL,72,43,29,2028.0,28,14,13,0.5,129,0.217,6,0.228,9.5,351,49,301,0.14,562,0.625,32,0.662,6.3,379,63,314,0.166,691,0.548,38,0.58,6.5,2015-16,Regular%20Season
203484,Kentavious Caldwell-Pope,1610612765,DET,74,41,33,2738.0,70,32,34,0.457,187,0.374,4,0.383,10.9,212,33,180,0.156,352,0.602,24,0.646,9.0,282,65,214,0.23,539,0.523,28,0.552,9.5,2015-16,Regular%20Season
201142,Kevin Durant,1610612760,OKC,72,52,20,2578.0,45,20,23,0.444,140,0.321,4,0.331,13.8,544,96,446,0.176,724,0.751,28,0.782,6.3,589,116,469,0.197,864,0.682,32,0.708,6.9,2015-16,Regular%20Season
708,Kevin Garnett,1610612750,MIN,35,13,22,532.0,15,8,7,0.533,36,0.417,0,0.417,12.4,134,30,103,0.224,206,0.65,10,0.684,4.8,149,38,110,0.255,242,0.616,10,0.642,5.6,2015-16,Regular%20Season
201567,Kevin Love,1610612739,CLE,77,53,24,2424.0,149,95,47,0.638,338,0.441,9,0.453,7.4,613,173,433,0.282,943,0.65,78,0.709,4.3,762,268,480,0.352,1281,0.595,87,0.638,4.9,2015-16,Regular%20Season
2755,Kevin Martin,1610612759,SAS,42,17,25,922.0,14,4,11,0.286,61,0.23,2,0.237,13.8,96,17,78,0.177,143,0.671,9,0.716,7.4,110,21,89,0.191,204,0.539,11,0.57,8.2,2015-16,Regular%20Season
202338,Kevin Seraphin,1610612752,NYK,41,13,28,473.0,31,19,12,0.613,79,0.392,1,0.397,5.7,95,36,57,0.379,167,0.569,21,0.651,3.9,126,55,69,0.437,246,0.512,22,0.563,4.4,2015-16,Regular%20Season
1626172,Kevon Looney,1610612744,GSW,2,1,1,15.0,4,2,2,0.5,5,0.8,0,0.8,9.1,6,3,3,0.5,7,0.857,0,0.857,8.2,10,5,5,0.5,12,0.833,0,0.833,8.5,2015-16,Regular%20Season
203114,Khris Middleton,1610612749,MIL,75,33,42,2743.0,44,18,28,0.409,155,0.284,6,0.295,12.7,258,45,216,0.174,428,0.603,24,0.639,8.7,302,63,244,0.209,583,0.518,30,0.546,9.4,2015-16,Regular%20Season
2550,Kirk Hinrich,1610612737,ATL,35,18,17,552.0,8,2,6,0.25,41,0.195,1,0.2,18.4,62,8,56,0.129,121,0.512,10,0.559,11.3,70,10,62,0.143,162,0.432,11,0.464,12.1,2015-16,Regular%20Season
202691,Klay Thompson,1610612744,GSW,79,70,9,2640.0,35,13,22,0.371,147,0.238,7,0.25,13.6,271,63,208,0.232,540,0.502,57,0.561,7.5,306,76,230,0.248,687,0.445,64,0.491,8.3,2015-16,Regular%20Season
977,Kobe Bryant,1610612747,LAL,65,13,52,1836.0,41,16,24,0.39,157,0.261,6,0.272,13.4,206,20,189,0.097,319,0.646,21,0.691,7.5,247,36,213,0.146,476,0.519,27,0.55,8.4,2015-16,Regular%20Season
201585,Kosta Koufos,1610612758,SAC,73,31,42,1430.0,167,94,73,0.563,339,0.493,6,0.502,6.2,246,71,176,0.289,419,0.587,40,0.649,4.8,413,165,249,0.4,758,0.545,46,0.58,5.4,2015-16,Regular%20Season
203123,Kostas Papanikolaou,1610612743,DEN,17,8,9,243.0,8,3,4,0.375,36,0.222,0,0.222,9.4,32,9,24,0.281,56,0.571,3,0.604,6.3,40,12,28,0.3,92,0.435,3,0.449,6.9,2015-16,Regular%20Season
2743,Kris Humphries,1610612737,ATL,52,28,24,832.0,57,38,17,0.667,155,0.368,1,0.37,5.7,161,49,112,0.304,296,0.544,27,0.599,4.1,218,87,129,0.399,451,0.483,28,0.515,4.5,2015-16,Regular%20Season
204001,Kristaps Porzingis,1610612752,NYK,72,28,44,2047.0,132,81,50,0.614,265,0.498,5,0.508,7.6,394,122,265,0.31,647,0.609,55,0.666,4.8,526,203,315,0.386,912,0.577,60,0.617,5.5,2015-16,Regular%20Season
203937,Kyle Anderson,1610612759,SAS,71,58,13,1219.0,25,10,14,0.4,77,0.325,1,0.329,9.9,219,52,165,0.237,326,0.672,23,0.723,6.3,244,62,179,0.254,403,0.605,24,0.644,6.6,2015-16,Regular%20Season
2594,Kyle Korver,1610612737,ATL,77,45,32,2327.0,14,2,11,0.143,79,0.177,3,0.184,19.0,245,58,185,0.237,542,0.452,58,0.506,7.0,259,60,196,0.232,621,0.417,61,0.463,7.6,2015-16,Regular%20Season
200768,Kyle Lowry,1610612761,TOR,75,52,23,2772.0,54,28,27,0.519,290,0.186,7,0.191,9.1,303,64,241,0.211,593,0.511,51,0.559,8.4,357,92,268,0.258,883,0.404,58,0.433,8.5,2015-16,Regular%20Season
203124,Kyle O'Quinn,1610612752,NYK,58,24,34,739.0,76,54,21,0.711,150,0.507,5,0.524,6.4,174,76,98,0.437,286,0.608,29,0.677,4.1,250,130,119,0.52,436,0.573,34,0.622,4.8,2015-16,Regular%20Season
202713,Kyle Singler,1610612760,OKC,53,36,17,861.0,50,24,26,0.48,118,0.424,3,0.435,9.1,91,24,65,0.264,176,0.517,17,0.572,7.0,141,48,91,0.34,294,0.48,20,0.515,7.7,2015-16,Regular%20Season
202681,Kyrie Irving,1610612739,CLE,51,36,15,1603.0,43,20,21,0.465,145,0.297,5,0.307,12.6,113,13,99,0.115,232,0.487,23,0.541,8.7,156,33,120,0.212,377,0.414,28,0.447,9.7,2015-16,Regular%20Season
200746,LaMarcus Aldridge,1610612759,SAS,74,61,13,2261.0,176,125,48,0.71,366,0.481,8,0.492,5.0,456,131,319,0.287,632,0.722,43,0.774,5.2,632,256,367,0.405,998,0.633,51,0.667,5.2,2015-16,Regular%20Season
203934,Lamar Patterson,1610612737,ATL,23,16,7,334.0,4,2,3,0.5,16,0.25,0,0.25,7.2,46,10,37,0.217,73,0.63,4,0.667,6.1,50,12,40,0.24,89,0.562,4,0.588,6.4,2015-16,Regular%20Season
202362,Lance Stephenson,1610612763,MEM,62,32,30,1323.0,40,17,21,0.425,129,0.31,6,0.325,6.9,183,38,146,0.208,284,0.644,17,0.685,6.6,223,55,167,0.247,413,0.54,23,0.572,6.7,2015-16,Regular%20Season
202498,Lance Thomas,1610612752,NYK,52,23,29,1169.0,34,13,23,0.382,108,0.315,3,0.324,11.7,97,30,67,0.309,213,0.455,18,0.497,6.8,131,43,90,0.328,321,0.408,21,0.437,8.2,2015-16,Regular%20Season
204038,Langston Galloway,1610612752,NYK,78,31,47,1949.0,43,17,28,0.395,138,0.312,8,0.331,13.4,245,34,211,0.139,417,0.588,33,0.638,8.5,288,51,239,0.177,555,0.519,41,0.56,9.3,2015-16,Regular%20Season
1626204,Larry Nance Jr.,1610612747,LAL,61,14,47,1227.0,101,57,45,0.564,226,0.447,10,0.468,8.1,211,53,159,0.251,387,0.545,28,0.588,5.4,312,110,204,0.353,613,0.509,38,0.543,6.2,2015-16,Regular%20Season
202730,Lavoy Allen,1610612754,IND,78,42,36,1582.0,162,112,49,0.691,370,0.438,8,0.448,5.6,262,97,162,0.37,448,0.585,32,0.63,5.2,424,209,211,0.493,818,0.518,40,0.545,5.3,2015-16,Regular%20Season
2544,LeBron James,1610612739,CLE,76,56,20,2709.0,111,65,42,0.586,306,0.363,11,0.376,7.0,454,96,354,0.211,617,0.736,32,0.776,6.8,565,161,396,0.285,923,0.612,43,0.642,6.9,2015-16,Regular%20Season
2571,Leandro Barbosa,1610612744,GSW,53,46,7,873.0,28,11,20,0.393,84,0.333,4,0.35,14.7,89,11,77,0.124,149,0.597,10,0.64,9.4,117,22,97,0.188,233,0.502,14,0.534,10.7,2015-16,Regular%20Season
203485,Lorenzo Brown,1610612765,DET,4,0,4,43.0,0,0,0,0.0,2,0.0,0,0.0,0.0,7,1,7,0.143,14,0.5,0,0.5,5.6,7,1,7,0.143,16,0.438,0,0.438,5.6,2015-16,Regular%20Season
200811,Lou Amundson,1610612752,NYK,24,8,16,185.0,23,16,6,0.696,51,0.451,1,0.46,9.6,26,9,18,0.346,55,0.473,6,0.531,4.3,49,25,24,0.51,106,0.462,7,0.495,6.7,2015-16,Regular%20Season
101150,Lou Williams,1610612747,LAL,59,12,47,1703.0,31,11,17,0.355,92,0.337,2,0.344,16.8,138,20,119,0.145,229,0.603,15,0.645,9.4,169,31,136,0.183,321,0.526,17,0.556,10.7,2015-16,Regular%20Season
201601,Luc Mbah a Moute,1610612746,LAC,61,43,18,1192.0,60,31,29,0.517,135,0.444,3,0.455,8.4,111,29,79,0.261,247,0.449,26,0.502,7.9,171,60,108,0.351,382,0.448,29,0.484,8.1,2015-16,Regular%20Season
203512,Lucas Nogueira,1610612761,TOR,20,10,10,196.0,18,12,6,0.667,36,0.5,0,0.5,5.4,28,12,16,0.429,50,0.56,3,0.596,4.5,46,24,22,0.522,86,0.535,3,0.554,4.8,2015-16,Regular%20Season
1626242,Luis Montero,1610612757,POR,4,2,2,19.0,0,0,0,0.0,1,0.0,0,0.0,0.0,4,1,3,0.25,5,0.8,0,0.8,13.5,4,1,3,0.25,6,0.667,0,0.667,13.5,2015-16,Regular%20Season
2449,Luis Scola,1610612761,TOR,74,48,26,1600.0,83,45,35,0.542,227,0.366,3,0.371,6.7,275,87,186,0.316,474,0.58,37,0.629,4.5,358,132,221,0.369,701,0.511,40,0.542,5.0,2015-16,Regular%20Season
202337,Luke Babbitt,1610612740,NOP,35,8,27,790.0,25,13,11,0.52,75,0.333,1,0.338,8.3,123,15,105,0.122,182,0.676,12,0.724,5.5,148,28,116,0.189,257,0.576,13,0.607,6.0,2015-16,Regular%20Season
2736,Luol Deng,1610612748,MIA,74,45,29,2394.0,108,64,43,0.593,254,0.425,9,0.441,6.5,335,81,248,0.242,597,0.561,54,0.617,7.1,443,145,291,0.327,851,0.521,63,0.562,7.0,2015-16,Regular%20Season
1938,Manu Ginobili,1610612759,SAS,49,39,10,988.0,26,15,12,0.577,84,0.31,2,0.317,9.4,119,25,94,0.21,199,0.598,14,0.643,8.7,145,40,106,0.276,283,0.512,16,0.543,8.9,2015-16,Regular%20Season
201188,Marc Gasol,1610612763,MEM,52,30,22,1791.0,58,33,25,0.569,148,0.392,3,0.4,7.4,304,117,184,0.385,505,0.602,38,0.651,5.2,362,150,209,0.414,653,0.554,41,0.592,5.6,2015-16,Regular%20Season
1626273,Marcelo Huertas,1610612747,LAL,38,4,34,662.0,17,5,13,0.294,51,0.333,1,0.34,15.1,72,3,67,0.042,123,0.585,2,0.595,11.0,89,8,80,0.09,174,0.511,3,0.52,11.8,2015-16,Regular%20Season
101162,Marcin Gortat,1610612764,WAS,75,35,40,2256.0,222,139,80,0.626,487,0.456,14,0.469,6.6,519,139,375,0.268,877,0.592,87,0.657,4.3,741,278,455,0.375,1364,0.543,101,0.587,5.0,2015-16,Regular%20Season
201158,Marco Belinelli,1610612758,SAC,51,22,29,1292.0,10,2,8,0.2,54,0.185,1,0.189,19.1,104,14,90,0.135,193,0.539,19,0.598,7.7,114,16,98,0.14,247,0.462,20,0.502,8.7,2015-16,Regular%20Season
202694,Marcus Morris Sr.,1610612765,DET,80,42,38,2856.0,91,47,38,0.516,273,0.333,4,0.338,9.1,313,75,235,0.24,537,0.583,42,0.632,6.4,404,122,273,0.302,810,0.499,46,0.529,7.0,2015-16,Regular%20Season
203935,Marcus Smart,1610612738,BOS,61,36,25,1667.0,76,46,30,0.605,219,0.347,8,0.36,7.5,179,43,137,0.24,302,0.593,27,0.651,7.4,255,89,167,0.349,521,0.489,35,0.525,7.4,2015-16,Regular%20Season
201977,Marcus Thornton,1610612764,WAS,51,28,23,976.0,38,17,22,0.447,119,0.319,5,0.333,9.6,112,14,97,0.125,197,0.569,23,0.644,8.1,150,31,119,0.207,316,0.475,28,0.521,8.5,2015-16,Regular%20Season
201596,Mario Chalmers,1610612748,MIA,55,35,20,1249.0,24,11,16,0.458,85,0.282,3,0.293,7.5,133,17,117,0.128,234,0.568,13,0.602,8.6,157,28,133,0.178,319,0.492,16,0.518,8.6,2015-16,Regular%20Season
1626209,Mario Hezonja,1610612753,ORL,59,23,36,1187.0,28,16,12,0.571,80,0.35,1,0.354,7.5,146,24,124,0.164,233,0.627,17,0.676,5.9,174,40,136,0.23,313,0.556,18,0.59,6.2,2015-16,Regular%20Season
203900,Markel Brown,1610612751,BKN,42,9,33,789.0,23,7,14,0.304,79,0.291,3,0.303,9.7,99,14,85,0.141,168,0.589,13,0.639,7.3,122,21,99,0.172,247,0.494,16,0.528,7.7,2015-16,Regular%20Season
202693,Markieff Morris,1610612764,WAS,64,22,42,1629.0,73,38,32,0.521,180,0.406,7,0.422,8.2,279,88,189,0.315,408,0.684,32,0.742,5.7,352,126,221,0.358,588,0.599,39,0.641,6.2,2015-16,Regular%20Season
201578,Marreese Speights,1610612744,GSW,66,58,8,802.0,77,51,23,0.662,182,0.423,3,0.43,5.4,162,64,96,0.395,286,0.566,20,0.609,4.6,239,115,119,0.481,468,0.511,23,0.537,4.9,2015-16,Regular%20Season
101107,Marvin Williams,1610612766,CHA,79,46,33,2303.0,127,78,43,0.614,246,0.516,4,0.525,7.5,394,95,297,0.241,658,0.599,42,0.64,5.6,521,173,340,0.332,904,0.576,46,0.607,6.0,2015-16,Regular%20Season
203486,Mason Plumlee,1610612757,POR,81,43,38,2062.0,201,133,64,0.662,492,0.409,10,0.417,6.9,427,140,284,0.328,750,0.569,65,0.623,4.4,628,273,348,0.435,1242,0.506,75,0.538,5.2,2015-16,Regular%20Season
2440,Matt Barnes,1610612763,MEM,73,37,36,2115.0,84,45,33,0.536,229,0.367,9,0.382,7.4,336,60,268,0.179,503,0.668,29,0.709,6.1,420,105,301,0.25,732,0.574,38,0.605,6.3,2015-16,Regular%20Season
2588,Matt Bonner,1610612759,SAS,16,15,1,152.0,3,1,2,0.333,12,0.25,0,0.25,12.8,24,5,19,0.208,38,0.632,4,0.706,5.8,27,6,21,0.222,50,0.54,4,0.587,6.6,2015-16,Regular%20Season
203521,Matthew Dellavedova,1610612739,CLE,64,45,19,1601.0,33,12,21,0.364,111,0.297,3,0.306,15.3,129,20,112,0.155,268,0.481,25,0.531,10.0,162,32,133,0.198,379,0.427,28,0.462,11.1,2015-16,Regular%20Season
203090,Maurice Harkless,1610612757,POR,73,38,35,1391.0,101,57,41,0.564,220,0.459,4,0.468,7.8,179,49,129,0.274,314,0.57,27,0.624,5.5,280,106,170,0.379,534,0.524,31,0.557,6.3,2015-16,Regular%20Season
1897,Metta World Peace,1610612747,LAL,32,5,27,552.0,19,13,6,0.684,72,0.264,2,0.271,7.4,70,9,62,0.129,127,0.551,10,0.598,7.9,89,22,68,0.247,199,0.447,12,0.476,7.8,2015-16,Regular%20Season
203086,Meyers Leonard,1610612757,POR,58,30,28,1291.0,51,32,21,0.627,121,0.421,4,0.436,6.5,263,75,184,0.285,400,0.658,21,0.694,4.2,314,107,205,0.341,521,0.603,25,0.633,4.6,2015-16,Regular%20Season
201563,Michael Beasley,1610612745,HOU,19,10,9,358.0,29,21,8,0.724,71,0.408,1,0.414,4.7,69,29,40,0.42,114,0.605,9,0.657,4.5,98,50,48,0.51,185,0.53,10,0.56,4.6,2015-16,Regular%20Season
203487,Michael Carter-Williams,1610612749,MIL,53,21,32,1622.0,48,35,15,0.729,172,0.279,6,0.289,6.9,228,53,176,0.232,396,0.576,34,0.63,7.2,276,88,191,0.319,568,0.486,40,0.523,7.2,2015-16,Regular%20Season
203077,Michael Kidd-Gilchrist,1610612766,CHA,6,4,2,178.0,12,10,1,0.833,33,0.364,2,0.387,5.9,33,10,23,0.303,51,0.647,5,0.717,5.1,45,20,24,0.444,84,0.536,7,0.584,5.3,2015-16,Regular%20Season
201144,Mike Conley,1610612763,MEM,54,32,22,1706.0,26,8,18,0.308,106,0.245,3,0.252,13.3,138,19,124,0.138,284,0.486,26,0.535,9.6,164,27,142,0.165,390,0.421,29,0.454,10.1,2015-16,Regular%20Season
2399,Mike Dunleavy,1610612741,CHI,27,11,16,635.0,8,6,1,0.75,43,0.186,1,0.19,4.0,75,15,62,0.2,153,0.49,21,0.568,6.1,83,21,63,0.253,196,0.423,22,0.477,5.9,2015-16,Regular%20Season
2034,Mike Miller,1610612743,DEN,24,7,17,279.0,5,1,4,0.2,11,0.455,1,0.5,12.6,47,6,41,0.128,80,0.588,2,0.603,6.0,52,7,45,0.135,91,0.571,3,0.591,6.6,2015-16,Regular%20Season
203488,Mike Muscala,1610612737,ATL,46,27,19,510.0,38,24,13,0.632,83,0.458,1,0.463,4.3,79,31,44,0.392,174,0.454,17,0.503,4.6,117,55,57,0.47,257,0.455,18,0.49,4.5,2015-16,Regular%20Season
203118,Mike Scott,1610612737,ATL,70,44,26,1095.0,53,34,19,0.642,140,0.379,1,0.381,6.1,153,41,113,0.268,298,0.513,22,0.554,6.7,206,75,132,0.364,438,0.47,23,0.496,6.6,2015-16,Regular%20Season
203101,Miles Plumlee,1610612749,MIL,52,18,34,838.0,94,53,39,0.564,188,0.5,8,0.522,6.0,138,43,93,0.312,270,0.511,25,0.563,4.9,232,96,132,0.414,458,0.507,33,0.546,5.3,2015-16,Regular%20Season
203141,Mirza Teletovic,1610612756,PHX,72,20,52,1625.0,55,29,25,0.527,165,0.333,7,0.348,8.3,247,81,168,0.328,437,0.565,38,0.619,4.8,302,110,193,0.364,602,0.502,45,0.542,5.4,2015-16,Regular%20Season
203956,Mitch McGary,1610612760,OKC,10,9,1,51.0,4,2,1,0.5,10,0.4,0,0.4,6.0,14,2,11,0.143,22,0.636,2,0.7,5.5,18,4,12,0.222,32,0.563,2,0.6,5.6,2015-16,Regular%20Season
2590,Mo Williams,1610612739,CLE,32,23,9,671.0,6,1,7,0.167,37,0.162,3,0.176,10.7,66,3,66,0.045,120,0.55,9,0.595,10.9,72,4,73,0.056,157,0.459,12,0.497,11.3,2015-16,Regular%20Season
101145,Monta Ellis,1610612754,IND,75,42,33,2564.0,42,16,29,0.381,165,0.255,7,0.266,15.3,229,22,206,0.096,414,0.553,26,0.59,8.8,271,38,235,0.14,579,0.468,33,0.496,10.0,2015-16,Regular%20Season
1626149,Montrezl Harrell,1610612745,HOU,27,11,16,316.0,25,11,12,0.44,53,0.472,0,0.472,7.2,39,16,23,0.41,65,0.6,1,0.609,6.3,64,27,35,0.422,118,0.542,1,0.547,6.7,2015-16,Regular%20Season
1626167,Myles Turner,1610612754,IND,57,29,28,1358.0,68,46,20,0.676,189,0.36,4,0.368,6.7,264,106,158,0.402,513,0.515,42,0.561,4.5,332,152,178,0.458,702,0.473,46,0.506,5.0,2015-16,Regular%20Season
1737,Nazr Mohammed,1610612760,OKC,3,3,0,14.0,1,1,0,1.0,1,1.0,0,1.0,2.7,3,2,1,0.667,5,0.6,1,0.75,3.4,4,3,1,0.75,6,0.667,1,0.8,3.2,2015-16,Regular%20Season
202357,Nemanja Bjelica,1610612750,MIN,50,17,33,984.0,49,36,12,0.735,106,0.462,3,0.476,7.7,161,49,113,0.304,289,0.557,25,0.61,4.8,210,85,125,0.405,395,0.532,28,0.572,5.5,2015-16,Regular%20Season
2403,Nene,1610612764,WAS,56,28,28,1079.0,52,38,14,0.731,152,0.342,2,0.347,7.3,207,64,142,0.309,349,0.593,43,0.676,5.0,259,102,156,0.394,501,0.517,45,0.568,5.4,2015-16,Regular%20Season
203457,Nerlens Noel,1610612755,PHI,67,10,57,1965.0,154,101,50,0.656,380,0.405,14,0.421,6.4,388,119,266,0.307,683,0.568,64,0.627,4.0,542,220,316,0.406,1063,0.51,78,0.55,4.6,2015-16,Regular%20Season
2555,Nick Collison,1610612760,OKC,45,30,15,583.0,68,52,16,0.765,133,0.511,3,0.523,6.1,103,30,72,0.291,176,0.585,17,0.648,5.1,171,82,88,0.48,309,0.553,20,0.592,5.5,2015-16,Regular%20Season
201156,Nick Young,1610612747,LAL,43,10,33,869.0,14,3,11,0.214,56,0.25,1,0.255,15.8,83,22,61,0.265,174,0.477,12,0.512,7.2,97,25,72,0.258,230,0.422,13,0.447,8.4,2015-16,Regular%20Season
201587,Nicolas Batum,1610612766,CHA,69,41,28,2427.0,55,24,31,0.436,201,0.274,7,0.284,11.8,373,59,314,0.158,566,0.659,30,0.696,6.4,428,83,345,0.194,767,0.558,37,0.586,7.1,2015-16,Regular%20Season
203917,Nik Stauskas,1610612755,PHI,65,7,58,1677.0,23,8,14,0.348,103,0.223,3,0.23,12.9,159,20,138,0.126,280,0.568,22,0.616,7.4,182,28,152,0.154,383,0.475,25,0.508,8.1,2015-16,Regular%20Season
203999,Nikola Jokic,1610612743,DEN,79,30,49,1729.0,181,124,52,0.685,421,0.43,8,0.438,5.5,379,146,232,0.385,642,0.59,57,0.648,4.3,560,270,284,0.482,1063,0.527,65,0.561,4.7,2015-16,Regular%20Season
202703,Nikola Mirotic,1610612741,CHI,65,37,28,1622.0,58,31,28,0.534,153,0.379,1,0.382,7.1,304,71,230,0.234,510,0.596,40,0.647,5.0,362,102,258,0.282,663,0.546,41,0.582,5.4,2015-16,Regular%20Season
201593,Nikola Pekovic,1610612750,MIN,10,0,10,136.0,7,6,1,0.857,22,0.318,2,0.35,3.7,14,4,9,0.286,29,0.483,6,0.609,5.6,21,10,10,0.476,51,0.412,8,0.488,4.9,2015-16,Regular%20Season
202696,Nikola Vucevic,1610612753,ORL,64,28,36,1998.0,172,99,66,0.576,347,0.496,11,0.512,6.5,393,154,241,0.392,635,0.619,53,0.675,4.3,565,253,307,0.448,982,0.575,64,0.615,4.9,2015-16,Regular%20Season
203943,Noah Vonleh,1610612757,POR,73,39,34,1124.0,91,60,30,0.659,227,0.401,7,0.414,6.0,214,72,140,0.336,344,0.622,35,0.693,4.5,305,132,170,0.433,571,0.534,42,0.577,4.9,2015-16,Regular%20Season
1626181,Norman Powell,1610612761,TOR,38,25,13,700.0,16,5,11,0.313,54,0.296,3,0.314,16.6,94,14,80,0.149,155,0.606,13,0.662,8.0,110,19,91,0.173,209,0.526,16,0.57,9.3,2015-16,Regular%20Season
202708,Norris Cole,1610612740,NOP,42,18,24,1149.0,10,1,9,0.1,59,0.169,2,0.175,17.7,141,22,119,0.156,221,0.638,23,0.712,9.3,151,23,128,0.152,280,0.539,25,0.592,9.9,2015-16,Regular%20Season
201564,O.J. Mayo,1610612749,MIL,36,16,20,1007.0,13,3,9,0.231,51,0.255,1,0.26,13.7,92,15,78,0.163,179,0.514,15,0.561,8.7,105,18,87,0.171,230,0.457,16,0.491,9.3,2015-16,Regular%20Season
201600,Omer Asik,1610612740,NOP,66,28,38,1169.0,120,81,32,0.675,268,0.448,2,0.451,5.5,294,98,195,0.333,475,0.619,46,0.685,4.1,414,179,227,0.432,743,0.557,48,0.596,4.5,2015-16,Regular%20Season
201956,Omri Casspi,1610612758,SAC,69,27,42,1880.0,58,28,29,0.483,203,0.286,8,0.297,8.0,352,68,285,0.193,609,0.578,53,0.633,4.8,410,96,314,0.234,812,0.505,61,0.546,5.2,2015-16,Regular%20Season
203111,Orlando Johnson,1610612740,NOP,6,1,5,97.0,4,2,3,0.5,11,0.364,0,0.364,7.1,11,1,10,0.091,30,0.367,3,0.407,6.9,15,3,13,0.2,41,0.366,3,0.395,7.0,2015-16,Regular%20Season
203490,Otto Porter Jr.,1610612764,WAS,74,36,38,2255.0,97,54,42,0.557,284,0.342,9,0.353,8.1,294,76,217,0.259,497,0.592,33,0.634,5.4,391,130,259,0.332,781,0.501,42,0.529,6.0,2015-16,Regular%20Season
200782,P.J. Tucker,1610612756,PHX,80,22,58,2500.0,165,100,58,0.606,419,0.394,17,0.41,7.2,347,81,264,0.233,482,0.72,39,0.783,6.3,512,181,322,0.354,901,0.568,56,0.606,6.6,2015-16,Regular%20Season
203798,PJ Hairston,1610612763,MEM,55,24,31,1186.0,25,11,15,0.44,92,0.272,2,0.278,11.2,148,27,121,0.182,256,0.578,18,0.622,6.9,173,38,136,0.22,348,0.497,20,0.527,7.5,2015-16,Regular%20Season
203143,Pablo Prigioni,1610612746,LAC,45,32,13,688.0,38,13,26,0.342,89,0.427,2,0.437,13.8,76,11,66,0.145,133,0.571,9,0.613,8.6,114,24,92,0.211,222,0.514,11,0.54,10.3,2015-16,Regular%20Season
1626192,Pat Connaughton,1610612757,POR,15,8,7,92.0,11,3,7,0.273,16,0.688,0,0.688,8.1,21,4,18,0.19,34,0.618,1,0.636,5.9,32,7,25,0.219,50,0.64,1,0.653,6.6,2015-16,Regular%20Season
201976,Patrick Beverley,1610612745,HOU,65,35,30,1899.0,73,37,35,0.507,181,0.403,5,0.415,9.7,177,28,146,0.158,332,0.533,29,0.584,8.8,250,65,181,0.26,513,0.487,34,0.522,9.1,2015-16,Regular%20Season
202335,Patrick Patterson,1610612761,TOR,74,49,25,1897.0,76,42,31,0.553,142,0.535,3,0.547,8.5,259,73,184,0.282,476,0.544,27,0.577,6.2,335,115,215,0.343,618,0.542,30,0.57,6.7,2015-16,Regular%20Season
201988,Patty Mills,1610612759,SAS,63,52,11,1306.0,26,4,23,0.154,78,0.333,1,0.338,15.5,131,9,122,0.069,209,0.627,13,0.668,10.1,157,13,145,0.083,287,0.547,14,0.575,11.1,2015-16,Regular%20Season
2200,Pau Gasol,1610612741,CHI,72,36,36,2291.0,155,108,45,0.697,336,0.461,10,0.475,6.1,638,215,416,0.337,1035,0.616,85,0.672,4.4,793,323,461,0.407,1371,0.578,95,0.621,4.7,2015-16,Regular%20Season
202331,Paul George,1610612754,IND,81,44,37,2819.0,79,36,44,0.456,261,0.303,4,0.307,11.2,484,81,404,0.167,773,0.626,60,0.679,6.3,563,117,448,0.208,1034,0.544,64,0.58,7.0,2015-16,Regular%20Season
200794,Paul Millsap,1610612737,ATL,80,47,33,2622.0,198,138,61,0.697,450,0.44,9,0.449,7.3,534,172,361,0.322,933,0.572,75,0.622,4.9,732,310,422,0.423,1383,0.529,84,0.564,5.5,2015-16,Regular%20Season
1718,Paul Pierce,1610612746,LAC,59,40,19,1126.0,12,3,9,0.25,50,0.24,3,0.255,16.6,172,53,116,0.308,338,0.509,33,0.564,5.5,184,56,125,0.304,388,0.474,36,0.523,6.3,2015-16,Regular%20Season
203515,Phil Pressey,1610612757,POR,13,1,12,195.0,3,0,3,0.0,14,0.214,1,0.231,19.9,27,2,26,0.074,45,0.6,1,0.614,11.3,30,2,29,0.067,59,0.508,2,0.526,12.2,2015-16,Regular%20Season
203112,Quincy Acy,1610612758,SAC,51,18,33,822.0,64,39,22,0.609,155,0.413,6,0.43,5.7,123,30,91,0.244,218,0.564,21,0.624,4.4,187,69,113,0.369,373,0.501,27,0.54,4.9,2015-16,Regular%20Season
1626154,RJ Hunter,1610612738,BOS,16,11,5,199.0,2,0,2,0.0,7,0.286,0,0.286,15.6,34,6,28,0.176,49,0.694,1,0.708,8.1,36,6,30,0.167,56,0.643,1,0.655,8.5,2015-16,Regular%20Season
200765,Rajon Rondo,1610612758,SAC,71,29,42,2513.0,77,30,43,0.39,282,0.273,10,0.283,12.0,355,38,315,0.107,628,0.565,50,0.614,8.7,432,68,358,0.157,910,0.475,60,0.508,9.2,2015-16,Regular%20Season
1626176,Rakeem Christmas,1610612754,IND,1,1,0,6.0,1,0,1,0.0,1,1.0,0,1.0,6.5,0,0,0,0.0,1,0.0,0,0.0,0.0,1,0,1,0.0,2,0.5,0,0.5,6.5,2015-16,Regular%20Season
201196,Ramon Sessions,1610612764,WAS,73,36,37,1535.0,25,6,19,0.24,117,0.214,3,0.219,16.0,178,17,160,0.096,270,0.659,15,0.698,9.2,203,23,179,0.113,387,0.525,18,0.55,10.0,2015-16,Regular%20Season
200751,Randy Foye,1610612760,OKC,64,31,33,1366.0,24,4,18,0.167,96,0.25,3,0.258,19.2,132,26,106,0.197,240,0.55,17,0.592,8.9,156,30,124,0.192,336,0.464,20,0.494,10.3,2015-16,Regular%20Season
1626173,Rashad Vaughn,1610612749,MIL,45,21,24,726.0,11,6,6,0.545,45,0.244,0,0.244,9.8,77,19,58,0.247,146,0.527,10,0.566,6.3,88,25,64,0.284,191,0.461,10,0.486,6.8,2015-16,Regular%20Season
2446,Rasual Butler,1610612759,SAS,28,24,4,346.0,3,2,1,0.667,15,0.2,2,0.231,12.0,52,11,42,0.212,85,0.612,9,0.684,6.7,55,13,43,0.236,100,0.55,11,0.618,7.0,2015-16,Regular%20Season
203526,Raul Neto,1610612762,UTA,65,32,33,1247.0,17,3,14,0.176,71,0.239,2,0.246,20.2,103,14,90,0.136,201,0.512,9,0.536,10.5,120,17,104,0.142,272,0.441,11,0.46,11.9,2015-16,Regular%20Season
203492,Ray McCallum,1610612759,SAS,19,11,8,329.0,8,2,6,0.25,30,0.267,1,0.276,13.3,38,6,31,0.158,72,0.528,6,0.576,9.8,46,8,37,0.174,102,0.451,7,0.484,10.4,2015-16,Regular%20Season
101109,Raymond Felton,1610612742,DAL,77,38,39,2139.0,36,17,19,0.472,135,0.267,11,0.29,11.7,222,29,193,0.131,411,0.54,32,0.586,7.8,258,46,212,0.178,546,0.473,43,0.513,8.4,2015-16,Regular%20Season
203493,Reggie Bullock Jr.,1610612765,DET,22,14,8,379.0,14,5,8,0.357,40,0.35,2,0.368,10.7,54,7,45,0.13,88,0.614,13,0.72,5.7,68,12,53,0.176,128,0.531,15,0.602,6.7,2015-16,Regular%20Season
202704,Reggie Jackson,1610612765,DET,75,42,33,2308.0,58,28,32,0.483,199,0.291,7,0.302,10.9,195,21,173,0.108,397,0.491,38,0.543,8.9,253,49,205,0.194,596,0.424,45,0.459,9.4,2015-16,Regular%20Season
2210,Richard Jefferson,1610612739,CLE,55,36,19,1058.0,15,5,10,0.333,75,0.2,2,0.205,12.7,113,21,91,0.186,215,0.526,19,0.577,6.2,128,26,101,0.203,290,0.441,21,0.476,7.0,2015-16,Regular%20Season
1626158,Richaun Holmes,1610612755,PHI,44,6,38,658.0,62,44,17,0.71,150,0.413,5,0.428,5.4,73,29,44,0.397,178,0.41,19,0.459,5.0,135,73,61,0.541,328,0.412,24,0.444,5.2,2015-16,Regular%20Season
201937,Ricky Rubio,1610612750,MIN,75,28,47,2289.0,40,6,34,0.15,148,0.27,10,0.29,15.3,286,45,239,0.157,487,0.587,42,0.643,9.5,326,51,273,0.156,635,0.513,52,0.559,10.2,2015-16,Regular%20Season
203496,Robert Covington,1610612755,PHI,66,10,56,1894.0,65,38,26,0.585,201,0.323,3,0.328,8.8,354,94,256,0.266,553,0.64,43,0.694,4.8,419,132,282,0.315,754,0.556,46,0.592,5.4,2015-16,Regular%20Season
203135,Robert Sacre,1610612747,LAL,22,1,21,296.0,32,19,12,0.594,78,0.41,2,0.421,5.9,40,13,29,0.325,78,0.513,12,0.606,5.8,72,32,41,0.444,156,0.462,14,0.507,5.8,2015-16,Regular%20Season
201577,Robin Lopez,1610612752,NYK,81,32,49,2200.0,268,202,58,0.754,543,0.494,9,0.502,4.7,334,140,191,0.419,670,0.499,61,0.548,5.2,602,342,249,0.568,1213,0.496,70,0.527,5.0,2015-16,Regular%20Season
203918,Rodney Hood,1610612762,UTA,74,37,37,2409.0,38,13,25,0.342,144,0.264,6,0.275,12.8,229,34,195,0.148,420,0.545,41,0.604,8.4,267,47,220,0.176,564,0.473,47,0.516,9.1,2015-16,Regular%20Season
201155,Rodney Stuckey,1610612754,IND,53,32,21,1200.0,19,6,13,0.316,82,0.232,2,0.238,14.4,137,30,108,0.219,224,0.612,10,0.64,8.3,156,36,121,0.231,306,0.51,12,0.531,9.1,2015-16,Regular%20Season
1626178,Rondae Hollis-Jefferson,1610612751,BKN,28,7,21,611.0,39,22,15,0.564,87,0.448,2,0.459,8.4,115,32,84,0.278,190,0.605,17,0.665,5.6,154,54,99,0.351,277,0.556,19,0.597,6.2,2015-16,Regular%20Season
101179,Ronnie Price,1610612756,PHX,43,12,31,918.0,25,9,16,0.36,75,0.333,2,0.342,13.9,74,6,70,0.081,122,0.607,8,0.649,11.7,99,15,86,0.152,197,0.503,10,0.529,12.2,2015-16,Regular%20Season
201579,Roy Hibbert,1610612747,LAL,80,17,63,1862.0,132,86,42,0.652,349,0.378,13,0.393,4.8,266,85,180,0.32,542,0.491,54,0.545,5.3,398,171,222,0.43,891,0.447,67,0.483,5.1,2015-16,Regular%20Season
200752,Rudy Gay,1610612758,SAC,69,29,40,2348.0,103,65,31,0.631,302,0.341,11,0.354,6.0,346,89,261,0.257,528,0.655,30,0.695,6.2,449,154,292,0.343,830,0.541,41,0.569,6.2,2015-16,Regular%20Season
203497,Rudy Gobert,1610612762,UTA,61,33,28,1932.0,208,147,61,0.707,475,0.438,11,0.448,5.1,460,132,326,0.287,747,0.616,54,0.664,3.8,668,279,387,0.418,1222,0.547,65,0.577,4.2,2015-16,Regular%20Season
203893,Russ Smith,1610612763,MEM,5,1,4,41.0,1,0,1,0.0,6,0.167,1,0.2,17.9,8,0,7,0.0,9,0.889,0,0.889,11.6,9,0,8,0.0,15,0.6,1,0.643,12.4,2015-16,Regular%20Season
201566,Russell Westbrook,1610612760,OKC,80,55,25,2749.0,145,72,70,0.497,422,0.344,11,0.353,8.7,481,79,403,0.164,739,0.651,42,0.69,7.3,626,151,473,0.241,1161,0.539,53,0.565,7.6,2015-16,Regular%20Season
201583,Ryan Anderson,1610612740,NOP,66,24,42,2008.0,131,94,32,0.718,316,0.415,3,0.419,4.6,265,104,165,0.392,480,0.552,46,0.611,5.2,396,198,197,0.5,796,0.497,49,0.53,5.0,2015-16,Regular%20Season
200797,Ryan Hollins,1610612763,MEM,32,15,17,446.0,47,29,16,0.617,119,0.395,5,0.412,6.9,51,17,34,0.333,136,0.375,17,0.429,4.8,98,46,50,0.469,255,0.384,22,0.421,5.8,2015-16,Regular%20Season
203527,Ryan Kelly,1610612747,LAL,33,2,31,460.0,21,7,14,0.333,58,0.362,4,0.389,8.6,100,26,72,0.26,140,0.714,8,0.758,4.8,121,33,86,0.273,198,0.611,12,0.651,5.5,2015-16,Regular%20Season
1626257,Salah Mejri,1610612742,DAL,28,13,15,388.0,41,23,14,0.561,82,0.5,1,0.506,6.8,82,30,52,0.366,147,0.558,11,0.603,4.7,123,53,66,0.431,229,0.537,12,0.567,5.4,2015-16,Regular%20Season
1626155,Sam Dekker,1610612745,HOU,1,0,1,5.0,0,0,0,0.0,0,0.0,0,0.0,0.0,1,0,1,0.0,1,1.0,0,1.0,13.8,1,0,1,0.0,1,1.0,0,1.0,13.8,2015-16,Regular%20Season
201619,Sasha Kaun,1610612739,CLE,12,8,4,72.0,12,8,3,0.667,27,0.444,0,0.444,5.5,14,4,10,0.286,24,0.583,2,0.636,7.7,26,12,13,0.462,51,0.51,2,0.531,6.7,2015-16,Regular%20Season
2756,Sasha Vujacic,1610612752,NYK,48,16,32,844.0,26,10,17,0.385,67,0.388,3,0.406,15.8,123,18,105,0.146,212,0.58,21,0.644,8.4,149,28,122,0.188,279,0.534,24,0.584,9.7,2015-16,Regular%20Season
203930,Sean Kilpatrick,1610612751,BKN,24,5,19,542.0,12,4,7,0.333,50,0.24,0,0.24,11.1,44,1,44,0.023,69,0.638,5,0.688,7.7,56,5,51,0.089,119,0.471,5,0.491,8.4,2015-16,Regular%20Season
201586,Serge Ibaka,1610612760,OKC,78,54,24,2500.0,141,83,53,0.589,298,0.473,11,0.491,7.6,392,115,273,0.293,741,0.529,69,0.583,4.8,533,198,326,0.371,1039,0.513,80,0.556,5.5,2015-16,Regular%20Season
203508,Sergey Karasev,1610612751,BKN,26,9,17,312.0,8,3,4,0.375,25,0.32,0,0.32,5.6,50,15,35,0.3,85,0.588,7,0.641,7.0,58,18,39,0.31,110,0.527,7,0.563,6.9,2015-16,Regular%20Season
203552,Seth Curry,1610612758,SAC,27,10,17,569.0,9,3,6,0.333,43,0.209,2,0.22,20.3,49,5,44,0.102,101,0.485,6,0.516,12.2,58,8,50,0.138,144,0.403,8,0.426,13.4,2015-16,Regular%20Season
203498,Shabazz Muhammad,1610612750,MIN,75,27,48,1565.0,100,57,42,0.57,246,0.407,8,0.42,6.3,167,56,110,0.335,289,0.578,16,0.612,7.0,267,113,152,0.423,535,0.499,24,0.523,6.7,2015-16,Regular%20Season
203894,Shabazz Napier,1610612753,ORL,32,15,17,395.0,9,2,7,0.222,23,0.391,0,0.391,11.9,46,7,38,0.152,62,0.742,6,0.821,8.9,55,9,45,0.164,85,0.647,6,0.696,9.4,2015-16,Regular%20Season
203499,Shane Larkin,1610612751,BKN,67,16,51,1537.0,28,6,25,0.214,101,0.277,6,0.295,16.0,152,13,141,0.086,265,0.574,20,0.62,8.5,180,19,166,0.106,366,0.492,26,0.529,9.7,2015-16,Regular%20Season
2733,Shaun Livingston,1610612744,GSW,72,63,9,1415.0,42,18,25,0.429,138,0.304,5,0.316,11.6,126,31,94,0.246,256,0.492,11,0.514,8.0,168,49,119,0.292,394,0.426,16,0.444,9.0,2015-16,Regular%20Season
203963,Shayne Whittington,1610612754,IND,5,4,1,35.0,5,4,2,0.8,10,0.5,0,0.5,5.1,7,3,4,0.429,13,0.538,0,0.538,4.0,12,7,6,0.583,23,0.522,0,0.522,4.5,2015-16,Regular%20Season
202714,Shelvin Mack,1610612762,UTA,40,20,20,1001.0,13,5,10,0.385,65,0.2,0,0.2,15.3,115,19,97,0.165,212,0.542,23,0.608,8.0,128,24,107,0.188,277,0.462,23,0.504,8.9,2015-16,Regular%20Season
203524,Solomon Hill,1610612754,IND,44,23,21,815.0,39,22,14,0.564,103,0.379,5,0.398,7.2,127,29,97,0.228,221,0.575,18,0.626,6.0,166,51,111,0.307,324,0.512,23,0.551,6.3,2015-16,Regular%20Season
201603,Sonny Weems,1610612756,PHX,27,4,23,342.0,7,3,5,0.429,30,0.233,3,0.259,17.1,46,7,39,0.152,64,0.719,2,0.742,5.9,53,10,44,0.189,94,0.564,5,0.596,7.5,2015-16,Regular%20Season
203915,Spencer Dinwiddie,1610612741,CHI,10,4,6,152.0,4,2,2,0.5,11,0.364,0,0.364,8.0,13,1,12,0.077,25,0.52,1,0.542,8.5,17,3,14,0.176,36,0.472,1,0.486,8.4,2015-16,Regular%20Season
201150,Spencer Hawes,1610612766,CHA,54,28,26,1008.0,51,34,14,0.667,135,0.378,8,0.402,6.4,193,71,122,0.368,348,0.555,32,0.611,4.6,244,105,136,0.43,483,0.505,40,0.551,5.0,2015-16,Regular%20Season
1626169,Stanley Johnson,1610612765,DET,69,35,34,1626.0,58,30,22,0.517,206,0.282,9,0.294,6.9,248,43,204,0.173,401,0.618,22,0.654,6.4,306,73,226,0.239,607,0.504,31,0.531,6.5,2015-16,Regular%20Season
201939,Stephen Curry,1610612744,GSW,79,71,8,2700.0,68,26,42,0.382,273,0.249,5,0.254,13.1,362,56,310,0.155,651,0.556,46,0.598,9.3,430,82,352,0.191,924,0.465,51,0.493,9.9,2015-16,Regular%20Season
2581,Steve Blake,1610612765,DET,47,27,20,833.0,9,3,7,0.333,34,0.265,0,0.265,16.6,80,6,73,0.075,129,0.62,10,0.672,10.6,89,9,80,0.101,163,0.546,10,0.582,11.4,2015-16,Regular%20Season
200779,Steve Novak,1610612749,MIL,5,4,1,22.0,0,0,0,0.0,0,0.0,0,0.0,0.0,5,1,4,0.2,8,0.625,1,0.714,3.8,5,1,4,0.2,8,0.625,1,0.714,3.8,2015-16,Regular%20Season
203500,Steven Adams,1610612760,OKC,80,54,26,2014.0,219,143,62,0.653,524,0.418,20,0.435,4.9,314,102,210,0.325,720,0.436,81,0.491,4.4,533,245,272,0.46,1244,0.428,101,0.466,4.6,2015-16,Regular%20Season
204456,T.J. McConnell,1610612755,PHI,74,9,65,1507.0,43,10,32,0.233,117,0.368,4,0.381,16.7,207,30,176,0.145,352,0.588,27,0.637,8.3,250,40,208,0.16,469,0.533,31,0.571,9.7,2015-16,Regular%20Season
203933,T.J. Warren,1610612756,PHX,42,13,29,999.0,57,28,28,0.491,164,0.348,5,0.358,9.9,90,20,72,0.222,152,0.592,14,0.652,9.0,147,48,100,0.327,316,0.465,19,0.495,9.4,2015-16,Regular%20Season
201959,Taj Gibson,1610612741,CHI,72,37,35,1919.0,205,137,62,0.668,442,0.464,12,0.477,5.8,298,97,197,0.326,548,0.544,55,0.604,5.6,503,234,259,0.465,990,0.508,67,0.545,5.7,2015-16,Regular%20Season
204028,Tarik Black,1610612747,LAL,36,6,30,483.0,44,28,15,0.636,119,0.37,5,0.386,6.1,113,35,76,0.31,179,0.631,15,0.689,4.4,157,63,91,0.401,298,0.527,20,0.565,4.9,2015-16,Regular%20Season
2419,Tayshaun Prince,1610612750,MIN,64,22,42,1249.0,32,15,16,0.469,85,0.376,2,0.386,10.3,115,26,91,0.226,208,0.553,23,0.622,8.1,147,41,107,0.279,293,0.502,25,0.549,8.5,2015-16,Regular%20Season
203093,Terrence Jones,1610612745,HOU,47,23,24,1026.0,62,38,21,0.613,171,0.363,5,0.373,6.8,149,61,88,0.409,270,0.552,21,0.598,5.2,211,99,109,0.469,441,0.478,26,0.508,5.7,2015-16,Regular%20Season
203082,Terrence Ross,1610612761,TOR,65,46,19,1600.0,21,4,17,0.19,63,0.333,0,0.333,18.0,163,15,147,0.092,281,0.58,20,0.625,6.5,184,19,164,0.103,344,0.535,20,0.568,8.0,2015-16,Regular%20Season
1626179,Terry Rozier,1610612738,BOS,24,14,10,243.0,24,12,11,0.5,47,0.511,2,0.533,11.5,39,12,27,0.308,71,0.549,3,0.574,7.5,63,24,38,0.381,118,0.534,5,0.558,9.0,2015-16,Regular%20Season
200757,Thabo Sefolosha,1610612737,ATL,73,42,31,1727.0,52,33,18,0.635,179,0.291,7,0.302,8.3,282,49,233,0.174,459,0.614,39,0.671,7.0,334,82,251,0.246,638,0.524,46,0.564,7.2,2015-16,Regular%20Season
201152,Thaddeus Young,1610612751,BKN,73,21,52,2407.0,176,109,67,0.619,465,0.378,20,0.396,6.9,484,125,353,0.258,729,0.664,59,0.722,5.0,660,234,420,0.355,1194,0.553,79,0.592,5.5,2015-16,Regular%20Season
203648,Thanasis Antetokounmpo,1610612752,NYK,1,0,1,4.0,0,0,0,0.0,0,0.0,0,0.0,0.0,1,0,1,0.0,1,1.0,0,1.0,5.8,1,0,1,0.0,1,1.0,0,1.0,5.8,2015-16,Regular%20Season
203080,Thomas Robinson,1610612751,BKN,66,16,50,906.0,136,107,25,0.787,303,0.449,8,0.461,4.7,223,68,155,0.305,341,0.654,27,0.71,4.0,359,175,180,0.487,644,0.557,35,0.589,4.2,2015-16,Regular%20Season
201168,Tiago Splitter,1610612737,ATL,35,21,14,570.0,45,33,11,0.733,125,0.36,2,0.366,5.2,75,33,39,0.44,173,0.434,19,0.487,4.4,120,66,50,0.55,298,0.403,21,0.433,4.7,2015-16,Regular%20Season
202353,Tibor Pleiss,1610612762,UTA,5,3,2,62.0,6,3,3,0.5,16,0.375,1,0.4,9.7,9,1,8,0.111,16,0.563,1,0.6,3.5,15,4,11,0.267,32,0.469,2,0.5,6.0,2015-16,Regular%20Season
1495,Tim Duncan,1610612759,SAS,60,50,10,1517.0,115,68,42,0.591,268,0.429,9,0.444,6.4,332,121,208,0.364,567,0.586,44,0.635,4.7,447,189,250,0.423,835,0.535,53,0.572,5.1,2015-16,Regular%20Season
204025,Tim Frazier,1610612740,NOP,31,14,17,687.0,26,20,6,0.769,73,0.356,2,0.366,8.1,84,12,71,0.143,160,0.525,14,0.575,8.4,110,32,77,0.291,233,0.472,16,0.507,8.3,2015-16,Regular%20Season
203501,Tim Hardaway Jr.,1610612737,ATL,36,20,16,674.0,7,2,5,0.286,33,0.212,0,0.212,13.9,79,17,64,0.215,135,0.585,10,0.632,7.0,86,19,69,0.221,168,0.512,10,0.544,7.5,2015-16,Regular%20Season
202389,Timofey Mozgov,1610612739,CLE,70,48,22,1258.0,110,76,33,0.691,287,0.383,5,0.39,6.0,227,86,137,0.379,433,0.524,37,0.573,5.0,337,162,170,0.481,720,0.468,42,0.497,5.3,2015-16,Regular%20Season
202699,Tobias Harris,1610612765,DET,75,37,38,2469.0,95,53,38,0.558,305,0.311,10,0.322,6.9,404,96,304,0.238,644,0.627,52,0.682,5.8,499,149,342,0.299,949,0.526,62,0.563,6.1,2015-16,Regular%20Season
201962,Toney Douglas,1610612740,NOP,47,16,31,1115.0,24,6,17,0.25,66,0.364,5,0.393,12.9,118,17,103,0.144,184,0.641,8,0.67,8.8,142,23,120,0.162,250,0.568,13,0.599,9.5,2015-16,Regular%20Season
2754,Tony Allen,1610612763,MEM,63,33,30,1612.0,104,66,35,0.635,302,0.344,9,0.355,7.5,192,37,153,0.193,285,0.674,30,0.753,7.9,296,103,188,0.348,587,0.504,39,0.54,7.8,2015-16,Regular%20Season
2225,Tony Parker,1610612759,SAS,69,56,13,1888.0,17,4,14,0.235,114,0.149,3,0.153,19.0,158,17,141,0.108,285,0.554,20,0.596,10.4,175,21,155,0.12,399,0.439,23,0.465,11.2,2015-16,Regular%20Season
203503,Tony Snell,1610612741,CHI,55,31,24,1213.0,19,5,14,0.263,53,0.358,5,0.396,13.6,180,30,148,0.167,291,0.619,22,0.669,7.7,199,35,162,0.176,344,0.578,27,0.628,8.2,2015-16,Regular%20Season
203100,Tony Wroten,1610612752,NYK,7,0,7,131.0,2,0,2,0.0,15,0.133,1,0.143,8.8,19,2,17,0.105,31,0.613,0,0.613,6.6,21,2,19,0.095,46,0.457,1,0.467,6.8,2015-16,Regular%20Season
2772,Trevor Ariza,1610612745,HOU,80,40,40,2855.0,67,30,37,0.448,240,0.279,6,0.286,12.1,299,62,238,0.207,506,0.591,39,0.64,7.9,366,92,275,0.251,746,0.491,45,0.522,8.6,2015-16,Regular%20Season
202344,Trevor Booker,1610612762,UTA,79,39,40,1632.0,166,110,53,0.663,411,0.404,9,0.413,6.1,286,78,206,0.273,477,0.6,43,0.659,4.6,452,188,259,0.416,888,0.509,52,0.541,5.2,2015-16,Regular%20Season
203504,Trey Burke,1610612762,UTA,53,25,28,1167.0,17,6,13,0.353,68,0.25,5,0.27,18.0,94,9,86,0.096,193,0.487,8,0.508,10.8,111,15,99,0.135,261,0.425,13,0.448,12.2,2015-16,Regular%20Season
1626168,Trey Lyles,1610612762,UTA,71,34,37,1341.0,59,37,21,0.627,174,0.339,7,0.353,8.6,240,53,186,0.221,397,0.605,38,0.669,4.8,299,90,207,0.301,571,0.524,45,0.568,5.5,2015-16,Regular%20Season
202684,Tristan Thompson,1610612739,CLE,81,57,24,2269.0,268,189,73,0.705,677,0.396,13,0.404,5.0,470,158,308,0.336,785,0.599,80,0.667,5.0,738,347,381,0.47,1462,0.505,93,0.539,5.0,2015-16,Regular%20Season
203584,Troy Daniels,1610612766,CHA,25,13,12,390.0,7,3,4,0.429,20,0.35,0,0.35,9.0,50,5,45,0.1,85,0.588,6,0.633,6.2,57,8,49,0.14,105,0.543,6,0.576,6.5,2015-16,Regular%20Season
201951,Ty Lawson,1610612754,IND,50,25,25,1189.0,26,7,20,0.269,87,0.299,3,0.31,15.2,94,9,89,0.096,178,0.528,13,0.57,10.4,120,16,109,0.133,265,0.453,16,0.482,11.5,2015-16,Regular%20Season
203898,Tyler Ennis,1610612749,MIL,31,12,19,520.0,13,7,5,0.538,35,0.371,0,0.371,8.4,62,6,57,0.097,101,0.614,5,0.646,9.8,75,13,62,0.173,136,0.551,5,0.573,9.6,2015-16,Regular%20Season
201946,Tyler Hansbrough,1610612766,CHA,32,19,13,298.0,40,28,10,0.7,78,0.513,1,0.519,4.9,48,19,29,0.396,84,0.571,15,0.696,5.6,88,47,39,0.534,162,0.543,16,0.603,5.3,2015-16,Regular%20Season
204020,Tyler Johnson,1610612748,MIA,32,16,16,818.0,28,13,15,0.464,80,0.35,5,0.373,9.7,81,13,68,0.16,185,0.438,18,0.485,7.9,109,26,83,0.239,265,0.411,23,0.45,8.4,2015-16,Regular%20Season
203092,Tyler Zeller,1610612738,BOS,53,35,18,646.0,62,42,18,0.677,156,0.397,3,0.405,5.3,113,47,66,0.416,213,0.531,19,0.582,4.5,175,89,84,0.509,369,0.474,22,0.504,4.8,2015-16,Regular%20Season
201936,Tyreke Evans,1610612740,NOP,25,11,14,765.0,20,10,10,0.5,86,0.233,4,0.244,9.5,109,14,95,0.128,172,0.634,13,0.686,8.1,129,24,105,0.186,258,0.5,17,0.535,8.3,2015-16,Regular%20Season
2199,Tyson Chandler,1610612756,PHX,66,18,48,1618.0,175,114,56,0.651,386,0.453,10,0.465,5.4,401,110,290,0.274,629,0.638,48,0.69,4.4,576,224,346,0.389,1015,0.567,58,0.602,4.7,2015-16,Regular%20Season
1626145,Tyus Jones,1610612750,MIN,22,7,15,357.0,7,1,6,0.143,22,0.318,2,0.35,12.8,40,4,37,0.1,63,0.635,3,0.667,8.5,47,5,43,0.106,85,0.553,5,0.588,9.1,2015-16,Regular%20Season
2617,Udonis Haslem,1610612748,MIA,31,20,11,236.0,10,4,6,0.4,20,0.5,1,0.526,8.0,65,16,49,0.246,85,0.765,5,0.813,3.5,75,20,55,0.267,105,0.714,6,0.758,4.2,2015-16,Regular%20Season
203506,Victor Oladipo,1610612753,ORL,69,31,38,2295.0,47,23,24,0.489,190,0.247,5,0.254,11.4,292,67,226,0.229,541,0.54,50,0.595,6.5,339,90,250,0.265,731,0.464,55,0.501,7.2,2015-16,Regular%20Season
1713,Vince Carter,1610612763,MEM,53,27,26,932.0,31,20,10,0.645,95,0.326,3,0.337,7.3,115,29,85,0.252,212,0.542,20,0.599,6.9,146,49,95,0.336,307,0.476,23,0.514,7.0,2015-16,Regular%20Season
201961,Wayne Ellington,1610612751,BKN,67,18,49,1486.0,20,5,15,0.25,96,0.208,3,0.215,10.5,154,20,134,0.13,254,0.606,19,0.655,7.8,174,25,149,0.144,350,0.497,22,0.53,8.1,2015-16,Regular%20Season
202325,Wesley Johnson,1610612746,LAC,69,46,23,1523.0,37,14,23,0.378,98,0.378,4,0.394,12.8,209,52,157,0.249,417,0.501,33,0.544,6.3,246,66,180,0.268,515,0.478,37,0.515,7.2,2015-16,Regular%20Season
202083,Wesley Matthews,1610612742,DAL,73,37,36,2493.0,27,6,21,0.222,120,0.225,7,0.239,15.2,211,47,165,0.223,376,0.561,42,0.632,8.0,238,53,186,0.223,496,0.48,49,0.532,8.8,2015-16,Regular%20Season
203115,Will Barton,1610612743,DEN,82,33,49,2353.0,59,31,29,0.525,261,0.226,7,0.232,11.1,417,78,338,0.187,631,0.661,44,0.71,5.2,476,109,367,0.229,892,0.534,51,0.566,5.9,2015-16,Regular%20Season
1626161,Willie Cauley-Stein,1610612758,SAC,63,26,37,1377.0,133,84,45,0.632,262,0.508,9,0.526,5.7,214,65,152,0.304,352,0.608,41,0.688,5.8,347,149,197,0.429,614,0.565,50,0.615,5.7,2015-16,Regular%20Season
203186,Willie Reed,1610612751,BKN,34,8,26,402.0,48,32,13,0.667,101,0.475,2,0.485,4.9,73,31,40,0.425,125,0.584,11,0.64,4.5,121,63,53,0.521,226,0.535,13,0.568,4.6,2015-16,Regular%20Season
204098,Xavier Munford,1610612763,MEM,12,3,9,226.0,3,0,3,0.0,16,0.188,0,0.188,22.0,28,4,23,0.143,45,0.622,2,0.651,9.3,31,4,26,0.129,61,0.508,2,0.525,10.6,2015-16,Regular%20Season
203897,Zach LaVine,1610612750,MIN,76,26,50,2111.0,27,11,15,0.407,121,0.223,5,0.233,11.3,201,30,173,0.149,348,0.578,21,0.615,8.0,228,41,188,0.18,469,0.486,26,0.515,8.4,2015-16,Regular%20Season
2216,Zach Randolph,1610612763,MEM,68,37,31,2016.0,179,131,39,0.732,457,0.392,18,0.408,4.6,350,121,231,0.346,577,0.607,54,0.669,4.7,529,252,270,0.476,1034,0.512,72,0.55,4.7,2015-16,Regular%20Season
2585,Zaza Pachulia,1610612742,DAL,75,40,35,1983.0,249,182,58,0.731,553,0.45,6,0.455,5.4,469,168,299,0.358,780,0.601,73,0.663,4.2,718,350,357,0.487,1333,0.539,79,0.573,4.6,2015-16,Regular%20Season
1626151,Aaron Harrison,1610612766,CHA,1,0,1,6.0,0,0,0,0.0,0,0.0,0,0.0,0.0,1,0,1,0.0,2,0.5,0,0.5,8.0,1,0,1,0.0,2,0.5,0,0.5,8.0,2015-16,Playoffs
201143,Al Horford,1610612737,ATL,10,4,6,327.0,13,7,6,0.538,37,0.351,1,0.361,12.3,52,19,33,0.365,114,0.456,9,0.495,5.1,65,26,39,0.4,151,0.43,10,0.461,6.5,2015-16,Playoffs
2744,Al Jefferson,1610612766,CHA,7,3,4,168.0,14,6,8,0.429,31,0.452,0,0.452,8.2,29,14,15,0.483,52,0.558,4,0.604,3.2,43,20,23,0.465,83,0.518,4,0.544,4.8,2015-16,Playoffs
202329,Al-Farouq Aminu,1610612757,POR,11,5,6,372.0,23,11,11,0.478,54,0.426,3,0.451,7.7,72,9,63,0.125,108,0.667,10,0.735,6.4,95,20,74,0.211,162,0.586,13,0.638,6.7,2015-16,Playoffs
203459,Allen Crabbe,1610612757,POR,10,5,5,284.0,5,2,4,0.4,23,0.217,0,0.217,12.4,27,2,23,0.074,41,0.659,3,0.711,7.9,32,4,27,0.125,64,0.5,3,0.525,8.8,2015-16,Playoffs
2405,Amar'e Stoudemire,1610612748,MIA,7,4,3,74.0,3,1,1,0.333,14,0.214,2,0.25,12.7,10,2,8,0.2,19,0.526,2,0.588,6.3,13,3,9,0.231,33,0.394,4,0.448,7.4,2015-16,Playoffs
101161,Amir Johnson,1610612738,BOS,6,2,4,134.0,11,5,6,0.455,27,0.407,2,0.44,6.4,32,9,23,0.281,56,0.571,5,0.627,4.9,43,14,29,0.326,83,0.518,7,0.566,5.3,2015-16,Playoffs
2760,Anderson Varejao,1610612744,GSW,12,8,4,70.0,12,8,3,0.667,21,0.571,0,0.571,4.6,9,1,9,0.111,26,0.346,4,0.409,4.5,21,9,12,0.429,47,0.447,4,0.488,4.5,2015-16,Playoffs
203083,Andre Drummond,1610612765,DET,4,0,4,131.0,12,10,1,0.833,22,0.545,0,0.545,2.7,24,9,15,0.375,47,0.511,6,0.585,3.5,36,19,16,0.528,69,0.522,6,0.571,3.3,2015-16,Playoffs
2738,Andre Iguodala,1610612744,GSW,24,15,9,767.0,35,14,21,0.4,74,0.473,3,0.493,10.1,70,8,63,0.114,128,0.547,9,0.588,9.6,105,22,84,0.21,202,0.52,12,0.553,9.8,2015-16,Playoffs
1889,Andre Miller,1610612759,SAS,3,2,1,26.0,2,0,2,0.0,5,0.4,0,0.4,8.4,3,0,3,0.0,5,0.6,1,0.75,11.0,5,0,5,0.0,10,0.5,1,0.556,10.0,2015-16,Playoffs
203460,Andre Roberson,1610612760,OKC,18,11,7,471.0,25,15,10,0.6,70,0.357,3,0.373,7.8,76,22,54,0.289,122,0.623,5,0.65,6.5,101,37,64,0.366,192,0.526,8,0.549,6.8,2015-16,Playoffs
101106,Andrew Bogut,1610612744,GSW,22,15,7,365.0,47,27,18,0.574,80,0.588,3,0.61,4.7,78,27,50,0.346,167,0.467,8,0.491,3.9,125,54,68,0.432,247,0.506,11,0.53,4.2,2015-16,Playoffs
202726,Andrew Goudelock,1610612745,HOU,1,0,1,6.0,0,0,0,0.0,0,0.0,0,0.0,0.0,1,0,1,0.0,3,0.333,0,0.333,5.7,1,0,1,0.0,3,0.333,0,0.333,5.7,2015-16,Playoffs
201627,Anthony Morrow,1610612760,OKC,2,2,0,14.0,0,0,0,0.0,0,0.0,0,0.0,0.0,2,0,2,0.0,3,0.667,0,0.667,3.9,2,0,2,0.0,3,0.667,0,0.667,3.9,2015-16,Playoffs
201229,Anthony Tolliver,1610612765,DET,3,0,3,26.0,1,1,0,1.0,2,0.5,0,0.5,5.4,3,1,2,0.333,5,0.6,1,0.75,4.2,4,2,2,0.5,7,0.571,1,0.667,4.5,2015-16,Playoffs
203382,Aron Baynes,1610612765,DET,3,0,3,32.0,3,3,0,1.0,6,0.5,0,0.5,2.5,5,2,3,0.4,9,0.556,0,0.556,5.2,8,5,3,0.625,15,0.533,0,0.533,4.2,2015-16,Playoffs
203085,Austin Rivers,1610612746,LAC,6,2,4,144.0,4,0,4,0.0,14,0.286,2,0.333,15.1,12,0,12,0.0,24,0.5,1,0.522,7.4,16,0,16,0.0,38,0.421,3,0.457,9.4,2015-16,Playoffs
202340,Avery Bradley,1610612738,BOS,1,0,1,33.0,2,0,2,0.0,4,0.5,0,0.5,17.7,1,0,1,0.0,7,0.143,0,0.143,3.2,3,0,3,0.0,11,0.273,0,0.273,12.8,2015-16,Playoffs
202687,Bismack Biyombo,1610612761,TOR,20,10,10,506.0,53,34,20,0.642,141,0.376,3,0.384,7.5,134,64,70,0.478,203,0.66,21,0.736,3.9,187,98,90,0.524,344,0.544,24,0.584,4.9,2015-16,Playoffs
201933,Blake Griffin,1610612746,LAC,4,2,2,127.0,7,2,3,0.286,20,0.35,1,0.368,6.8,28,10,18,0.357,42,0.667,1,0.683,3.8,35,12,21,0.343,62,0.565,2,0.583,4.2,2015-16,Playoffs
1626246,Boban Marjanovic,1610612759,SAS,6,4,2,41.0,4,3,1,0.75,8,0.5,0,0.5,3.1,10,3,7,0.3,16,0.625,0,0.625,4.6,14,6,8,0.429,24,0.583,0,0.583,4.2,2015-16,Playoffs
2564,Boris Diaw,1610612759,SAS,8,6,2,150.0,2,2,0,1.0,17,0.118,1,0.125,2.1,17,4,13,0.235,31,0.548,5,0.654,4.8,19,6,13,0.316,48,0.396,6,0.452,4.5,2015-16,Playoffs
201575,Brandon Rush,1610612744,GSW,12,6,6,105.0,0,0,0,0.0,2,0.0,0,0.0,0.0,23,7,15,0.304,38,0.605,6,0.719,6.6,23,7,15,0.304,40,0.575,6,0.676,6.6,2015-16,Playoffs
203148,Brian Roberts,1610612757,POR,1,0,1,8.0,1,0,1,0.0,2,0.5,0,0.5,36.1,0,0,0,0.0,0,0.0,0,0.0,0.0,1,0,1,0.0,2,0.5,0,0.5,36.1,2015-16,Playoffs
203912,C.J. Wilcox,1610612746,LAC,1,0,1,2.0,0,0,0,0.0,0,0.0,0,0.0,0.0,1,1,0,1.0,1,1.0,0,1.0,13.6,1,1,0,1.0,1,1.0,0,1.0,13.6,2015-16,Playoffs
203468,CJ McCollum,1610612757,POR,11,5,6,442.0,7,3,4,0.429,31,0.226,0,0.226,14.5,33,4,30,0.121,70,0.471,2,0.485,11.1,40,7,34,0.175,101,0.396,2,0.404,11.7,2015-16,Playoffs
101139,CJ Miles,1610612754,IND,7,3,4,92.0,4,4,0,1.0,7,0.571,0,0.571,4.3,20,0,19,0.0,24,0.833,0,0.833,7.9,24,4,19,0.167,31,0.774,0,0.774,7.2,2015-16,Playoffs
1626166,Cameron Payne,1610612760,OKC,3,1,2,30.0,0,0,0,0.0,1,0.0,0,0.0,0.0,4,0,4,0.0,6,0.667,0,0.667,8.2,4,0,4,0.0,7,0.571,0,0.571,8.2,2015-16,Playoffs
101112,Channing Frye,1610612739,CLE,15,10,5,220.0,5,0,4,0.0,13,0.385,0,0.385,11.8,36,10,26,0.278,67,0.537,7,0.6,4.3,41,10,30,0.244,80,0.513,7,0.562,5.0,2015-16,Playoffs
101111,Charlie Villanueva,1610612742,DAL,2,0,2,15.0,0,0,0,0.0,2,0.0,1,0.0,0.0,2,0,2,0.0,4,0.5,0,0.5,4.0,2,0,2,0.0,6,0.333,1,0.4,4.0,2015-16,Playoffs
2365,Chris Andersen,1610612763,MEM,4,0,4,79.0,13,10,3,0.769,20,0.65,0,0.65,4.0,18,7,10,0.389,34,0.529,4,0.6,3.1,31,17,13,0.548,54,0.574,4,0.62,3.5,2015-16,Playoffs
2549,Chris Kaman,1610612757,POR,4,2,2,32.0,2,0,2,0.0,3,0.667,0,0.667,15.0,6,3,4,0.5,14,0.429,0,0.429,3.5,8,3,6,0.375,17,0.471,0,0.471,6.0,2015-16,Playoffs
101108,Chris Paul,1610612746,LAC,4,2,2,125.0,4,1,2,0.25,13,0.308,0,0.308,17.0,12,1,11,0.083,23,0.522,2,0.571,14.6,16,2,13,0.125,36,0.444,2,0.471,15.1,2015-16,Playoffs
203991,Clint Capela,1610612745,HOU,5,1,4,43.0,8,8,0,1.0,15,0.533,1,0.571,7.4,12,4,8,0.333,18,0.667,1,0.706,4.4,20,12,8,0.6,33,0.606,2,0.645,5.6,2015-16,Playoffs
203469,Cody Zeller,1610612766,CHA,7,3,4,137.0,9,8,1,0.889,36,0.25,1,0.257,6.0,28,7,21,0.25,54,0.519,5,0.571,4.7,37,15,22,0.405,90,0.411,6,0.44,5.0,2015-16,Playoffs
202332,Cole Aldrich,1610612746,LAC,6,2,4,77.0,8,7,1,0.875,20,0.4,0,0.4,9.3,22,7,15,0.318,28,0.786,2,0.846,4.1,30,14,16,0.467,48,0.625,2,0.652,5.5,2015-16,Playoffs
201147,Corey Brewer,1610612745,HOU,3,0,3,56.0,3,0,3,0.0,7,0.429,0,0.429,11.7,4,1,5,0.25,9,0.444,1,0.5,6.5,7,1,8,0.143,16,0.438,1,0.467,8.2,2015-16,Playoffs
202709,Cory Joseph,1610612761,TOR,17,8,9,397.0,11,3,7,0.273,43,0.256,1,0.262,13.3,30,6,24,0.2,63,0.476,5,0.517,7.8,41,9,31,0.22,106,0.387,6,0.41,9.2,2015-16,Playoffs
201584,Courtney Lee,1610612766,CHA,7,3,4,257.0,5,3,2,0.6,22,0.227,1,0.238,7.3,15,1,14,0.067,36,0.417,2,0.441,8.7,20,4,16,0.2,58,0.345,3,0.364,8.3,2015-16,Playoffs
2563,Dahntay Jones,1610612739,CLE,5,5,0,28.0,0,0,0,0.0,3,0.0,0,0.0,0.0,7,0,7,0.0,9,0.778,0,0.778,5.5,7,0,7,0.0,12,0.583,0,0.583,5.5,2015-16,Playoffs
203081,Damian Lillard,1610612757,POR,10,5,5,396.0,12,3,9,0.25,41,0.293,4,0.324,13.3,35,2,33,0.057,71,0.493,4,0.522,8.1,47,5,42,0.106,112,0.42,8,0.452,9.4,2015-16,Playoffs
201980,Danny Green,1610612759,SAS,9,6,3,237.0,0,0,0,0.0,11,0.0,0,0.0,0.0,31,9,22,0.29,56,0.554,3,0.585,6.8,31,9,22,0.29,67,0.463,3,0.484,6.8,2015-16,Playoffs
101135,David Lee,1610612742,DAL,2,0,2,33.0,1,0,1,0.0,6,0.167,0,0.167,9.8,5,2,3,0.4,9,0.556,0,0.556,3.6,6,2,4,0.333,15,0.4,0,0.4,4.7,2015-16,Playoffs
2561,David West,1610612759,SAS,10,6,4,176.0,13,8,5,0.615,28,0.464,1,0.481,5.6,24,14,9,0.583,45,0.533,4,0.585,4.8,37,22,14,0.595,73,0.507,5,0.544,5.1,2015-16,Playoffs
201599,DeAndre Jordan,1610612746,LAC,6,2,4,198.0,30,20,10,0.667,45,0.667,0,0.667,6.0,68,20,48,0.294,102,0.667,5,0.701,4.9,98,40,58,0.408,147,0.667,5,0.69,5.2,2015-16,Playoffs
201942,DeMar DeRozan,1610612761,TOR,19,10,9,712.0,13,6,7,0.462,75,0.173,3,0.181,9.9,70,16,54,0.229,120,0.583,9,0.631,7.6,83,22,61,0.265,195,0.426,12,0.454,8.0,2015-16,Playoffs
201960,DeMarre Carroll,1610612761,TOR,20,10,10,596.0,23,9,14,0.391,67,0.343,2,0.354,10.6,58,22,36,0.379,118,0.492,15,0.563,7.2,81,31,50,0.383,185,0.438,17,0.482,8.1,2015-16,Playoffs
1626153,Delon Wright,1610612761,TOR,4,0,4,30.0,1,0,1,0.0,5,0.2,0,0.2,1.4,3,0,3,0.0,5,0.6,0,0.6,7.4,4,0,4,0.0,10,0.4,0,0.4,5.9,2015-16,Playoffs
203471,Dennis Schroder,1610612737,ATL,8,2,6,165.0,6,2,5,0.333,18,0.333,0,0.333,14.2,13,1,12,0.077,30,0.433,1,0.448,7.2,19,3,17,0.158,48,0.396,1,0.404,9.4,2015-16,Playoffs
101114,Deron Williams,1610612742,DAL,2,1,1,48.0,0,0,0,0.0,5,0.0,0,0.0,0.0,2,1,1,0.5,7,0.286,0,0.286,5.1,2,1,1,0.5,12,0.167,0,0.167,5.1,2015-16,Playoffs
2734,Devin Harris,1610612742,DAL,5,1,4,121.0,1,0,1,0.0,12,0.083,0,0.083,26.8,13,3,10,0.231,25,0.52,2,0.565,7.4,14,3,11,0.214,37,0.378,2,0.4,8.8,2015-16,Playoffs
203079,Dion Waiters,1610612760,OKC,18,11,7,491.0,6,0,4,0.0,29,0.207,1,0.214,24.3,41,9,32,0.22,69,0.594,5,0.641,8.7,47,9,36,0.191,98,0.48,6,0.511,10.1,2015-16,Playoffs
1717,Dirk Nowitzki,1610612742,DAL,5,1,4,170.0,3,2,1,0.667,14,0.214,1,0.231,7.6,21,5,16,0.238,43,0.488,3,0.525,6.4,24,7,17,0.292,57,0.421,4,0.453,6.6,2015-16,Playoffs
202700,Donatas Motiejunas,1610612745,HOU,5,1,4,98.0,10,3,6,0.3,16,0.625,0,0.625,8.4,16,5,12,0.313,29,0.552,1,0.571,5.9,26,8,18,0.308,45,0.578,1,0.591,6.8,2015-16,Playoffs
2748,Dorell Wright,1610612748,MIA,4,2,2,15.0,0,0,0,0.0,0,0.0,0,0.0,0.0,6,3,3,0.5,6,1.0,0,1.0,4.8,6,3,3,0.5,6,1.0,0,1.0,4.8,2015-16,Playoffs
203110,Draymond Green,1610612744,GSW,23,15,8,879.0,38,25,13,0.658,101,0.376,3,0.388,6.2,190,75,112,0.395,327,0.581,21,0.621,3.8,228,100,125,0.439,428,0.533,24,0.564,4.3,2015-16,Playoffs
2730,Dwight Howard,1610612745,HOU,5,1,4,180.0,26,22,3,0.846,72,0.361,1,0.366,4.2,44,14,30,0.318,68,0.647,3,0.677,3.3,70,36,33,0.514,140,0.5,4,0.515,3.6,2015-16,Playoffs
203939,Dwight Powell,1610612742,DAL,3,1,2,59.0,9,4,5,0.444,12,0.75,0,0.75,7.5,8,2,6,0.25,25,0.32,3,0.364,6.5,17,6,11,0.353,37,0.459,3,0.5,7.0,2015-16,Playoffs
2548,Dwyane Wade,1610612748,MIA,14,7,7,473.0,12,9,3,0.75,40,0.3,2,0.316,8.7,67,13,54,0.194,102,0.657,4,0.684,7.4,79,22,57,0.278,142,0.556,6,0.581,7.6,2015-16,Playoffs
202334,Ed Davis,1610612757,POR,11,5,6,205.0,26,17,7,0.654,71,0.366,3,0.382,4.7,49,9,41,0.184,82,0.598,8,0.662,4.1,75,26,48,0.347,153,0.49,11,0.528,4.3,2015-16,Playoffs
202683,Enes Freedom,1610612760,OKC,17,10,7,311.0,47,36,11,0.766,97,0.485,0,0.485,4.3,64,33,30,0.516,131,0.489,9,0.525,4.4,111,69,41,0.622,228,0.487,9,0.507,4.3,2015-16,Playoffs
202323,Evan Turner,1610612738,BOS,6,2,4,214.0,8,5,4,0.625,27,0.296,0,0.296,12.4,26,3,23,0.115,56,0.464,7,0.531,5.1,34,8,27,0.235,83,0.41,7,0.447,7.0,2015-16,Playoffs
203105,Festus Ezeli,1610612744,GSW,20,12,8,198.0,23,11,12,0.478,59,0.39,2,0.404,5.3,38,11,25,0.289,70,0.543,9,0.623,4.8,61,22,37,0.361,129,0.473,11,0.517,5.0,2015-16,Playoffs
1626163,Frank Kaminsky,1610612766,CHA,7,3,4,190.0,3,1,2,0.333,21,0.143,0,0.143,9.3,27,8,19,0.296,53,0.509,0,0.509,4.8,30,9,21,0.3,74,0.405,0,0.405,5.3,2015-16,Playoffs
201588,George Hill,1610612754,IND,7,3,4,235.0,6,3,3,0.5,14,0.429,1,0.462,9.3,13,3,11,0.231,45,0.289,5,0.325,12.0,19,6,14,0.316,59,0.322,6,0.358,11.2,2015-16,Playoffs
101123,Gerald Green,1610612748,MIA,7,3,4,91.0,2,1,1,0.5,10,0.2,1,0.222,12.2,15,0,15,0.0,24,0.625,1,0.652,7.1,17,1,16,0.059,34,0.5,2,0.531,7.7,2015-16,Playoffs
201945,Gerald Henderson,1610612757,POR,11,5,6,234.0,6,1,5,0.167,24,0.25,2,0.273,6.4,29,3,26,0.103,50,0.58,5,0.644,6.5,35,4,31,0.114,74,0.473,7,0.522,6.5,2015-16,Playoffs
201609,Goran Dragic,1610612748,MIA,14,7,7,472.0,11,3,8,0.273,52,0.212,2,0.22,11.8,58,8,50,0.138,98,0.592,4,0.617,9.7,69,11,58,0.159,150,0.46,6,0.479,10.1,2015-16,Playoffs
203084,Harrison Barnes,1610612744,GSW,24,15,9,743.0,27,9,18,0.333,65,0.415,0,0.415,9.2,85,23,63,0.271,191,0.445,11,0.472,6.9,112,32,81,0.286,256,0.438,11,0.457,7.5,2015-16,Playoffs
202355,Hassan Whiteside,1610612748,MIA,9,5,4,283.0,26,24,2,0.923,58,0.448,4,0.481,4.4,83,26,56,0.313,135,0.615,11,0.669,3.6,109,50,58,0.459,193,0.565,15,0.612,3.8,2015-16,Playoffs
203546,Ian Clark,1610612744,GSW,8,4,4,110.0,2,0,2,0.0,11,0.182,1,0.2,11.6,15,2,13,0.133,25,0.6,2,0.652,5.2,17,2,15,0.118,36,0.472,3,0.515,5.9,2015-16,Playoffs
101133,Ian Mahinmi,1610612754,IND,7,3,4,172.0,12,5,5,0.417,33,0.364,1,0.375,12.7,24,10,14,0.417,62,0.387,3,0.407,4.2,36,15,19,0.417,95,0.379,4,0.396,6.7,2015-16,Playoffs
202697,Iman Shumpert,1610612739,CLE,21,16,5,367.0,10,7,3,0.7,24,0.417,0,0.417,7.9,37,4,32,0.108,60,0.617,1,0.627,6.6,47,11,35,0.234,84,0.56,1,0.566,6.9,2015-16,Playoffs
202738,Isaiah Thomas,1610612738,BOS,6,2,4,220.0,2,1,1,0.5,28,0.071,0,0.071,8.3,16,2,15,0.125,32,0.5,1,0.516,10.7,18,3,16,0.167,60,0.3,1,0.305,10.5,2015-16,Playoffs
200826,J.J. Barea,1610612742,DAL,4,0,4,100.0,0,0,0,0.0,12,0.0,1,0.0,0.0,6,0,6,0.0,16,0.375,2,0.429,13.0,6,0,6,0.0,28,0.214,3,0.24,13.0,2015-16,Playoffs
200755,JJ Redick,1610612746,LAC,6,2,4,166.0,1,0,1,0.0,8,0.125,2,0.167,27.1,11,2,9,0.182,27,0.407,5,0.5,8.1,12,2,10,0.167,35,0.343,7,0.429,9.7,2015-16,Playoffs
2747,JR Smith,1610612739,CLE,20,15,5,694.0,7,4,4,0.571,25,0.28,0,0.28,19.6,60,5,55,0.083,92,0.652,5,0.69,9.2,67,9,59,0.134,117,0.573,5,0.598,10.4,2015-16,Playoffs
203210,JaMychal Green,1610612763,MEM,4,0,4,72.0,5,3,2,0.6,10,0.5,0,0.5,4.8,10,3,7,0.3,19,0.526,2,0.588,4.4,15,6,9,0.4,29,0.517,2,0.556,4.5,2015-16,Playoffs
201580,JaVale McGee,1610612742,DAL,2,0,2,14.0,2,2,0,1.0,4,0.5,0,0.5,4.8,1,0,1,0.0,3,0.333,0,0.333,5.3,3,2,1,0.667,7,0.429,0,0.429,5.0,2015-16,Playoffs
203109,Jae Crowder,1610612738,BOS,6,2,4,197.0,5,1,3,0.2,14,0.357,0,0.357,15.3,34,6,28,0.176,52,0.654,3,0.694,6.1,39,7,31,0.179,66,0.591,3,0.619,7.1,2015-16,Playoffs
2037,Jamal Crawford,1610612746,LAC,4,1,3,133.0,2,0,2,0.0,7,0.286,3,0.5,20.3,11,2,9,0.182,21,0.524,0,0.524,10.7,13,2,11,0.154,28,0.464,3,0.52,12.2,2015-16,Playoffs
201935,James Harden,1610612745,HOU,5,1,4,193.0,7,3,3,0.429,15,0.467,1,0.5,7.4,19,2,16,0.105,31,0.613,6,0.76,7.8,26,5,19,0.192,46,0.565,7,0.667,7.7,2015-16,Playoffs
201949,James Johnson,1610612761,TOR,8,3,5,93.0,3,2,1,0.667,10,0.3,0,0.3,19.3,12,2,10,0.167,13,0.923,0,0.923,5.9,15,4,11,0.267,23,0.652,0,0.652,8.6,2015-16,Playoffs
2592,James Jones,1610612739,CLE,3,2,1,28.0,1,0,1,0.0,2,0.5,0,0.5,8.3,3,0,3,0.0,6,0.5,0,0.5,8.7,4,0,4,0.0,8,0.5,0,0.5,8.6,2015-16,Playoffs
203949,James Michael McAdoo,1610612744,GSW,4,1,3,26.0,0,0,0,0.0,4,0.0,0,0.0,0.0,8,1,8,0.125,11,0.727,0,0.727,5.4,8,1,8,0.125,15,0.533,0,0.533,5.4,2015-16,Playoffs
203096,Jared Sullinger,1610612738,BOS,6,2,4,81.0,10,8,2,0.8,28,0.357,1,0.37,3.7,17,3,14,0.176,29,0.586,1,0.607,4.2,27,11,16,0.407,57,0.474,2,0.491,4.0,2015-16,Playoffs
1626185,Jarell Martin,1610612763,MEM,2,0,2,46.0,4,1,3,0.25,11,0.364,0,0.364,5.8,3,1,2,0.333,11,0.273,3,0.375,4.5,7,2,5,0.286,22,0.318,3,0.368,5.2,2015-16,Playoffs
1891,Jason Terry,1610612745,HOU,4,0,4,102.0,1,0,1,0.0,5,0.2,0,0.2,25.2,10,1,10,0.1,12,0.833,0,0.833,15.6,11,1,11,0.091,17,0.647,0,0.647,16.4,2015-16,Playoffs
201574,Jason Thompson,1610612761,TOR,5,1,4,31.0,6,2,4,0.333,13,0.462,1,0.5,4.4,5,2,3,0.4,8,0.625,0,0.625,6.6,11,4,7,0.364,21,0.524,1,0.55,5.4,2015-16,Playoffs
201145,Jeff Green,1610612746,LAC,5,1,4,143.0,3,1,2,0.333,8,0.375,0,0.375,10.8,16,3,13,0.188,35,0.457,2,0.485,6.7,19,4,15,0.211,43,0.442,2,0.463,7.4,2015-16,Playoffs
201952,Jeff Teague,1610612737,ATL,10,4,6,279.0,3,2,1,0.667,26,0.115,1,0.12,10.8,16,3,13,0.188,39,0.41,1,0.421,10.3,19,5,14,0.263,65,0.292,2,0.302,10.4,2015-16,Playoffs
203087,Jeremy Lamb,1610612766,CHA,2,0,2,10.0,1,1,0,1.0,3,0.333,0,0.333,9.1,3,0,3,0.0,5,0.6,1,0.75,3.3,4,1,3,0.25,8,0.5,1,0.571,4.8,2015-16,Playoffs
202391,Jeremy Lin,1610612766,CHA,6,2,4,155.0,3,1,2,0.333,12,0.25,0,0.25,13.7,13,2,11,0.154,29,0.448,2,0.481,9.2,16,3,13,0.188,41,0.39,2,0.41,10.0,2015-16,Playoffs
2207,Joe Johnson,1610612748,MIA,14,7,7,492.0,7,6,1,0.857,30,0.233,2,0.25,5.9,59,9,50,0.153,103,0.573,3,0.59,6.0,66,15,51,0.227,133,0.496,5,0.516,6.0,2015-16,Playoffs
1626202,Joe Young,1610612754,IND,1,0,1,3.0,0,0,0,0.0,0,0.0,0,0.0,0.0,1,0,1,0.0,1,1.0,0,1.0,5.5,1,0,1,0.0,1,1.0,0,1.0,5.5,2015-16,Playoffs
201973,Jonas Jerebko,1610612738,BOS,6,2,4,162.0,7,3,3,0.429,18,0.389,0,0.389,9.5,34,8,27,0.235,64,0.531,5,0.576,6.2,41,11,30,0.268,82,0.5,5,0.532,6.6,2015-16,Playoffs
202685,Jonas Valanciunas,1610612761,TOR,11,6,5,302.0,48,37,10,0.771,107,0.449,2,0.457,3.1,81,27,54,0.333,131,0.618,5,0.643,3.6,129,64,64,0.496,238,0.542,7,0.558,3.4,2015-16,Playoffs
203613,Jonathon Simmons,1610612759,SAS,2,2,0,24.0,3,2,1,0.667,5,0.6,0,0.6,9.7,1,0,1,0.0,3,0.333,0,0.333,10.4,4,2,2,0.5,8,0.5,0,0.5,9.8,2015-16,Playoffs
200770,Jordan Farmar,1610612763,MEM,4,0,4,113.0,0,0,0,0.0,4,0.0,1,0.0,0.0,6,1,5,0.167,11,0.545,1,0.6,9.0,6,1,5,0.167,15,0.4,2,0.462,9.0,2015-16,Playoffs
201941,Jordan Hill,1610612754,IND,3,3,0,10.0,2,2,0,1.0,2,1.0,0,1.0,7.1,4,2,2,0.5,6,0.667,1,0.8,6.2,6,4,2,0.667,8,0.75,1,0.857,6.5,2015-16,Playoffs
203895,Jordan McRae,1610612739,CLE,2,2,0,4.0,0,0,0,0.0,0,0.0,0,0.0,0.0,2,0,2,0.0,2,1.0,0,1.0,5.3,2,0,2,0.0,2,1.0,0,1.0,5.3,2015-16,Playoffs
1626175,Jordan Mickey,1610612738,BOS,1,0,1,9.0,1,0,1,0.0,1,1.0,0,1.0,5.4,1,1,0,1.0,5,0.2,0,0.2,4.1,2,1,1,0.5,6,0.333,0,0.333,4.7,2015-16,Playoffs
203268,Jorge Gutierrez,1610612766,CHA,2,0,2,10.0,0,0,0,0.0,0,0.0,0,0.0,0.0,2,1,1,0.5,3,0.667,0,0.667,9.6,2,1,1,0.5,3,0.667,0,0.667,9.6,2015-16,Playoffs
203962,Josh Huestis,1610612760,OKC,2,2,0,10.0,1,1,0,1.0,3,0.333,0,0.333,4.1,2,0,2,0.0,5,0.4,3,1.0,7.2,3,1,2,0.333,8,0.375,3,0.6,6.1,2015-16,Playoffs
201177,Josh McRoberts,1610612748,MIA,8,3,5,124.0,7,6,1,0.857,14,0.5,0,0.5,4.0,19,6,14,0.316,46,0.413,2,0.432,7.1,26,12,15,0.462,60,0.433,2,0.448,6.3,2015-16,Playoffs
1626196,Josh Richardson,1610612748,MIA,14,7,7,387.0,10,2,8,0.2,28,0.357,2,0.385,15.7,40,7,33,0.175,79,0.506,8,0.563,9.7,50,9,41,0.18,107,0.467,10,0.515,10.9,2015-16,Playoffs
2746,Josh Smith,1610612745,HOU,3,1,2,29.0,1,0,1,0.0,2,0.5,0,0.5,8.6,1,1,1,1.0,4,0.25,0,0.25,16.7,2,1,2,0.5,6,0.333,0,0.333,14.0,2015-16,Playoffs
1626147,Justin Anderson,1610612742,DAL,5,1,4,95.0,9,2,6,0.222,17,0.529,0,0.529,17.1,11,1,10,0.091,25,0.44,3,0.5,5.5,20,3,16,0.15,42,0.476,3,0.513,10.4,2015-16,Playoffs
1626159,Justise Winslow,1610612748,MIA,13,7,6,330.0,17,12,5,0.706,49,0.347,1,0.354,5.6,46,10,36,0.217,113,0.407,13,0.46,6.5,63,22,41,0.349,162,0.389,14,0.426,6.2,2015-16,Playoffs
203909,KJ McDaniels,1610612745,HOU,3,0,3,33.0,1,1,0,1.0,10,0.1,1,0.111,3.8,6,1,5,0.167,13,0.462,3,0.6,5.8,7,2,5,0.286,23,0.304,4,0.368,5.5,2015-16,Playoffs
202695,Kawhi Leonard,1610612759,SAS,10,6,4,339.0,14,8,6,0.571,45,0.311,2,0.326,7.5,49,13,36,0.265,84,0.583,4,0.613,6.1,63,21,42,0.333,129,0.488,6,0.512,6.4,2015-16,Playoffs
203482,Kelly Olynyk,1610612738,BOS,3,1,2,21.0,2,2,0,1.0,10,0.2,1,0.222,8.1,2,0,2,0.0,4,0.5,0,0.5,7.6,4,2,2,0.5,14,0.286,1,0.308,7.9,2015-16,Playoffs
202689,Kemba Walker,1610612766,CHA,7,3,4,260.0,3,2,1,0.667,38,0.079,1,0.081,7.5,18,4,15,0.222,49,0.367,2,0.383,8.0,21,6,16,0.286,87,0.241,3,0.25,7.9,2015-16,Playoffs
203145,Kent Bazemore,1610612737,ATL,10,4,6,325.0,8,3,5,0.375,27,0.296,0,0.296,8.0,58,12,45,0.207,91,0.637,6,0.682,7.4,66,15,50,0.227,118,0.559,6,0.589,7.5,2015-16,Playoffs
203484,Kentavious Caldwell-Pope,1610612765,DET,4,0,4,161.0,2,1,1,0.5,9,0.222,0,0.222,13.5,15,1,14,0.067,28,0.536,0,0.536,12.9,17,2,15,0.118,37,0.459,0,0.459,13.0,2015-16,Playoffs
201142,Kevin Durant,1610612760,OKC,18,11,7,726.0,13,7,6,0.538,44,0.295,1,0.302,11.5,115,17,99,0.148,155,0.742,9,0.788,6.8,128,24,105,0.188,199,0.643,10,0.677,7.3,2015-16,Playoffs
201567,Kevin Love,1610612739,CLE,20,15,5,613.0,34,25,8,0.735,89,0.382,2,0.391,6.8,141,45,96,0.319,227,0.621,15,0.665,4.5,175,70,104,0.4,316,0.554,17,0.585,4.9,2015-16,Playoffs
2755,Kevin Martin,1610612759,SAS,3,2,1,35.0,0,0,0,0.0,3,0.0,0,0.0,0.0,4,0,4,0.0,6,0.667,1,0.8,5.3,4,0,4,0.0,9,0.444,1,0.5,5.3,2015-16,Playoffs
2550,Kirk Hinrich,1610612737,ATL,2,1,1,24.0,0,0,0,0.0,1,0.0,0,0.0,0.0,4,0,4,0.0,4,1.0,0,1.0,8.8,4,0,4,0.0,5,0.8,0,0.8,8.8,2015-16,Playoffs
202691,Klay Thompson,1610612744,GSW,24,15,9,849.0,15,6,10,0.4,62,0.242,0,0.242,11.6,73,18,55,0.247,158,0.462,20,0.529,7.7,88,24,65,0.273,220,0.4,20,0.44,8.6,2015-16,Playoffs
2743,Kris Humphries,1610612737,ATL,4,1,3,56.0,8,3,4,0.375,15,0.533,0,0.533,9.5,16,7,9,0.438,26,0.615,4,0.727,4.7,24,10,13,0.417,41,0.585,4,0.649,6.2,2015-16,Playoffs
203937,Kyle Anderson,1610612759,SAS,7,5,2,115.0,2,0,2,0.0,9,0.222,0,0.222,13.4,22,3,19,0.136,37,0.595,3,0.647,7.7,24,3,21,0.125,46,0.522,3,0.558,8.1,2015-16,Playoffs
2594,Kyle Korver,1610612737,ATL,9,4,5,287.0,3,1,2,0.333,11,0.273,0,0.273,20.1,45,12,33,0.267,85,0.529,9,0.592,6.9,48,13,35,0.271,96,0.5,9,0.552,7.7,2015-16,Playoffs
200768,Kyle Lowry,1610612761,TOR,20,10,10,766.0,18,8,9,0.444,98,0.184,2,0.188,11.8,76,16,60,0.211,164,0.463,16,0.514,7.0,94,24,69,0.255,262,0.359,18,0.385,7.9,2015-16,Playoffs
202713,Kyle Singler,1610612760,OKC,4,2,2,44.0,1,0,1,0.0,3,0.333,0,0.333,22.5,6,3,3,0.5,10,0.6,1,0.667,4.5,7,3,4,0.429,13,0.538,1,0.583,7.1,2015-16,Playoffs
202681,Kyrie Irving,1610612739,CLE,20,15,5,734.0,15,7,9,0.467,72,0.208,5,0.224,10.9,47,2,45,0.043,118,0.398,7,0.423,12.1,62,9,54,0.145,190,0.326,12,0.348,11.8,2015-16,Playoffs
200746,LaMarcus Aldridge,1610612759,SAS,10,6,4,337.0,22,13,8,0.591,46,0.478,1,0.489,5.4,61,14,46,0.23,100,0.61,6,0.649,5.8,83,27,54,0.325,146,0.568,7,0.597,5.7,2015-16,Playoffs
203934,Lamar Patterson,1610612737,ATL,3,2,1,19.0,0,0,0,0.0,1,0.0,0,0.0,0.0,5,2,3,0.4,7,0.714,1,0.833,4.9,5,2,3,0.4,8,0.625,1,0.714,4.9,2015-16,Playoffs
202362,Lance Stephenson,1610612763,MEM,3,0,3,86.0,1,0,1,0.0,6,0.167,0,0.167,14.2,5,0,5,0.0,10,0.5,0,0.5,5.9,6,0,6,0.0,16,0.375,0,0.375,7.3,2015-16,Playoffs
202730,Lavoy Allen,1610612754,IND,4,1,3,45.0,4,3,1,0.75,12,0.333,0,0.333,5.0,10,5,5,0.5,17,0.588,1,0.625,5.7,14,8,6,0.571,29,0.483,1,0.5,5.5,2015-16,Playoffs
2544,LeBron James,1610612739,CLE,21,16,5,822.0,42,25,17,0.595,118,0.356,1,0.359,6.4,158,34,123,0.215,230,0.687,13,0.728,6.4,200,59,140,0.295,348,0.575,14,0.599,6.4,2015-16,Playoffs
2571,Leandro Barbosa,1610612744,GSW,14,10,4,178.0,11,4,7,0.364,22,0.5,0,0.5,8.9,16,4,13,0.25,32,0.5,5,0.593,8.3,27,8,20,0.296,54,0.5,5,0.551,8.5,2015-16,Playoffs
201601,Luc Mbah a Moute,1610612746,LAC,4,2,2,68.0,2,2,0,1.0,5,0.4,0,0.4,2.4,8,1,7,0.125,18,0.444,2,0.5,7.5,10,3,7,0.3,23,0.435,2,0.476,6.5,2015-16,Playoffs
203512,Lucas Nogueira,1610612761,TOR,4,0,4,28.0,1,1,0,1.0,1,1.0,0,1.0,1.2,7,1,6,0.143,12,0.583,0,0.583,4.3,8,2,6,0.25,13,0.615,0,0.615,3.9,2015-16,Playoffs
2449,Luis Scola,1610612761,TOR,7,2,5,99.0,2,1,1,0.5,9,0.222,0,0.222,17.9,16,7,9,0.438,24,0.667,1,0.696,4.7,18,8,10,0.444,33,0.545,1,0.563,6.2,2015-16,Playoffs
2736,Luol Deng,1610612748,MIA,14,7,7,495.0,19,15,5,0.789,47,0.404,0,0.404,7.9,64,12,51,0.188,129,0.496,12,0.547,6.4,83,27,56,0.325,176,0.472,12,0.506,6.8,2015-16,Playoffs
1938,Manu Ginobili,1610612759,SAS,10,6,4,192.0,6,1,5,0.167,10,0.6,0,0.6,17.4,21,6,15,0.286,40,0.525,5,0.6,6.9,27,7,20,0.259,50,0.54,5,0.6,9.3,2015-16,Playoffs
202694,Marcus Morris Sr.,1610612765,DET,4,0,4,144.0,2,0,2,0.0,3,0.667,0,0.667,18.3,11,3,8,0.273,25,0.44,3,0.5,8.4,13,3,10,0.231,28,0.464,3,0.52,9.9,2015-16,Playoffs
203935,Marcus Smart,1610612738,BOS,6,2,4,193.0,8,5,3,0.625,30,0.267,1,0.276,7.1,19,4,15,0.211,39,0.487,3,0.528,7.0,27,9,18,0.333,69,0.391,4,0.415,7.0,2015-16,Playoffs
201578,Marreese Speights,1610612744,GSW,18,11,7,180.0,15,14,1,0.933,37,0.405,4,0.455,4.7,32,12,20,0.375,58,0.552,4,0.593,3.9,47,26,21,0.553,95,0.495,8,0.54,4.2,2015-16,Playoffs
101107,Marvin Williams,1610612766,CHA,7,3,4,228.0,7,5,2,0.714,21,0.333,0,0.333,8.0,41,7,32,0.171,49,0.837,1,0.854,5.6,48,12,34,0.25,70,0.686,1,0.696,6.0,2015-16,Playoffs
203486,Mason Plumlee,1610612757,POR,11,5,6,306.0,37,23,15,0.622,82,0.451,3,0.468,5.7,93,20,73,0.215,142,0.655,11,0.71,3.9,130,43,88,0.331,224,0.58,14,0.619,4.4,2015-16,Playoffs
2440,Matt Barnes,1610612763,MEM,4,0,4,139.0,5,2,3,0.4,16,0.313,3,0.385,12.5,24,5,19,0.208,41,0.585,3,0.632,6.3,29,7,22,0.241,57,0.509,6,0.569,7.4,2015-16,Playoffs
203521,Matthew Dellavedova,1610612739,CLE,11,7,4,153.0,3,0,3,0.0,10,0.3,0,0.3,26.2,11,2,9,0.182,25,0.44,1,0.458,10.8,14,2,12,0.143,35,0.4,1,0.412,14.1,2015-16,Playoffs
203090,Maurice Harkless,1610612757,POR,10,4,6,265.0,22,17,5,0.773,47,0.468,1,0.478,6.0,34,3,30,0.088,36,0.944,3,1.03,8.0,56,20,35,0.357,83,0.675,4,0.709,7.2,2015-16,Playoffs
201563,Michael Beasley,1610612745,HOU,5,1,4,80.0,4,1,3,0.25,12,0.333,1,0.364,4.3,17,3,11,0.176,20,0.85,1,0.895,3.7,21,4,14,0.19,32,0.656,2,0.7,3.8,2015-16,Playoffs
203488,Mike Muscala,1610612737,ATL,8,4,4,66.0,7,6,1,0.857,15,0.467,0,0.467,4.8,10,3,7,0.3,28,0.357,0,0.357,5.7,17,9,8,0.529,43,0.395,0,0.395,5.3,2015-16,Playoffs
203118,Mike Scott,1610612737,ATL,9,4,5,158.0,5,5,0,1.0,16,0.313,0,0.313,4.6,27,9,18,0.333,43,0.628,2,0.659,4.5,32,14,18,0.438,59,0.542,2,0.561,4.5,2015-16,Playoffs
2590,Mo Williams,1610612739,CLE,4,4,0,31.0,0,0,0,0.0,1,0.0,0,0.0,0.0,6,3,3,0.5,7,0.857,0,0.857,8.2,6,3,3,0.5,8,0.75,0,0.75,8.2,2015-16,Playoffs
101145,Monta Ellis,1610612754,IND,7,3,4,225.0,4,2,2,0.5,18,0.222,2,0.25,17.8,23,4,19,0.174,42,0.548,3,0.59,7.9,27,6,21,0.222,60,0.45,5,0.491,9.3,2015-16,Playoffs
1626149,Montrezl Harrell,1610612745,HOU,1,0,1,6.0,0,0,0,0.0,0,0.0,0,0.0,0.0,2,0,2,0.0,2,1.0,0,1.0,4.2,2,0,2,0.0,2,1.0,0,1.0,4.2,2015-16,Playoffs
1626167,Myles Turner,1610612754,IND,7,3,4,197.0,16,12,4,0.75,25,0.64,0,0.64,5.1,29,13,16,0.448,72,0.403,4,0.426,4.3,45,25,20,0.556,97,0.464,4,0.484,4.6,2015-16,Playoffs
1737,Nazr Mohammed,1610612760,OKC,3,2,1,9.0,1,1,0,1.0,1,1.0,0,1.0,5.4,2,1,1,0.5,3,0.667,0,0.667,5.6,3,2,1,0.667,4,0.75,0,0.75,5.5,2015-16,Playoffs
2555,Nick Collison,1610612760,OKC,7,4,3,66.0,3,2,1,0.667,9,0.333,0,0.333,7.2,8,1,7,0.125,9,0.889,1,1.0,7.4,11,3,8,0.273,18,0.611,1,0.647,7.4,2015-16,Playoffs
201587,Nicolas Batum,1610612766,CHA,5,1,4,144.0,2,0,2,0.0,8,0.25,0,0.25,12.1,16,2,15,0.125,27,0.593,0,0.593,5.4,18,2,17,0.111,35,0.514,0,0.514,6.1,2015-16,Playoffs
203943,Noah Vonleh,1610612757,POR,3,1,2,9.0,1,0,0,0.0,2,0.5,0,0.5,0.0,3,0,3,0.0,3,1.0,0,1.0,4.0,4,0,3,0.0,5,0.8,0,0.8,4.0,2015-16,Playoffs
1626181,Norman Powell,1610612761,TOR,15,6,9,181.0,4,0,4,0.0,15,0.267,0,0.267,10.7,23,6,17,0.261,33,0.697,1,0.719,6.8,27,6,21,0.222,48,0.563,1,0.574,7.4,2015-16,Playoffs
203143,Pablo Prigioni,1610612746,LAC,2,0,2,19.0,2,1,1,0.5,2,1.0,0,1.0,6.0,1,0,1,0.0,2,0.5,0,0.5,13.6,3,1,2,0.333,4,0.75,0,0.75,8.5,2015-16,Playoffs
1626192,Pat Connaughton,1610612757,POR,1,0,1,1.0,0,0,0,0.0,0,0.0,0,0.0,0.0,1,0,1,0.0,1,1.0,0,1.0,13.0,1,0,1,0.0,1,1.0,0,1.0,13.0,2015-16,Playoffs
201976,Patrick Beverley,1610612745,HOU,5,1,4,129.0,4,1,3,0.25,21,0.19,2,0.211,11.1,18,3,15,0.167,33,0.545,2,0.581,8.6,22,4,18,0.182,54,0.407,4,0.44,9.1,2015-16,Playoffs
202335,Patrick Patterson,1610612761,TOR,19,10,9,564.0,29,16,12,0.552,69,0.42,5,0.453,7.5,48,15,31,0.313,100,0.48,8,0.522,6.2,77,31,43,0.403,169,0.456,13,0.494,6.7,2015-16,Playoffs
201988,Patty Mills,1610612759,SAS,6,3,3,102.0,0,0,0,0.0,5,0.0,0,0.0,0.0,14,1,13,0.071,18,0.778,1,0.824,11.0,14,1,13,0.071,23,0.609,1,0.636,11.0,2015-16,Playoffs
202331,Paul George,1610612754,IND,7,3,4,275.0,9,8,2,0.889,30,0.3,2,0.321,7.3,44,9,34,0.205,86,0.512,7,0.557,8.1,53,17,36,0.321,116,0.457,9,0.495,8.0,2015-16,Playoffs
200794,Paul Millsap,1610612737,ATL,10,4,6,365.0,28,19,8,0.679,68,0.412,3,0.431,6.9,66,26,40,0.394,130,0.508,18,0.589,4.6,94,45,48,0.479,198,0.475,21,0.531,5.2,2015-16,Playoffs
1718,Paul Pierce,1610612746,LAC,4,0,4,43.0,0,0,0,0.0,1,0.0,0,0.0,0.0,6,2,4,0.333,13,0.462,1,0.5,5.3,6,2,4,0.333,14,0.429,1,0.462,5.3,2015-16,Playoffs
1626154,RJ Hunter,1610612738,BOS,4,1,3,26.0,1,0,1,0.0,1,1.0,0,1.0,22.9,5,1,4,0.2,6,0.833,0,0.833,7.7,6,1,5,0.167,7,0.857,0,0.857,10.3,2015-16,Playoffs
200751,Randy Foye,1610612760,OKC,11,7,4,137.0,2,0,2,0.0,9,0.222,0,0.222,16.2,18,7,11,0.389,30,0.6,2,0.643,5.3,20,7,13,0.35,39,0.513,2,0.541,6.4,2015-16,Playoffs
101109,Raymond Felton,1610612742,DAL,5,1,4,172.0,2,0,2,0.0,17,0.118,0,0.118,13.3,21,5,16,0.238,36,0.583,2,0.618,10.9,23,5,18,0.217,53,0.434,2,0.451,11.1,2015-16,Playoffs
203493,Reggie Bullock Jr.,1610612765,DET,1,0,1,12.0,0,0,0,0.0,0,0.0,0,0.0,0.0,2,1,1,0.5,3,0.667,0,0.667,1.2,2,1,1,0.5,3,0.667,0,0.667,1.2,2015-16,Playoffs
202704,Reggie Jackson,1610612765,DET,4,0,4,147.0,2,1,1,0.5,5,0.4,0,0.4,3.6,11,1,10,0.091,24,0.458,3,0.524,8.7,13,2,11,0.154,29,0.448,3,0.5,7.9,2015-16,Playoffs
2210,Richard Jefferson,1610612739,CLE,17,13,4,338.0,16,8,7,0.5,44,0.364,1,0.372,5.4,58,12,45,0.207,89,0.652,7,0.707,6.5,74,20,52,0.27,133,0.556,8,0.592,6.3,2015-16,Playoffs
201155,Rodney Stuckey,1610612754,IND,7,3,4,125.0,1,1,0,1.0,11,0.091,1,0.1,14.2,14,2,12,0.143,35,0.4,8,0.519,8.6,15,3,12,0.2,46,0.326,9,0.405,8.9,2015-16,Playoffs
201566,Russell Westbrook,1610612760,OKC,17,10,7,640.0,41,20,19,0.488,115,0.357,4,0.369,9.4,83,12,70,0.145,143,0.58,8,0.615,8.1,124,32,89,0.258,258,0.481,12,0.504,8.5,2015-16,Playoffs
1626257,Salah Mejri,1610612742,DAL,4,1,3,76.0,5,3,2,0.6,15,0.333,1,0.357,7.5,8,6,2,0.75,20,0.4,4,0.5,4.5,13,9,4,0.692,35,0.371,5,0.433,5.7,2015-16,Playoffs
201586,Serge Ibaka,1610612760,OKC,18,11,7,602.0,23,13,10,0.565,54,0.426,2,0.442,7.6,90,26,62,0.289,159,0.566,16,0.629,4.7,113,39,72,0.345,213,0.531,18,0.579,5.3,2015-16,Playoffs
2733,Shaun Livingston,1610612744,GSW,24,15,9,514.0,13,8,5,0.615,40,0.325,0,0.325,8.2,63,8,53,0.127,107,0.589,8,0.636,8.2,76,16,58,0.211,147,0.517,8,0.547,8.2,2015-16,Playoffs
203524,Solomon Hill,1610612754,IND,7,3,4,198.0,5,2,3,0.4,19,0.263,1,0.278,11.5,23,4,20,0.174,56,0.411,7,0.469,9.0,28,6,23,0.214,75,0.373,8,0.418,9.4,2015-16,Playoffs
201150,Spencer Hawes,1610612766,CHA,5,3,2,53.0,3,1,2,0.333,5,0.6,0,0.6,8.6,13,3,10,0.231,27,0.481,3,0.542,3.8,16,4,12,0.25,32,0.5,3,0.552,4.7,2015-16,Playoffs
1626169,Stanley Johnson,1610612765,DET,4,0,4,81.0,0,0,0,0.0,3,0.0,0,0.0,0.0,16,4,12,0.25,35,0.457,2,0.485,4.9,16,4,12,0.25,38,0.421,2,0.444,4.9,2015-16,Playoffs
201939,Stephen Curry,1610612744,GSW,17,10,7,596.0,14,8,6,0.571,79,0.177,3,0.184,8.4,85,16,70,0.188,144,0.59,12,0.644,9.6,99,24,76,0.242,223,0.444,15,0.476,9.4,2015-16,Playoffs
2581,Steve Blake,1610612765,DET,3,0,3,34.0,0,0,0,0.0,0,0.0,0,0.0,0.0,4,0,4,0.0,5,0.8,0,0.8,8.6,4,0,4,0.0,5,0.8,0,0.8,8.6,2015-16,Playoffs
203500,Steven Adams,1610612760,OKC,18,11,7,553.0,62,38,23,0.613,159,0.39,6,0.405,5.4,109,32,76,0.294,193,0.565,19,0.626,4.0,171,70,99,0.409,352,0.486,25,0.523,4.5,2015-16,Playoffs
203082,Terrence Ross,1610612761,TOR,18,9,9,323.0,4,2,2,0.5,24,0.167,1,0.174,11.9,28,1,27,0.036,54,0.519,2,0.538,6.0,32,3,29,0.094,78,0.41,3,0.427,6.8,2015-16,Playoffs
1626179,Terry Rozier,1610612738,BOS,5,2,3,99.0,3,1,2,0.333,5,0.6,0,0.6,6.0,14,3,10,0.214,17,0.824,0,0.824,5.7,17,4,12,0.235,22,0.773,0,0.773,5.7,2015-16,Playoffs
200757,Thabo Sefolosha,1610612737,ATL,10,4,6,203.0,8,5,3,0.625,18,0.444,0,0.444,5.6,33,5,28,0.152,57,0.579,7,0.66,5.2,41,10,31,0.244,75,0.547,7,0.603,5.3,2015-16,Playoffs
1495,Tim Duncan,1610612759,SAS,10,6,4,218.0,10,5,5,0.5,43,0.233,0,0.233,8.8,38,15,23,0.395,70,0.543,6,0.594,3.8,48,20,28,0.417,113,0.425,6,0.449,4.9,2015-16,Playoffs
203501,Tim Hardaway Jr.,1610612737,ATL,3,2,1,52.0,0,0,0,0.0,1,0.0,0,0.0,0.0,8,1,7,0.125,12,0.667,1,0.727,7.1,8,1,7,0.125,13,0.615,1,0.667,7.1,2015-16,Playoffs
202389,Timofey Mozgov,1610612739,CLE,8,6,2,58.0,5,1,3,0.2,14,0.357,0,0.357,6.0,16,5,11,0.313,20,0.8,1,0.842,4.2,21,6,14,0.286,34,0.618,1,0.636,4.6,2015-16,Playoffs
202699,Tobias Harris,1610612765,DET,4,0,4,156.0,6,2,3,0.333,15,0.4,1,0.429,12.8,32,8,24,0.25,54,0.593,3,0.627,5.3,38,10,27,0.263,69,0.551,4,0.585,6.4,2015-16,Playoffs
2754,Tony Allen,1610612763,MEM,4,0,4,94.0,6,5,1,0.833,20,0.3,1,0.316,4.6,5,0,5,0.0,10,0.5,2,0.625,10.2,11,5,6,0.455,30,0.367,3,0.407,7.1,2015-16,Playoffs
2225,Tony Parker,1610612759,SAS,10,6,4,264.0,1,0,1,0.0,16,0.063,0,0.063,14.2,21,1,23,0.048,41,0.512,2,0.538,11.6,22,1,24,0.045,57,0.386,2,0.4,11.7,2015-16,Playoffs
2772,Trevor Ariza,1610612745,HOU,5,1,4,181.0,7,5,2,0.714,23,0.304,0,0.304,7.5,14,0,14,0.0,21,0.667,3,0.778,11.8,21,5,16,0.238,44,0.477,3,0.512,10.3,2015-16,Playoffs
202684,Tristan Thompson,1610612739,CLE,21,16,5,622.0,86,66,19,0.767,203,0.424,9,0.443,6.1,102,30,72,0.294,170,0.6,12,0.646,5.7,188,96,91,0.511,373,0.504,21,0.534,5.9,2015-16,Playoffs
203584,Troy Daniels,1610612766,CHA,1,0,1,9.0,0,0,0,0.0,2,0.0,0,0.0,0.0,2,2,0,1.0,3,0.667,0,0.667,5.7,2,2,0,1.0,5,0.4,0,0.4,5.7,2015-16,Playoffs
201951,Ty Lawson,1610612754,IND,4,3,1,46.0,1,0,1,0.0,4,0.25,0,0.25,7.0,6,1,5,0.167,8,0.75,0,0.75,10.5,7,1,6,0.143,12,0.583,0,0.583,10.0,2015-16,Playoffs
204020,Tyler Johnson,1610612748,MIA,3,2,1,43.0,2,2,0,1.0,4,0.5,0,0.5,5.8,5,0,5,0.0,12,0.417,1,0.455,4.5,7,2,5,0.286,16,0.438,1,0.467,4.9,2015-16,Playoffs
203092,Tyler Zeller,1610612738,BOS,3,0,3,38.0,4,3,1,0.75,8,0.5,0,0.5,17.0,11,3,8,0.273,16,0.688,0,0.688,4.1,15,6,9,0.4,24,0.625,0,0.625,7.6,2015-16,Playoffs
2617,Udonis Haslem,1610612748,MIA,7,3,4,83.0,11,8,3,0.727,20,0.55,0,0.55,7.7,20,5,15,0.25,32,0.625,1,0.645,3.3,31,13,18,0.419,52,0.596,1,0.608,4.8,2015-16,Playoffs
1713,Vince Carter,1610612763,MEM,4,0,4,91.0,5,4,1,0.8,12,0.417,0,0.417,5.3,10,3,7,0.3,19,0.526,2,0.588,5.4,15,7,8,0.467,31,0.484,2,0.517,5.3,2015-16,Playoffs
202325,Wesley Johnson,1610612746,LAC,6,2,4,77.0,5,3,2,0.6,7,0.714,0,0.714,10.2,13,5,8,0.385,26,0.5,3,0.565,7.4,18,8,10,0.444,33,0.545,3,0.6,8.2,2015-16,Playoffs
202083,Wesley Matthews,1610612742,DAL,5,1,4,173.0,4,2,1,0.5,7,0.571,0,0.571,12.9,14,1,13,0.071,24,0.583,1,0.609,11.8,18,3,14,0.167,31,0.581,1,0.6,12.0,2015-16,Playoffs
204098,Xavier Munford,1610612763,MEM,4,0,4,89.0,1,0,1,0.0,7,0.143,0,0.143,28.5,8,0,8,0.0,11,0.727,0,0.727,15.9,9,0,9,0.0,18,0.5,0,0.5,17.3,2015-16,Playoffs
2216,Zach Randolph,1610612763,MEM,4,0,4,120.0,15,14,1,0.933,42,0.357,1,0.366,4.2,20,6,14,0.3,29,0.69,1,0.714,4.0,35,20,15,0.571,71,0.493,2,0.507,4.1,2015-16,Playoffs
2585,Zaza Pachulia,1610612742,DAL,5,1,4,112.0,10,8,2,0.8,33,0.303,2,0.323,6.8,17,5,12,0.294,40,0.425,6,0.5,3.6,27,13,14,0.481,73,0.37,8,0.415,4.8,2015-16,Playoffs
1627773,AJ Hammons,1610612742,DAL,16,3,13,150.0,8,3,5,0.375,29,0.276,1,0.286,7.5,28,10,18,0.357,55,0.509,4,0.549,3.9,36,13,23,0.361,84,0.429,5,0.456,4.7,2016-17,Regular%20Season
201166,Aaron Brooks,1610612754,IND,40,23,17,581.0,18,4,14,0.222,53,0.34,2,0.353,13.2,51,6,47,0.118,89,0.573,2,0.586,9.9,69,10,61,0.145,142,0.486,4,0.5,10.8,2016-17,Regular%20Season
203932,Aaron Gordon,1610612753,ORL,79,29,50,2266.0,116,64,51,0.552,272,0.426,6,0.436,7.5,289,66,220,0.228,477,0.606,33,0.651,6.6,405,130,271,0.321,748,0.541,39,0.571,6.8,2016-17,Regular%20Season
1626151,Aaron Harrison,1610612766,CHA,3,1,2,10.0,0,0,0,0.0,0,0.0,0,0.0,0.0,3,0,3,0.0,3,1.0,0,1.0,5.5,3,0,3,0.0,3,1.0,0,1.0,5.5,2016-17,Regular%20Season
203940,Adreian Payne,1610612750,MIN,16,5,11,121.0,9,5,3,0.556,22,0.409,1,0.429,10.3,24,4,19,0.167,32,0.75,3,0.828,4.7,33,9,22,0.273,54,0.611,4,0.66,6.1,2016-17,Regular%20Season
201143,Al Horford,1610612738,BOS,68,46,22,2193.0,95,51,44,0.537,251,0.378,8,0.391,9.4,370,120,248,0.324,676,0.547,48,0.589,6.3,465,171,292,0.368,927,0.502,56,0.534,7.0,2016-17,Regular%20Season
2744,Al Jefferson,1610612754,IND,63,32,31,910.0,74,52,23,0.703,158,0.468,3,0.477,6.2,202,70,131,0.347,308,0.656,24,0.711,4.2,276,122,154,0.442,466,0.592,27,0.629,4.7,2016-17,Regular%20Season
202329,Al-Farouq Aminu,1610612757,POR,60,32,28,1769.0,77,39,34,0.506,196,0.393,4,0.401,7.2,374,111,258,0.297,637,0.587,57,0.645,5.5,451,150,292,0.333,829,0.544,61,0.587,5.8,2016-17,Regular%20Season
101187,Alan Anderson,1610612746,LAC,15,10,5,191.0,3,3,0,1.0,13,0.231,3,0.3,8.9,21,2,19,0.095,34,0.618,2,0.656,6.8,24,5,19,0.208,47,0.511,5,0.571,7.0,2016-17,Regular%20Season
1626210,Alan Williams,1610612756,PHX,39,10,29,691.0,94,60,28,0.638,211,0.445,4,0.454,6.1,197,66,129,0.335,303,0.65,19,0.694,4.2,291,126,157,0.433,514,0.566,23,0.593,4.8,2016-17,Regular%20Season
202692,Alec Burks,1610612762,UTA,36,21,15,615.0,17,8,9,0.471,53,0.321,2,0.333,9.2,103,26,77,0.252,165,0.624,13,0.678,6.2,120,34,86,0.283,218,0.55,15,0.591,6.6,2016-17,Regular%20Season
203518,Alex Abrines,1610612760,OKC,43,25,18,771.0,18,8,10,0.444,50,0.36,2,0.375,10.6,67,16,51,0.239,128,0.523,11,0.573,8.1,85,24,61,0.282,178,0.478,13,0.515,8.6,2016-17,Regular%20Season
203458,Alex Len,1610612756,PHX,72,20,52,1491.0,155,99,47,0.639,359,0.432,9,0.443,5.6,347,117,228,0.337,582,0.596,49,0.651,4.4,502,216,275,0.43,940,0.534,58,0.569,4.7,2016-17,Regular%20Season
1627816,Alex Poythress,1610612755,PHI,6,0,6,157.0,11,7,3,0.636,25,0.44,0,0.44,4.8,18,7,10,0.389,42,0.429,4,0.474,7.2,29,14,13,0.483,67,0.433,4,0.46,6.3,2016-17,Regular%20Season
201582,Alexis Ajinca,1610612740,NOP,37,14,23,574.0,46,33,13,0.717,121,0.38,3,0.39,5.2,130,40,89,0.308,221,0.588,10,0.616,4.7,176,73,102,0.415,341,0.516,13,0.537,4.8,2016-17,Regular%20Season
203459,Allen Crabbe,1610612757,POR,73,38,35,2114.0,19,6,13,0.316,99,0.192,4,0.2,19.3,206,48,159,0.233,393,0.524,27,0.563,7.3,225,54,172,0.24,492,0.457,31,0.488,8.3,2016-17,Regular%20Season
202087,Alonzo Gee,1610612743,DEN,8,2,6,78.0,4,2,2,0.5,9,0.444,1,0.5,4.4,11,4,8,0.364,19,0.579,4,0.733,6.1,15,6,10,0.4,28,0.536,5,0.652,5.7,2016-17,Regular%20Season
101161,Amir Johnson,1610612738,BOS,79,51,28,1604.0,118,83,29,0.703,324,0.364,8,0.373,5.3,248,105,143,0.423,515,0.482,52,0.536,4.5,366,188,172,0.514,839,0.436,60,0.47,4.8,2016-17,Regular%20Season
2760,Anderson Varejao,1610612744,GSW,12,11,1,84.0,12,7,4,0.583,18,0.667,1,0.706,6.8,15,5,10,0.333,25,0.6,5,0.75,5.1,27,12,14,0.444,43,0.628,6,0.73,5.8,2016-17,Regular%20Season
203083,Andre Drummond,1610612765,DET,81,36,45,2409.0,345,263,77,0.762,646,0.534,12,0.544,5.1,770,262,505,0.34,1071,0.719,68,0.768,3.6,1115,525,582,0.471,1714,0.651,80,0.682,4.0,2016-17,Regular%20Season
2738,Andre Iguodala,1610612744,GSW,74,62,12,1958.0,51,22,28,0.431,105,0.486,7,0.52,10.2,253,61,189,0.241,449,0.563,30,0.604,9.3,304,83,217,0.273,554,0.549,37,0.588,9.4,2016-17,Regular%20Season
203460,Andre Roberson,1610612760,OKC,78,46,32,2360.0,98,57,38,0.582,310,0.316,7,0.323,7.2,305,74,228,0.243,565,0.54,42,0.583,6.0,403,131,266,0.325,873,0.462,49,0.489,6.3,2016-17,Regular%20Season
101106,Andrew Bogut,1610612739,CLE,25,8,17,562.0,56,38,17,0.679,111,0.505,3,0.519,6.2,162,50,110,0.309,256,0.633,26,0.704,4.1,218,88,127,0.404,364,0.599,29,0.651,4.6,2016-17,Regular%20Season
1626150,Andrew Harrison,1610612763,MEM,54,32,22,1265.0,23,5,18,0.217,94,0.245,1,0.247,17.9,113,15,97,0.133,222,0.509,20,0.559,9.6,136,20,115,0.147,316,0.43,21,0.461,11.0,2016-17,Regular%20Season
203094,Andrew Nicholson,1610612751,BKN,25,9,16,253.0,15,9,6,0.6,30,0.5,0,0.5,4.6,45,16,30,0.356,85,0.529,7,0.577,4.8,60,25,36,0.417,113,0.531,7,0.566,4.7,2016-17,Regular%20Season
203952,Andrew Wiggins,1610612750,MIN,79,31,48,2946.0,102,68,30,0.667,338,0.302,8,0.309,6.8,226,74,151,0.327,437,0.517,35,0.562,7.4,328,142,181,0.433,775,0.423,43,0.448,7.3,2016-17,Regular%20Season
203461,Anthony Bennett,1610612751,BKN,19,3,16,222.0,21,15,3,0.714,41,0.512,0,0.512,6.1,47,13,34,0.277,73,0.644,3,0.671,4.4,68,28,37,0.412,114,0.596,3,0.613,4.9,2016-17,Regular%20Season
1626148,Anthony Brown,1610612753,ORL,10,2,8,156.0,8,2,5,0.25,13,0.615,1,0.667,14.3,25,3,22,0.12,34,0.735,3,0.806,8.3,33,5,27,0.152,47,0.702,4,0.767,9.6,2016-17,Regular%20Season
203076,Anthony Davis,1610612740,NOP,75,31,44,2708.0,172,123,46,0.715,362,0.475,10,0.489,6.2,712,249,461,0.35,1053,0.676,61,0.718,4.8,884,372,507,0.421,1410,0.627,71,0.66,5.0,2016-17,Regular%20Season
201627,Anthony Morrow,1610612741,CHI,21,10,11,415.0,12,6,5,0.5,32,0.375,0,0.375,12.9,19,2,18,0.105,41,0.463,4,0.514,13.6,31,8,23,0.258,73,0.425,4,0.449,13.1,2016-17,Regular%20Season
201229,Anthony Tolliver,1610612758,SAC,61,25,36,1439.0,51,20,30,0.392,132,0.386,4,0.398,8.2,186,50,135,0.269,336,0.554,31,0.61,6.3,237,70,165,0.295,464,0.511,35,0.552,6.7,2016-17,Regular%20Season
203462,Archie Goodwin,1610612751,BKN,9,5,4,148.0,7,3,3,0.429,23,0.304,0,0.304,7.2,21,2,19,0.095,31,0.677,0,0.677,6.6,28,5,22,0.179,54,0.519,0,0.519,6.7,2016-17,Regular%20Season
202620,Arinze Onuaku,1610612753,ORL,4,1,3,19.0,2,2,0,1.0,3,0.667,0,0.667,2.3,4,3,1,0.75,8,0.5,0,0.5,2.2,6,5,1,0.833,11,0.545,0,0.545,2.2,2016-17,Regular%20Season
203382,Aron Baynes,1610612765,DET,70,32,38,1110.0,111,81,28,0.73,292,0.38,5,0.387,5.1,222,82,135,0.369,394,0.563,53,0.651,4.4,333,163,163,0.489,684,0.487,58,0.532,4.7,2016-17,Regular%20Season
201167,Arron Afflalo,1610612758,SAC,52,20,32,1411.0,9,2,7,0.222,73,0.123,2,0.127,11.8,115,8,108,0.07,215,0.535,14,0.572,8.7,124,10,115,0.081,288,0.431,16,0.456,9.1,2016-17,Regular%20Season
203085,Austin Rivers,1610612746,LAC,64,39,25,1826.0,20,10,10,0.5,127,0.157,5,0.164,9.9,141,22,119,0.156,323,0.437,31,0.483,9.0,161,32,129,0.199,450,0.358,36,0.389,9.1,2016-17,Regular%20Season
202340,Avery Bradley,1610612738,BOS,54,34,20,1820.0,65,29,32,0.446,219,0.297,2,0.3,8.8,269,46,223,0.171,482,0.558,45,0.616,5.9,334,75,255,0.225,701,0.476,47,0.511,6.4,2016-17,Regular%20Season
1626253,Axel Toupane,1610612740,NOP,1,1,0,21.0,0,0,0,0.0,0,0.0,0,0.0,0.0,1,0,1,0.0,2,0.5,0,0.5,14.6,1,0,1,0.0,2,0.5,0,0.5,14.6,2016-17,Regular%20Season
1627791,Ben Bentil,1610612742,DAL,1,1,0,3.0,0,0,0,0.0,0,0.0,0,0.0,0.0,2,1,1,0.5,2,1.0,0,1.0,6.9,2,1,1,0.5,2,1.0,0,1.0,6.9,2016-17,Regular%20Season
203463,Ben McLemore,1610612758,SAC,45,20,25,981.0,19,9,11,0.474,92,0.207,3,0.213,8.6,110,16,90,0.145,205,0.537,23,0.604,6.5,129,25,101,0.194,296,0.436,26,0.478,6.9,2016-17,Regular%20Season
2757,Beno Udrih,1610612765,DET,29,13,16,498.0,6,1,5,0.167,34,0.176,0,0.176,21.5,51,7,44,0.137,87,0.586,5,0.622,8.9,57,8,49,0.14,121,0.471,5,0.491,10.2,2016-17,Regular%20Season
202687,Bismack Biyombo,1610612753,ORL,80,29,51,1778.0,157,100,51,0.637,362,0.434,6,0.441,6.2,410,128,282,0.312,687,0.597,57,0.651,4.4,567,228,333,0.402,1047,0.542,63,0.576,4.9,2016-17,Regular%20Season
201933,Blake Griffin,1610612746,LAC,61,40,21,2076.0,112,60,46,0.536,283,0.396,7,0.406,7.0,385,112,276,0.291,595,0.647,38,0.691,5.3,497,172,322,0.346,872,0.57,45,0.601,5.7,2016-17,Regular%20Season
1626246,Boban Marjanovic,1610612765,DET,28,11,17,277.0,46,36,9,0.783,86,0.535,3,0.554,4.1,84,26,58,0.31,111,0.757,6,0.8,4.7,130,62,67,0.477,196,0.663,9,0.695,4.4,2016-17,Regular%20Season
201628,Bobby Brown,1610612745,HOU,7,5,2,74.0,0,0,1,0.0,3,0.0,1,0.0,24.5,6,1,5,0.167,13,0.462,1,0.5,10.2,6,1,6,0.167,16,0.375,2,0.429,12.3,2016-17,Regular%20Season
1626171,Bobby Portis,1610612741,CHI,60,28,32,979.0,75,44,31,0.587,160,0.469,3,0.478,6.8,221,63,154,0.285,347,0.637,27,0.691,5.2,296,107,185,0.361,507,0.584,30,0.621,5.6,2016-17,Regular%20Season
202711,Bojan Bogdanovic,1610612764,WAS,80,23,57,2064.0,37,21,15,0.568,181,0.204,7,0.213,10.0,240,43,198,0.179,435,0.552,34,0.599,6.6,277,64,213,0.231,616,0.45,41,0.482,7.0,2016-17,Regular%20Season
2564,Boris Diaw,1610612762,UTA,65,39,26,1189.0,46,28,20,0.609,111,0.414,5,0.434,6.9,112,25,86,0.223,256,0.438,28,0.491,5.9,158,53,106,0.335,367,0.431,33,0.473,6.3,2016-17,Regular%20Season
203078,Bradley Beal,1610612764,WAS,71,45,26,2494.0,53,19,35,0.358,206,0.257,12,0.273,14.7,187,36,151,0.193,385,0.486,26,0.521,9.3,240,55,186,0.229,590,0.407,38,0.435,10.6,2016-17,Regular%20Season
201148,Brandan Wright,1610612763,MEM,26,13,13,429.0,31,16,13,0.516,70,0.443,3,0.463,6.1,47,21,27,0.447,87,0.54,3,0.56,5.1,78,37,40,0.474,157,0.497,6,0.517,5.5,2016-17,Regular%20Season
101138,Brandon Bass,1610612746,LAC,44,24,20,533.0,43,31,12,0.721,96,0.448,0,0.448,6.0,86,27,59,0.314,138,0.623,5,0.647,5.2,129,58,71,0.45,234,0.551,5,0.563,5.5,2016-17,Regular%20Season
1627742,Brandon Ingram,1610612747,LAL,77,25,52,2253.0,60,25,35,0.417,202,0.297,10,0.313,9.1,256,48,209,0.188,424,0.604,28,0.646,6.5,316,73,244,0.231,622,0.508,38,0.541,7.0,2016-17,Regular%20Season
201943,Brandon Jennings,1610612764,WAS,71,35,36,1624.0,29,5,23,0.172,108,0.269,7,0.287,13.4,167,16,154,0.096,300,0.557,24,0.605,9.6,196,21,177,0.107,408,0.48,31,0.52,10.1,2016-17,Regular%20Season
202688,Brandon Knight,1610612756,PHX,44,14,30,978.0,25,10,14,0.4,89,0.281,4,0.294,12.4,92,16,75,0.174,197,0.467,18,0.514,7.6,117,26,89,0.222,286,0.409,22,0.443,8.6,2016-17,Regular%20Season
201575,Brandon Rush,1610612750,MIN,39,12,27,938.0,16,6,9,0.375,52,0.308,4,0.333,13.0,83,14,68,0.169,164,0.506,12,0.546,7.6,99,20,77,0.202,216,0.458,16,0.495,8.4,2016-17,Regular%20Season
203148,Brian Roberts,1610612766,CHA,27,9,18,322.0,5,3,2,0.6,20,0.25,0,0.25,10.1,34,4,30,0.118,56,0.607,5,0.667,9.6,39,7,32,0.179,76,0.513,5,0.549,9.6,2016-17,Regular%20Season
1627362,Briante Weber,1610612766,CHA,13,7,6,160.0,8,2,5,0.25,16,0.5,0,0.5,9.2,18,1,17,0.056,31,0.581,2,0.621,6.0,26,3,22,0.115,47,0.553,2,0.578,6.9,2016-17,Regular%20Season
1627744,Brice Johnson,1610612746,LAC,2,0,2,7.0,1,1,0,1.0,2,0.5,0,0.5,3.4,2,1,1,0.5,4,0.5,0,0.5,2.4,3,2,1,0.667,6,0.5,0,0.5,2.8,2016-17,Regular%20Season
201572,Brook Lopez,1610612751,BKN,75,20,55,2222.0,121,85,35,0.702,287,0.422,6,0.431,6.6,282,113,169,0.401,554,0.509,47,0.556,6.5,403,198,204,0.491,840,0.48,53,0.512,6.5,2016-17,Regular%20Season
203998,Bruno Caboclo,1610612761,TOR,4,4,0,27.0,4,3,1,0.75,5,0.8,0,0.8,3.1,5,2,3,0.4,6,0.833,1,1.0,3.7,9,5,4,0.556,11,0.818,1,0.9,3.4,2016-17,Regular%20Season
1627854,Bryn Forbes,1610612759,SAS,17,11,6,220.0,2,0,1,0.0,12,0.167,2,0.2,19.6,20,3,18,0.15,36,0.556,2,0.588,10.4,22,3,19,0.136,47,0.468,4,0.512,10.8,2016-17,Regular%20Season
1627741,Buddy Hield,1610612758,SAC,76,28,48,1837.0,35,10,24,0.286,146,0.24,6,0.25,11.2,234,29,205,0.124,417,0.561,32,0.608,7.8,269,39,229,0.145,563,0.478,38,0.512,8.3,2016-17,Regular%20Season
201228,C.J. Watson,1610612753,ORL,41,13,28,781.0,16,1,15,0.063,51,0.314,5,0.348,16.5,73,11,62,0.151,118,0.619,10,0.676,9.2,89,12,77,0.135,169,0.527,15,0.578,10.5,2016-17,Regular%20Season
203912,C.J. Wilcox,1610612753,ORL,9,3,6,64.0,4,0,4,0.0,6,0.667,0,0.667,19.8,8,1,7,0.125,16,0.5,3,0.615,8.4,12,1,11,0.083,22,0.545,3,0.632,12.2,2016-17,Regular%20Season
203468,CJ McCollum,1610612757,POR,77,39,38,2681.0,60,19,43,0.317,228,0.263,8,0.273,14.2,229,31,200,0.135,484,0.473,34,0.509,9.3,289,50,243,0.173,710,0.407,42,0.433,10.3,2016-17,Regular%20Season
101139,CJ Miles,1610612754,IND,71,36,35,1695.0,28,12,16,0.429,92,0.304,4,0.318,13.0,197,41,157,0.208,308,0.64,19,0.682,8.2,225,53,173,0.236,400,0.563,23,0.597,8.8,2016-17,Regular%20Season
1626166,Cameron Payne,1610612741,CHI,24,11,13,358.0,3,1,2,0.333,30,0.1,0,0.1,8.9,45,2,44,0.044,74,0.608,4,0.643,8.4,48,3,46,0.063,104,0.462,4,0.48,8.4,2016-17,Regular%20Season
1627747,Caris LeVert,1610612751,BKN,55,15,40,1204.0,23,9,12,0.391,88,0.261,4,0.274,13.7,164,23,141,0.14,252,0.651,16,0.695,7.1,187,32,153,0.171,340,0.55,20,0.584,7.8,2016-17,Regular%20Season
2546,Carmelo Anthony,1610612752,NYK,74,29,45,2538.0,62,41,22,0.661,245,0.253,3,0.256,7.5,376,81,294,0.215,615,0.611,36,0.649,6.3,438,122,316,0.279,859,0.51,39,0.534,6.5,2016-17,Regular%20Season
202718,Chandler Parsons,1610612763,MEM,31,16,15,619.0,6,3,4,0.5,33,0.182,1,0.188,7.4,78,14,66,0.179,119,0.655,7,0.696,7.7,84,17,70,0.202,152,0.553,8,0.583,7.8,2016-17,Regular%20Season
101112,Channing Frye,1610612739,CLE,70,40,30,1337.0,37,21,16,0.568,102,0.363,3,0.374,9.5,253,89,162,0.352,445,0.569,37,0.62,5.1,290,110,178,0.379,546,0.531,40,0.573,5.6,2016-17,Regular%20Season
1626184,Chasson Randle,1610612752,NYK,16,6,10,255.0,6,2,4,0.333,22,0.273,2,0.3,11.9,26,5,21,0.192,41,0.634,4,0.703,11.2,32,7,25,0.219,63,0.508,6,0.561,11.3,2016-17,Regular%20Season
1627767,Cheick Diallo,1610612740,NOP,13,5,8,186.0,23,14,10,0.609,44,0.523,0,0.523,6.3,50,11,39,0.22,70,0.714,4,0.758,5.0,73,25,49,0.342,114,0.64,4,0.664,5.4,2016-17,Regular%20Season
1627778,Chinanu Onuaku,1610612745,HOU,3,2,1,42.0,2,0,2,0.0,9,0.222,0,0.222,5.5,8,4,4,0.5,11,0.727,0,0.727,5.7,10,4,6,0.4,20,0.5,0,0.5,5.7,2016-17,Regular%20Season
2365,Chris Andersen,1610612739,CLE,10,6,4,105.0,9,8,1,0.889,26,0.346,0,0.346,7.0,22,6,16,0.273,50,0.44,5,0.489,4.3,31,14,17,0.452,76,0.408,5,0.437,5.1,2016-17,Regular%20Season
1626191,Chris McCullough,1610612764,WAS,10,0,10,61.0,9,4,5,0.444,14,0.643,0,0.643,7.5,10,1,9,0.1,18,0.556,2,0.625,4.0,19,5,14,0.263,32,0.594,2,0.633,5.7,2016-17,Regular%20Season
101108,Chris Paul,1610612746,LAC,61,43,18,1921.0,40,16,26,0.4,136,0.294,6,0.308,15.7,264,32,233,0.121,498,0.53,29,0.563,8.0,304,48,259,0.158,634,0.479,35,0.508,9.1,2016-17,Regular%20Season
1626174,Christian Wood,1610612766,CHA,8,3,5,91.0,14,11,3,0.786,23,0.609,0,0.609,4.0,15,3,12,0.2,33,0.455,5,0.536,5.1,29,14,15,0.483,56,0.518,5,0.569,4.6,2016-17,Regular%20Season
203991,Clint Capela,1610612745,HOU,65,44,21,1551.0,178,123,50,0.691,400,0.445,11,0.458,6.2,348,130,216,0.374,584,0.596,34,0.633,4.7,526,253,266,0.481,983,0.535,45,0.561,5.2,2016-17,Regular%20Season
203469,Cody Zeller,1610612766,CHA,62,33,29,1725.0,135,84,52,0.622,358,0.377,8,0.386,5.8,270,100,171,0.37,537,0.503,48,0.552,5.6,405,184,223,0.454,895,0.453,56,0.483,5.7,2016-17,Regular%20Season
202332,Cole Aldrich,1610612750,MIN,50,18,32,477.0,50,29,21,0.58,99,0.505,1,0.51,7.4,107,41,63,0.383,171,0.626,10,0.665,4.6,157,70,84,0.446,269,0.584,11,0.609,5.5,2016-17,Regular%20Season
201147,Corey Brewer,1610612747,LAL,71,41,30,1148.0,32,8,23,0.25,132,0.242,1,0.244,10.2,134,26,105,0.194,224,0.598,19,0.654,8.2,166,34,128,0.205,356,0.466,20,0.494,8.6,2016-17,Regular%20Season
202709,Cory Joseph,1610612761,TOR,75,45,30,1896.0,50,26,25,0.52,198,0.253,6,0.26,10.6,178,44,137,0.247,400,0.445,43,0.499,7.8,228,70,162,0.307,598,0.381,49,0.415,8.6,2016-17,Regular%20Season
201584,Courtney Lee,1610612752,NYK,72,27,45,2305.0,53,15,40,0.283,149,0.356,5,0.368,12.9,206,19,185,0.092,372,0.554,33,0.608,10.1,259,34,225,0.131,521,0.497,38,0.536,10.7,2016-17,Regular%20Season
1626245,Cristiano Felicio,1610612741,CHI,62,28,34,1012.0,124,84,36,0.677,310,0.4,4,0.405,5.3,187,54,133,0.289,365,0.512,37,0.57,4.1,311,138,169,0.444,675,0.461,41,0.491,4.6,2016-17,Regular%20Season
1626156,D'Angelo Russell,1610612747,LAL,58,19,39,1722.0,31,11,21,0.355,156,0.199,5,0.205,12.7,190,17,178,0.089,348,0.546,22,0.583,8.7,221,28,199,0.127,504,0.438,27,0.463,9.4,2016-17,Regular%20Season
201571,D.J. Augustin,1610612753,ORL,62,21,41,1249.0,15,4,11,0.267,67,0.224,3,0.234,14.3,102,7,96,0.069,185,0.551,6,0.57,11.3,117,11,107,0.094,252,0.464,9,0.481,11.7,2016-17,Regular%20Season
2563,Dahntay Jones,1610612739,CLE,1,0,1,12.0,1,1,0,1.0,2,0.5,0,0.5,4.2,1,0,1,0.0,2,0.5,0,0.5,4.3,2,1,1,0.5,4,0.5,0,0.5,4.3,2016-17,Regular%20Season
1627745,Damian Jones,1610612744,GSW,9,7,2,76.0,9,4,5,0.444,23,0.391,1,0.409,6.4,14,2,12,0.143,22,0.636,1,0.667,5.3,23,6,17,0.261,45,0.511,2,0.535,5.7,2016-17,Regular%20Season
203081,Damian Lillard,1610612757,POR,75,38,37,2693.0,46,21,23,0.457,225,0.204,11,0.215,10.7,322,52,273,0.161,606,0.531,54,0.583,8.7,368,73,296,0.198,831,0.443,65,0.48,8.9,2016-17,Regular%20Season
204014,Damjan Rudez,1610612753,ORL,19,6,13,162.0,5,2,2,0.4,6,0.833,0,0.833,13.0,20,3,16,0.15,30,0.667,1,0.69,8.0,25,5,18,0.2,36,0.694,1,0.714,8.9,2016-17,Regular%20Season
1627849,Daniel Ochefu,1610612764,WAS,12,7,5,64.0,5,2,3,0.4,20,0.25,0,0.25,5.9,17,6,11,0.353,20,0.85,1,0.895,4.3,22,8,14,0.364,40,0.55,1,0.564,4.6,2016-17,Regular%20Season
201568,Danilo Gallinari,1610612743,DEN,62,30,32,2104.0,39,18,21,0.462,153,0.255,5,0.264,9.7,284,54,230,0.19,470,0.604,38,0.657,7.6,323,72,251,0.223,622,0.519,43,0.558,7.9,2016-17,Regular%20Season
201980,Danny Green,1610612759,SAS,62,46,16,1652.0,31,13,17,0.419,97,0.32,1,0.323,12.4,191,48,145,0.251,386,0.495,35,0.544,6.2,222,61,162,0.275,483,0.46,36,0.497,7.1,2016-17,Regular%20Season
201967,Dante Cunningham,1610612740,NOP,63,28,35,1616.0,56,31,23,0.554,125,0.448,3,0.459,7.1,221,43,177,0.195,388,0.57,29,0.616,5.7,277,74,200,0.267,512,0.541,32,0.577,6.0,2016-17,Regular%20Season
203957,Dante Exum,1610612762,UTA,53,33,20,1096.0,30,9,20,0.3,82,0.366,1,0.37,15.6,102,14,88,0.137,183,0.557,11,0.593,8.5,132,23,108,0.174,265,0.498,12,0.522,10.1,2016-17,Regular%20Season
1627863,Danuel House Jr.,1610612764,WAS,1,0,1,1.0,0,0,0,0.0,0,0.0,0,0.0,0.0,1,0,1,0.0,1,1.0,0,1.0,5.0,1,0,1,0.0,1,1.0,0,1.0,5.0,2016-17,Regular%20Season
203967,Dario Saric,1610612755,PHI,80,28,52,2113.0,112,66,36,0.589,313,0.358,8,0.367,7.1,401,106,289,0.264,678,0.591,53,0.642,4.8,513,172,325,0.335,990,0.518,61,0.552,5.3,2016-17,Regular%20Season
201589,Darrell Arthur,1610612743,DEN,38,18,20,600.0,25,18,7,0.72,59,0.424,4,0.455,8.4,87,25,59,0.287,160,0.544,15,0.6,6.7,112,43,66,0.384,219,0.511,19,0.56,7.1,2016-17,Regular%20Season
201954,Darren Collison,1610612758,SAC,60,20,40,1827.0,23,8,15,0.348,122,0.189,5,0.197,16.1,129,11,119,0.085,244,0.529,22,0.581,11.4,152,19,134,0.125,366,0.415,27,0.448,12.1,2016-17,Regular%20Season
1626199,Darrun Hilliard,1610612765,DET,18,6,12,230.0,2,1,1,0.5,18,0.111,1,0.118,13.5,31,6,25,0.194,43,0.721,1,0.738,9.1,33,7,26,0.212,60,0.55,2,0.569,9.4,2016-17,Regular%20Season
101135,David Lee,1610612759,SAS,77,58,19,1451.0,148,98,48,0.662,322,0.46,10,0.474,6.1,290,85,204,0.293,500,0.58,40,0.63,4.8,438,183,252,0.418,819,0.535,50,0.57,5.2,2016-17,Regular%20Season
1628021,David Nwaba,1610612747,LAL,20,5,15,397.0,17,9,9,0.529,62,0.274,2,0.283,5.2,46,9,37,0.196,86,0.535,11,0.613,7.8,63,18,46,0.286,148,0.426,13,0.467,7.3,2016-17,Regular%20Season
2561,David West,1610612744,GSW,65,53,12,822.0,47,29,18,0.617,99,0.475,3,0.49,5.2,156,71,82,0.455,301,0.518,27,0.569,5.1,203,100,100,0.493,400,0.508,30,0.549,5.1,2016-17,Regular%20Season
202722,Davis Bertans,1610612759,SAS,45,34,11,680.0,22,12,10,0.545,54,0.407,1,0.415,10.3,75,23,51,0.307,162,0.463,16,0.514,6.1,97,35,61,0.361,216,0.449,17,0.487,7.1,2016-17,Regular%20Season
201599,DeAndre Jordan,1610612746,LAC,81,51,30,2570.0,298,204,86,0.685,570,0.523,10,0.532,4.9,816,240,572,0.294,1133,0.72,57,0.758,4.5,1114,444,658,0.399,1700,0.655,67,0.682,4.6,2016-17,Regular%20Season
202732,DeAndre Liggins,1610612742,DAL,42,27,15,657.0,20,7,11,0.35,59,0.339,3,0.357,12.9,88,14,73,0.159,145,0.607,9,0.647,7.9,108,21,84,0.194,203,0.532,12,0.565,8.8,2016-17,Regular%20Season
1627761,DeAndre' Bembry,1610612737,ATL,23,11,12,294.0,14,9,5,0.643,40,0.35,0,0.35,8.1,45,10,35,0.222,82,0.549,12,0.643,7.5,59,19,40,0.322,121,0.488,12,0.541,7.7,2016-17,Regular%20Season
201942,DeMar DeRozan,1610612761,TOR,73,46,27,2591.0,70,32,36,0.457,248,0.282,9,0.293,11.1,315,60,253,0.19,504,0.625,27,0.66,7.9,385,92,289,0.239,751,0.513,36,0.538,8.5,2016-17,Regular%20Season
202326,DeMarcus Cousins,1610612740,NOP,72,30,42,2465.0,152,102,39,0.671,436,0.349,10,0.357,5.5,642,179,455,0.279,894,0.718,51,0.762,4.5,794,281,494,0.354,1322,0.601,61,0.63,4.7,2016-17,Regular%20Season
201960,DeMarre Carroll,1610612761,TOR,66,40,26,1737.0,62,36,23,0.581,200,0.31,12,0.33,8.4,210,43,166,0.205,388,0.541,34,0.593,7.1,272,79,189,0.29,586,0.464,46,0.504,7.4,2016-17,Regular%20Season
1627749,Dejounte Murray,1610612759,SAS,17,14,3,246.0,6,3,3,0.5,23,0.261,1,0.273,15.0,36,8,29,0.222,73,0.493,8,0.554,6.7,42,11,32,0.262,96,0.438,9,0.483,7.8,2016-17,Regular%20Season
1626153,Delon Wright,1610612761,TOR,23,17,6,411.0,16,4,12,0.25,48,0.333,1,0.34,9.4,32,9,23,0.281,66,0.485,6,0.533,9.0,48,13,35,0.271,114,0.421,7,0.449,9.1,2016-17,Regular%20Season
1627743,Demetrius Jackson,1610612738,BOS,2,1,1,13.0,2,1,1,0.5,3,0.667,0,0.667,17.9,2,0,2,0.0,5,0.4,0,0.4,14.0,4,1,3,0.25,8,0.5,0,0.5,15.9,2016-17,Regular%20Season
203471,Dennis Schroder,1610612737,ATL,76,41,35,2396.0,42,15,27,0.357,235,0.179,12,0.188,13.7,206,24,183,0.117,409,0.504,46,0.567,10.8,248,39,210,0.157,644,0.385,58,0.423,11.4,2016-17,Regular%20Season
1627756,Denzel Valentine,1610612741,CHI,43,22,21,876.0,11,2,9,0.182,43,0.256,1,0.262,17.0,140,30,108,0.214,249,0.562,22,0.617,7.0,151,32,117,0.212,292,0.517,23,0.561,7.8,2016-17,Regular%20Season
101114,Deron Williams,1610612739,CLE,51,19,32,1395.0,13,4,9,0.308,81,0.16,4,0.169,19.6,132,13,119,0.098,250,0.528,20,0.574,10.1,145,17,128,0.117,331,0.438,24,0.472,11.0,2016-17,Regular%20Season
202324,Derrick Favors,1610612762,UTA,50,33,17,1186.0,92,60,30,0.652,218,0.422,8,0.438,5.4,213,75,136,0.352,378,0.563,37,0.625,4.6,305,135,166,0.443,593,0.514,45,0.557,4.9,2016-17,Regular%20Season
1627884,Derrick Jones Jr.,1610612756,PHX,23,4,19,471.0,38,24,14,0.632,62,0.613,0,0.613,7.6,40,11,29,0.275,82,0.488,6,0.526,6.7,78,35,43,0.449,144,0.542,6,0.565,7.1,2016-17,Regular%20Season
201565,Derrick Rose,1610612752,NYK,63,25,38,2058.0,66,29,36,0.439,254,0.26,22,0.284,11.0,180,23,157,0.128,336,0.536,25,0.579,10.4,246,52,193,0.211,590,0.417,47,0.453,10.6,2016-17,Regular%20Season
202682,Derrick Williams,1610612739,CLE,42,12,30,741.0,19,14,6,0.737,49,0.388,1,0.396,6.4,111,19,93,0.171,169,0.657,15,0.721,5.4,130,33,99,0.254,218,0.596,16,0.644,5.6,2016-17,Regular%20Season
1626164,Devin Booker,1610612756,PHX,72,23,49,2518.0,44,17,28,0.386,221,0.199,8,0.207,12.4,202,33,172,0.163,412,0.49,36,0.537,9.0,246,50,200,0.203,633,0.389,44,0.418,9.6,2016-17,Regular%20Season
2734,Devin Harris,1610612742,DAL,52,24,28,907.0,9,3,7,0.333,57,0.158,4,0.17,9.3,114,16,99,0.14,196,0.582,15,0.63,8.2,123,19,106,0.154,253,0.486,19,0.526,8.5,2016-17,Regular%20Season
203473,Dewayne Dedmon,1610612759,SAS,73,54,19,1301.0,128,89,37,0.695,295,0.434,6,0.443,5.8,365,111,253,0.304,511,0.714,27,0.754,4.5,493,200,290,0.406,803,0.614,33,0.64,4.9,2016-17,Regular%20Season
1627738,Deyonta Davis,1610612763,MEM,24,16,8,211.0,20,12,8,0.6,50,0.4,1,0.408,5.2,40,17,23,0.425,71,0.563,3,0.588,5.8,60,29,31,0.483,121,0.496,4,0.513,5.6,2016-17,Regular%20Season
1627754,Diamond Stone,1610612746,LAC,5,4,1,19.0,1,0,1,0.0,10,0.1,1,0.111,9.5,5,0,5,0.0,8,0.625,0,0.625,5.6,6,0,6,0.0,17,0.353,1,0.375,6.2,2016-17,Regular%20Season
203079,Dion Waiters,1610612748,MIA,46,27,19,1384.0,18,7,10,0.389,118,0.153,7,0.162,11.6,135,25,111,0.185,285,0.474,23,0.515,9.0,153,32,121,0.209,401,0.382,30,0.412,9.2,2016-17,Regular%20Season
1717,Dirk Nowitzki,1610612742,DAL,53,22,31,1394.0,23,11,11,0.478,66,0.348,6,0.383,10.4,324,111,211,0.343,478,0.678,34,0.73,4.4,347,122,222,0.352,542,0.64,40,0.691,4.8,2016-17,Regular%20Season
1627734,Domantas Sabonis,1610612760,OKC,77,45,32,1574.0,46,27,17,0.587,166,0.277,8,0.291,7.4,242,82,159,0.339,437,0.554,29,0.593,5.5,288,109,176,0.378,601,0.479,37,0.511,5.8,2016-17,Regular%20Season
202700,Donatas Motiejunas,1610612740,NOP,29,13,16,455.0,26,14,12,0.538,63,0.413,0,0.413,6.8,75,28,48,0.373,137,0.547,9,0.586,4.8,101,42,60,0.416,200,0.505,9,0.529,5.3,2016-17,Regular%20Season
1627827,Dorian Finney-Smith,1610612742,DAL,70,32,38,1520.0,54,31,22,0.574,144,0.375,7,0.394,9.4,167,47,119,0.281,309,0.54,15,0.568,6.2,221,78,141,0.353,452,0.489,22,0.514,6.9,2016-17,Regular%20Season
203926,Doug McDermott,1610612760,OKC,57,30,27,1390.0,20,9,12,0.45,94,0.213,6,0.227,14.4,159,46,114,0.289,296,0.537,43,0.628,5.2,179,55,126,0.307,390,0.459,49,0.525,6.3,2016-17,Regular%20Season
1627733,Dragan Bender,1610612756,PHX,35,9,26,513.0,22,11,10,0.5,45,0.489,3,0.524,9.3,74,20,54,0.27,130,0.569,4,0.587,5.4,96,31,64,0.323,173,0.555,7,0.578,6.2,2016-17,Regular%20Season
203110,Draymond Green,1610612744,GSW,76,62,14,2471.0,98,59,37,0.602,252,0.389,13,0.41,6.6,501,153,341,0.305,835,0.6,66,0.651,4.6,599,212,378,0.354,1082,0.554,79,0.597,4.9,2016-17,Regular%20Season
2730,Dwight Howard,1610612737,ATL,74,37,37,2199.0,296,206,82,0.696,650,0.455,7,0.46,4.2,644,212,426,0.329,1003,0.642,60,0.683,4.0,940,418,508,0.445,1652,0.569,67,0.593,4.0,2016-17,Regular%20Season
203939,Dwight Powell,1610612742,DAL,71,28,43,1287.0,90,50,39,0.556,246,0.366,8,0.378,7.1,211,53,156,0.251,347,0.608,33,0.672,4.8,301,103,195,0.342,593,0.508,41,0.545,5.4,2016-17,Regular%20Season
2548,Dwyane Wade,1610612741,CHI,60,29,31,1792.0,63,32,29,0.508,189,0.333,8,0.348,7.3,207,40,165,0.193,362,0.572,24,0.612,6.5,270,72,194,0.267,551,0.49,32,0.52,6.7,2016-17,Regular%20Season
202734,E'Twaun Moore,1610612740,NOP,63,26,37,1570.0,33,12,19,0.364,84,0.393,1,0.398,11.9,118,23,94,0.195,241,0.49,22,0.539,9.9,151,35,113,0.232,325,0.465,23,0.5,10.4,2016-17,Regular%20Season
202334,Ed Davis,1610612757,POR,44,19,25,782.0,96,68,25,0.708,239,0.402,10,0.419,4.9,148,50,97,0.338,283,0.523,25,0.574,4.9,244,118,122,0.484,522,0.467,35,0.501,4.9,2016-17,Regular%20Season
204002,Edy Tavares,1610612739,CLE,2,1,1,28.0,4,2,2,0.5,8,0.5,0,0.5,9.4,7,5,2,0.714,12,0.583,0,0.583,4.3,11,7,4,0.636,20,0.55,0,0.55,6.1,2016-17,Regular%20Season
203901,Elfrid Payton,1610612753,ORL,81,29,52,2394.0,89,41,47,0.461,319,0.279,16,0.294,9.4,298,34,266,0.114,506,0.589,46,0.648,8.7,387,75,313,0.194,825,0.469,62,0.507,8.9,2016-17,Regular%20Season
202407,Elijah Millsap,1610612756,PHX,2,1,1,23.0,3,1,2,0.333,4,0.75,0,0.75,11.3,3,0,3,0.0,11,0.273,2,0.333,5.0,6,1,5,0.167,15,0.4,2,0.462,8.2,2016-17,Regular%20Season
1626144,Emmanuel Mudiay,1610612743,DEN,47,20,27,1256.0,28,9,20,0.321,126,0.222,8,0.237,13.0,146,17,131,0.116,249,0.586,19,0.635,8.6,174,26,151,0.149,375,0.464,27,0.5,9.3,2016-17,Regular%20Season
202683,Enes Freedom,1610612760,OKC,70,43,27,1511.0,195,147,40,0.754,486,0.401,14,0.413,4.2,287,85,200,0.296,503,0.571,49,0.632,4.6,482,232,240,0.481,987,0.488,63,0.522,4.4,2016-17,Regular%20Season
202339,Eric Bledsoe,1610612756,PHX,62,20,42,2054.0,49,27,21,0.551,225,0.218,15,0.233,10.4,259,41,218,0.158,439,0.59,35,0.641,8.5,308,68,239,0.221,663,0.465,50,0.502,8.8,2016-17,Regular%20Season
201569,Eric Gordon,1610612745,HOU,73,49,24,2259.0,29,8,21,0.276,179,0.162,4,0.166,16.5,172,30,142,0.174,392,0.439,31,0.476,9.3,201,38,163,0.189,571,0.352,35,0.375,10.4,2016-17,Regular%20Season
101141,Ersan Ilyasova,1610612737,ATL,81,35,46,2122.0,115,79,35,0.687,327,0.352,7,0.359,6.3,366,103,260,0.281,603,0.607,49,0.661,5.5,481,182,295,0.378,930,0.517,56,0.55,5.7,2016-17,Regular%20Season
203095,Evan Fournier,1610612753,ORL,63,22,41,2073.0,43,20,22,0.465,181,0.238,3,0.242,11.7,165,33,130,0.2,347,0.476,41,0.539,8.5,208,53,152,0.255,526,0.395,44,0.432,9.1,2016-17,Regular%20Season
202323,Evan Turner,1610612757,POR,64,33,31,1636.0,36,18,18,0.5,148,0.243,0,0.243,9.7,211,36,172,0.171,404,0.522,43,0.584,6.6,247,54,190,0.219,552,0.447,43,0.485,7.1,2016-17,Regular%20Season
1626163,Frank Kaminsky,1610612766,CHA,74,31,43,1934.0,57,35,22,0.614,182,0.313,10,0.331,8.5,279,79,200,0.283,521,0.536,49,0.591,5.8,336,114,222,0.339,702,0.479,59,0.523,6.3,2016-17,Regular%20Season
1627832,Fred VanVleet,1610612761,TOR,20,13,7,251.0,4,1,4,0.25,23,0.174,0,0.174,17.2,38,4,34,0.105,57,0.667,2,0.691,8.7,42,5,38,0.119,79,0.532,2,0.545,9.6,2016-17,Regular%20Season
202066,Garrett Temple,1610612758,SAC,59,24,35,1581.0,32,11,21,0.344,123,0.26,4,0.269,12.3,152,43,108,0.283,281,0.541,14,0.569,9.1,184,54,129,0.293,404,0.455,18,0.477,9.7,2016-17,Regular%20Season
203914,Gary Harris,1610612743,DEN,52,27,25,1665.0,48,24,24,0.5,153,0.314,8,0.331,10.2,125,20,105,0.16,228,0.548,20,0.601,9.0,173,44,129,0.254,381,0.454,28,0.49,9.3,2016-17,Regular%20Season
202390,Gary Neal,1610612737,ATL,1,0,1,13.0,0,0,0,0.0,0,0.0,0,0.0,0.0,1,0,1,0.0,2,0.5,0,0.5,9.8,1,0,1,0.0,2,0.5,0,0.5,9.8,2016-17,Regular%20Season
1627780,Gary Payton II,1610612749,MIL,5,1,4,98.0,0,0,0,0.0,7,0.0,2,0.0,0.0,12,1,11,0.083,22,0.545,1,0.571,8.0,12,1,11,0.083,29,0.414,3,0.462,8.0,2016-17,Regular%20Season
201588,George Hill,1610612762,UTA,48,32,16,1510.0,23,10,14,0.435,85,0.271,1,0.274,12.1,144,31,118,0.215,287,0.502,29,0.558,7.8,167,41,132,0.246,372,0.449,30,0.488,8.4,2016-17,Regular%20Season
1627777,Georges Niang,1610612754,IND,11,4,7,64.0,2,0,2,0.0,8,0.25,0,0.25,9.6,15,3,12,0.2,25,0.6,2,0.652,7.7,17,3,14,0.176,33,0.515,2,0.548,7.9,2016-17,Regular%20Season
1627834,Georgios Papagiannis,1610612758,SAC,18,6,12,343.0,24,14,7,0.583,42,0.571,0,0.571,4.9,62,20,42,0.323,101,0.614,10,0.681,4.3,86,34,49,0.395,143,0.601,10,0.647,4.5,2016-17,Regular%20Season
101123,Gerald Green,1610612738,BOS,34,24,10,431.0,16,8,8,0.5,48,0.333,4,0.364,13.9,68,9,58,0.132,107,0.636,10,0.701,7.3,84,17,66,0.202,155,0.542,14,0.596,8.5,2016-17,Regular%20Season
201945,Gerald Henderson,1610612755,PHI,66,23,43,1530.0,34,12,23,0.353,125,0.272,4,0.281,13.2,151,23,126,0.152,255,0.592,12,0.621,8.8,185,35,149,0.189,380,0.487,16,0.508,9.7,2016-17,Regular%20Season
203507,Giannis Antetokounmpo,1610612749,MIL,80,42,38,2845.0,142,100,40,0.704,390,0.364,11,0.375,6.4,558,118,435,0.211,849,0.657,59,0.706,6.4,700,218,475,0.311,1238,0.565,70,0.599,6.4,2016-17,Regular%20Season
203922,Glenn Robinson III,1610612754,IND,61,31,30,1326.0,53,21,32,0.396,151,0.351,1,0.353,10.7,189,33,157,0.175,334,0.566,33,0.628,6.8,242,54,189,0.223,485,0.499,34,0.537,7.7,2016-17,Regular%20Season
201609,Goran Dragic,1610612748,MIA,72,40,32,2437.0,62,20,39,0.323,278,0.223,8,0.23,12.0,217,27,193,0.124,464,0.468,40,0.512,8.9,279,47,232,0.168,741,0.377,48,0.403,9.6,2016-17,Regular%20Season
202330,Gordon Hayward,1610612762,UTA,73,46,27,2516.0,49,24,27,0.49,180,0.272,5,0.28,11.9,345,50,292,0.145,542,0.637,40,0.687,7.2,394,74,319,0.188,722,0.546,45,0.582,7.8,2016-17,Regular%20Season
203476,Gorgui Dieng,1610612750,MIN,82,31,51,2653.0,188,109,75,0.58,454,0.414,12,0.425,7.1,459,123,334,0.268,792,0.58,72,0.638,5.1,647,232,409,0.359,1242,0.521,84,0.559,5.6,2016-17,Regular%20Season
202328,Greg Monroe,1610612749,MIL,80,42,38,1821.0,167,133,32,0.796,416,0.401,10,0.411,4.9,365,128,237,0.351,590,0.619,52,0.678,4.8,532,261,269,0.491,1005,0.529,62,0.564,4.9,2016-17,Regular%20Season
202349,Greivis Vasquez,1610612751,BKN,2,1,1,20.0,0,0,1,0.0,2,0.0,0,0.0,0.0,2,0,2,0.0,5,0.4,0,0.4,6.5,2,0,3,0.0,7,0.286,0,0.286,6.5,2016-17,Regular%20Season
203084,Harrison Barnes,1610612742,DAL,78,31,47,2767.0,92,45,46,0.489,257,0.358,11,0.374,8.7,298,85,212,0.285,574,0.519,53,0.572,6.5,390,130,258,0.333,829,0.47,64,0.51,7.0,2016-17,Regular%20Season
202355,Hassan Whiteside,1610612748,MIA,77,39,38,2513.0,293,219,67,0.747,665,0.441,19,0.454,4.6,795,277,510,0.348,1187,0.67,73,0.714,3.6,1088,496,577,0.456,1850,0.588,92,0.619,3.8,2016-17,Regular%20Season
1627740,Henry Ellenson,1610612765,DET,10,4,6,115.0,8,3,5,0.375,15,0.533,0,0.533,3.9,33,6,27,0.182,47,0.702,4,0.767,4.8,41,9,32,0.22,62,0.661,4,0.707,4.6,2016-17,Regular%20Season
203138,Hollis Thompson,1610612740,NOP,38,11,27,737.0,19,8,9,0.421,51,0.373,1,0.38,12.3,93,16,75,0.172,159,0.585,12,0.633,7.0,112,24,84,0.214,210,0.533,13,0.569,7.8,2016-17,Regular%20Season
203546,Ian Clark,1610612744,GSW,55,47,8,899.0,22,5,17,0.227,77,0.286,3,0.297,13.4,99,10,91,0.101,166,0.596,19,0.673,9.5,121,15,108,0.124,243,0.498,22,0.548,10.3,2016-17,Regular%20Season
101133,Ian Mahinmi,1610612764,WAS,30,18,12,540.0,47,24,23,0.511,118,0.398,4,0.412,6.7,103,31,69,0.301,171,0.602,21,0.687,5.1,150,55,92,0.367,289,0.519,25,0.568,5.6,2016-17,Regular%20Season
202697,Iman Shumpert,1610612739,CLE,69,43,26,1781.0,39,13,26,0.333,114,0.342,6,0.361,13.5,179,32,148,0.179,325,0.551,24,0.595,7.8,218,45,174,0.206,439,0.497,30,0.533,8.8,2016-17,Regular%20Season
203477,Isaiah Canaan,1610612741,CHI,25,13,12,470.0,6,2,4,0.333,31,0.194,3,0.214,9.0,44,5,40,0.114,77,0.571,6,0.62,8.5,50,7,44,0.14,108,0.463,9,0.505,8.6,2016-17,Regular%20Season
1627819,Isaiah Taylor,1610612745,HOU,3,2,1,51.0,1,1,0,1.0,3,0.333,0,0.333,11.3,2,0,2,0.0,4,0.5,0,0.5,15.1,3,1,2,0.333,7,0.429,0,0.429,13.8,2016-17,Regular%20Season
202738,Isaiah Thomas,1610612738,BOS,72,48,24,2435.0,42,18,25,0.429,251,0.167,11,0.175,14.1,162,17,147,0.105,338,0.479,16,0.503,11.6,204,35,172,0.172,589,0.346,27,0.363,12.1,2016-17,Regular%20Season
1627785,Isaiah Whitehead,1610612751,BKN,66,17,49,1506.0,32,21,11,0.656,133,0.241,7,0.254,9.5,152,31,121,0.204,306,0.497,31,0.553,8.7,184,52,132,0.283,439,0.419,38,0.459,8.9,2016-17,Regular%20Season
202397,Ish Smith,1610612765,DET,78,37,41,1898.0,21,3,19,0.143,118,0.178,4,0.184,17.6,213,30,185,0.141,455,0.468,66,0.548,8.1,234,33,204,0.141,573,0.408,70,0.465,9.1,2016-17,Regular%20Season
1627826,Ivica Zubac,1610612747,LAL,33,7,26,595.0,41,29,11,0.707,109,0.376,2,0.383,4.2,118,49,68,0.415,224,0.527,19,0.576,4.9,159,78,79,0.491,333,0.477,21,0.51,4.8,2016-17,Regular%20Season
200826,J.J. Barea,1610612742,DAL,32,9,23,709.0,9,1,8,0.111,39,0.231,0,0.231,18.1,74,6,69,0.081,142,0.521,14,0.578,8.9,83,7,77,0.084,181,0.459,14,0.497,9.9,2016-17,Regular%20Season
200755,JJ Redick,1610612746,LAC,74,46,28,2089.0,11,1,10,0.091,57,0.193,2,0.2,16.6,160,18,139,0.113,320,0.5,38,0.567,9.1,171,19,149,0.111,376,0.455,40,0.509,9.5,2016-17,Regular%20Season
2747,JR Smith,1610612739,CLE,38,23,15,1113.0,17,6,12,0.353,47,0.362,1,0.37,16.5,96,17,80,0.177,161,0.596,13,0.649,9.6,113,23,92,0.204,207,0.546,14,0.585,10.7,2016-17,Regular%20Season
203210,JaMychal Green,1610612763,MEM,76,40,36,2084.0,167,115,49,0.689,358,0.466,8,0.477,5.8,377,92,282,0.244,569,0.663,41,0.714,5.1,544,207,331,0.381,923,0.589,49,0.622,5.3,2016-17,Regular%20Season
201580,JaVale McGee,1610612744,GSW,66,56,10,692.0,100,65,33,0.65,191,0.524,4,0.535,5.2,143,56,82,0.392,254,0.563,29,0.636,4.4,243,121,115,0.498,445,0.546,33,0.59,4.7,2016-17,Regular%20Season
203953,Jabari Parker,1610612749,MIL,51,22,29,1728.0,79,43,30,0.544,234,0.338,7,0.348,7.5,235,55,176,0.234,414,0.568,34,0.618,6.4,314,98,206,0.312,648,0.485,41,0.517,6.7,2016-17,Regular%20Season
203109,Jae Crowder,1610612738,BOS,72,48,24,2335.0,48,14,36,0.292,203,0.236,5,0.242,10.9,367,70,295,0.191,555,0.661,33,0.703,6.9,415,84,331,0.202,754,0.55,38,0.58,7.4,2016-17,Regular%20Season
1626143,Jahlil Okafor,1610612755,PHI,50,15,35,1134.0,81,59,20,0.728,251,0.323,5,0.329,5.7,159,58,103,0.365,324,0.491,38,0.556,4.9,240,117,123,0.488,574,0.418,43,0.452,5.2,2016-17,Regular%20Season
1627774,Jake Layman,1610612757,POR,13,4,9,166.0,6,4,3,0.667,13,0.462,0,0.462,7.6,18,4,14,0.222,31,0.581,3,0.643,7.3,24,8,17,0.333,44,0.545,3,0.585,7.4,2016-17,Regular%20Season
1627751,Jakob Poeltl,1610612761,TOR,47,32,15,594.0,77,55,20,0.714,167,0.461,6,0.478,4.7,86,32,53,0.372,175,0.491,21,0.558,4.4,163,87,73,0.534,341,0.478,27,0.519,4.6,2016-17,Regular%20Season
2037,Jamal Crawford,1610612746,LAC,65,39,26,1732.0,17,7,10,0.412,65,0.262,3,0.274,11.6,112,16,98,0.143,193,0.58,11,0.615,11.8,129,23,108,0.178,258,0.5,14,0.529,11.8,2016-17,Regular%20Season
1627750,Jamal Murray,1610612743,DEN,75,36,39,1662.0,40,10,29,0.25,148,0.27,6,0.282,14.8,173,35,136,0.202,282,0.613,27,0.678,8.7,213,45,165,0.211,430,0.495,33,0.537,9.9,2016-17,Regular%20Season
2749,Jameer Nelson,1610612743,DEN,68,31,37,1908.0,28,12,16,0.429,101,0.277,7,0.298,16.4,164,18,145,0.11,303,0.541,25,0.59,9.7,192,30,161,0.156,404,0.475,32,0.516,10.6,2016-17,Regular%20Season
203516,James Ennis III,1610612763,MEM,61,31,30,1471.0,69,41,26,0.594,190,0.363,5,0.373,8.6,190,41,147,0.216,303,0.627,24,0.681,6.3,259,82,173,0.317,492,0.526,29,0.559,6.9,2016-17,Regular%20Season
201935,James Harden,1610612745,HOU,81,54,27,2947.0,95,51,44,0.537,260,0.365,7,0.375,10.9,564,103,456,0.183,854,0.66,56,0.707,6.2,659,154,500,0.234,1113,0.592,63,0.628,6.9,2016-17,Regular%20Season
201949,James Johnson,1610612748,MIA,76,40,36,2085.0,66,26,39,0.394,226,0.292,8,0.303,8.3,310,70,235,0.226,520,0.596,44,0.651,6.0,376,96,274,0.255,745,0.505,52,0.543,6.4,2016-17,Regular%20Season
2592,James Jones,1610612739,CLE,21,8,13,248.0,3,0,3,0.0,14,0.214,1,0.231,13.0,34,9,25,0.265,66,0.515,7,0.576,6.2,37,9,28,0.243,80,0.463,8,0.514,6.8,2016-17,Regular%20Season
203949,James Michael McAdoo,1610612744,GSW,35,29,6,367.0,33,19,13,0.576,91,0.363,3,0.375,7.6,57,19,38,0.333,121,0.471,11,0.518,6.6,90,38,51,0.422,212,0.425,14,0.455,7.0,2016-17,Regular%20Season
203923,James Young,1610612738,BOS,14,8,6,141.0,6,4,2,0.667,12,0.5,0,0.5,10.0,20,6,14,0.3,31,0.645,3,0.714,5.4,26,10,16,0.385,43,0.605,3,0.65,6.5,2016-17,Regular%20Season
201162,Jared Dudley,1610612756,PHX,58,16,42,1304.0,31,13,19,0.419,121,0.256,5,0.267,12.2,193,43,145,0.223,448,0.431,45,0.479,6.6,224,56,164,0.25,569,0.394,50,0.432,7.4,2016-17,Regular%20Season
203096,Jared Sullinger,1610612761,TOR,10,1,9,112.0,10,4,6,0.4,32,0.313,2,0.333,9.1,17,3,14,0.176,38,0.447,5,0.515,4.3,27,7,20,0.259,69,0.391,7,0.435,6.1,2016-17,Regular%20Season
204067,Jarell Eddie,1610612756,PHX,4,0,4,60.0,1,1,0,1.0,4,0.25,0,0.25,2.5,6,1,5,0.167,14,0.429,0,0.429,11.7,7,2,5,0.286,18,0.389,0,0.389,10.3,2016-17,Regular%20Season
1626185,Jarell Martin,1610612763,MEM,39,20,19,545.0,42,29,13,0.69,118,0.356,8,0.382,5.5,120,34,86,0.283,192,0.625,19,0.694,4.9,162,63,99,0.389,310,0.523,27,0.572,5.1,2016-17,Regular%20Season
203950,Jarnell Stokes,1610612743,DEN,1,0,1,6.0,1,0,1,0.0,2,0.5,0,0.5,4.9,1,0,1,0.0,2,0.5,1,1.0,5.0,2,0,2,0.0,4,0.5,1,0.667,4.9,2016-17,Regular%20Season
1627784,Jarrod Uthoff,1610612742,DAL,7,1,6,112.0,8,3,5,0.375,21,0.381,0,0.381,8.3,14,3,11,0.214,32,0.438,5,0.519,8.0,22,6,16,0.273,53,0.415,5,0.458,8.1,2016-17,Regular%20Season
201160,Jason Smith,1610612764,WAS,68,42,26,1033.0,64,31,32,0.484,160,0.4,3,0.408,8.3,194,64,127,0.33,341,0.569,25,0.614,5.6,258,95,159,0.368,501,0.515,28,0.545,6.3,2016-17,Regular%20Season
1891,Jason Terry,1610612749,MIL,51,27,24,1029.0,15,1,13,0.067,37,0.405,1,0.417,18.5,90,9,84,0.1,151,0.596,6,0.621,11.1,105,10,97,0.095,188,0.559,7,0.58,12.1,2016-17,Regular%20Season
1627759,Jaylen Brown,1610612738,BOS,70,44,26,1261.0,44,27,15,0.614,153,0.288,4,0.295,6.4,175,38,134,0.217,264,0.663,21,0.72,5.9,219,65,149,0.297,416,0.526,25,0.56,6.0,2016-17,Regular%20Season
201145,Jeff Green,1610612753,ORL,64,23,41,1442.0,39,18,19,0.462,143,0.273,4,0.281,11.1,175,41,133,0.234,294,0.595,17,0.632,7.0,214,59,152,0.276,436,0.491,21,0.516,7.7,2016-17,Regular%20Season
201952,Jeff Teague,1610612754,IND,80,41,39,2600.0,33,12,21,0.364,179,0.184,5,0.19,14.2,294,36,253,0.122,486,0.605,25,0.638,9.1,327,48,274,0.147,664,0.492,30,0.516,9.6,2016-17,Regular%20Season
203481,Jeff Withey,1610612762,UTA,43,29,14,411.0,52,37,12,0.712,98,0.531,2,0.542,4.1,69,24,45,0.348,171,0.404,19,0.454,4.1,121,61,57,0.504,269,0.45,21,0.488,4.1,2016-17,Regular%20Season
203924,Jerami Grant,1610612760,OKC,72,37,35,1447.0,38,14,23,0.368,115,0.33,2,0.336,9.7,167,59,109,0.353,335,0.499,25,0.539,6.7,205,73,132,0.356,449,0.457,27,0.486,7.2,2016-17,Regular%20Season
203087,Jeremy Lamb,1610612766,CHA,59,26,33,1103.0,30,16,15,0.533,89,0.337,2,0.345,7.0,234,45,189,0.192,348,0.672,14,0.701,5.0,264,61,204,0.231,436,0.606,16,0.629,5.2,2016-17,Regular%20Season
202391,Jeremy Lin,1610612751,BKN,32,12,20,813.0,11,3,8,0.273,71,0.155,3,0.162,16.2,122,15,107,0.123,245,0.498,18,0.537,7.7,133,18,115,0.135,315,0.422,21,0.452,8.4,2016-17,Regular%20Season
1626170,Jerian Grant,1610612741,CHI,45,23,22,842.0,17,5,13,0.294,69,0.246,2,0.254,16.1,93,14,80,0.151,179,0.52,16,0.571,7.7,110,19,93,0.173,248,0.444,18,0.478,9.1,2016-17,Regular%20Season
201573,Jerryd Bayless,1610612755,PHI,3,1,2,71.0,3,2,1,0.667,10,0.3,1,0.333,19.5,9,1,8,0.111,13,0.692,1,0.75,7.7,12,3,9,0.25,23,0.522,2,0.571,10.7,2016-17,Regular%20Season
202710,Jimmy Butler,1610612741,CHI,75,40,35,2779.0,129,68,60,0.527,333,0.387,5,0.393,9.5,341,60,287,0.176,596,0.572,41,0.614,8.0,470,128,347,0.272,929,0.506,46,0.532,8.4,2016-17,Regular%20Season
201149,Joakim Noah,1610612752,NYK,46,17,29,1015.0,162,115,43,0.71,333,0.486,7,0.497,5.3,241,66,173,0.274,443,0.544,35,0.591,4.1,403,181,216,0.449,776,0.519,42,0.549,4.6,2016-17,Regular%20Season
201975,Jodie Meeks,1610612753,ORL,31,13,18,646.0,5,2,3,0.4,29,0.172,2,0.185,14.8,72,17,55,0.236,123,0.585,10,0.637,7.8,77,19,58,0.247,152,0.507,12,0.55,8.3,2016-17,Regular%20Season
203925,Joe Harris,1610612751,BKN,48,10,38,1070.0,16,6,10,0.375,84,0.19,6,0.205,10.3,125,19,104,0.152,241,0.519,27,0.584,7.7,141,25,114,0.177,325,0.434,33,0.483,8.0,2016-17,Regular%20Season
204060,Joe Ingles,1610612762,UTA,77,48,29,1909.0,23,9,12,0.391,85,0.271,4,0.284,16.3,238,40,199,0.168,368,0.647,16,0.676,8.4,261,49,211,0.188,453,0.576,20,0.603,9.0,2016-17,Regular%20Season
2207,Joe Johnson,1610612762,UTA,71,42,29,1712.0,33,14,19,0.424,93,0.355,1,0.359,10.0,210,41,168,0.195,343,0.612,26,0.662,7.4,243,55,187,0.226,435,0.559,27,0.596,7.7,2016-17,Regular%20Season
1626202,Joe Young,1610612754,IND,9,3,6,81.0,1,0,1,0.0,10,0.1,0,0.1,14.7,16,0,16,0.0,22,0.727,1,0.762,9.3,17,0,17,0.0,30,0.567,1,0.586,9.6,2016-17,Regular%20Season
201202,Joel Anthony,1610612759,SAS,13,10,3,112.0,8,6,1,0.75,27,0.296,1,0.308,5.6,23,8,15,0.348,33,0.697,1,0.719,5.2,31,14,16,0.452,60,0.517,2,0.534,5.3,2016-17,Regular%20Season
1627762,Joel Bolomboy,1610612762,UTA,8,4,4,46.0,4,2,1,0.5,8,0.5,0,0.5,5.4,13,4,9,0.308,23,0.565,2,0.619,4.4,17,6,10,0.353,31,0.548,2,0.586,4.6,2016-17,Regular%20Season
203954,Joel Embiid,1610612755,PHI,31,13,18,786.0,61,39,18,0.639,174,0.351,3,0.357,6.8,182,64,120,0.352,300,0.607,29,0.672,4.2,243,103,138,0.424,472,0.515,32,0.552,4.8,2016-17,Regular%20Season
203530,Joffrey Lauvergne,1610612741,CHI,66,38,28,945.0,72,44,26,0.611,182,0.396,5,0.407,6.1,179,52,127,0.291,292,0.613,24,0.668,4.4,251,96,153,0.382,474,0.53,29,0.564,4.9,2016-17,Regular%20Season
203089,John Henson,1610612749,MIL,58,26,32,1122.0,92,60,30,0.652,205,0.449,3,0.455,5.4,203,71,130,0.35,340,0.597,19,0.632,5.5,295,131,160,0.444,541,0.545,22,0.568,5.5,2016-17,Regular%20Season
203098,John Jenkins,1610612756,PHX,1,0,1,4.0,0,0,0,0.0,0,0.0,0,0.0,0.0,1,0,1,0.0,3,0.333,1,0.5,10.1,1,0,1,0.0,3,0.333,1,0.5,10.1,2016-17,Regular%20Season
202322,John Wall,1610612764,WAS,77,47,30,2802.0,59,21,35,0.356,310,0.19,28,0.209,13.4,267,33,239,0.124,476,0.561,24,0.591,11.1,326,54,274,0.166,786,0.415,52,0.444,11.5,2016-17,Regular%20Season
203948,Johnny O'Bryant III,1610612766,CHA,8,4,4,75.0,9,5,3,0.556,15,0.6,1,0.643,8.8,10,5,6,0.5,16,0.625,1,0.667,5.3,19,10,9,0.526,31,0.613,2,0.655,6.8,2016-17,Regular%20Season
202720,Jon Leuer,1610612765,DET,71,31,40,1904.0,102,66,33,0.647,245,0.416,8,0.43,6.0,300,81,222,0.27,512,0.586,56,0.658,4.7,402,147,255,0.366,755,0.532,64,0.582,5.0,2016-17,Regular%20Season
201973,Jonas Jerebko,1610612738,BOS,76,50,26,1202.0,59,28,31,0.475,173,0.341,3,0.347,8.3,213,46,166,0.216,370,0.576,26,0.619,4.8,272,74,197,0.272,541,0.503,29,0.531,5.5,2016-17,Regular%20Season
202685,Jonas Valanciunas,1610612761,TOR,79,49,30,2043.0,223,173,38,0.776,515,0.433,13,0.444,4.2,522,203,318,0.389,854,0.611,61,0.658,3.5,745,376,356,0.505,1367,0.545,74,0.576,3.7,2016-17,Regular%20Season
1626780,Jonathan Gibson,1610612742,DAL,10,1,9,181.0,1,1,0,1.0,12,0.083,0,0.083,4.4,21,2,19,0.095,29,0.724,1,0.75,10.3,22,3,19,0.136,41,0.537,1,0.55,10.0,2016-17,Regular%20Season
203613,Jonathon Simmons,1610612759,SAS,57,45,12,1142.0,20,8,12,0.4,88,0.227,2,0.233,10.6,137,25,111,0.182,235,0.583,19,0.634,7.9,157,33,123,0.21,321,0.489,21,0.523,8.2,2016-17,Regular%20Season
203903,Jordan Clarkson,1610612747,LAL,77,24,53,2271.0,49,19,29,0.388,231,0.212,9,0.221,12.1,197,16,182,0.081,366,0.538,20,0.569,10.1,246,35,211,0.142,597,0.412,29,0.433,10.5,2016-17,Regular%20Season
202348,Jordan Crawford,1610612740,NOP,16,8,8,379.0,4,0,4,0.0,16,0.25,0,0.25,11.8,30,5,25,0.167,54,0.556,3,0.588,8.4,34,5,29,0.147,70,0.486,3,0.507,8.8,2016-17,Regular%20Season
200770,Jordan Farmar,1610612758,SAC,2,1,1,35.0,1,0,1,0.0,1,1.0,0,1.0,19.0,2,0,2,0.0,7,0.286,1,0.333,10.4,3,0,3,0.0,8,0.375,1,0.429,13.2,2016-17,Regular%20Season
201941,Jordan Hill,1610612750,MIN,5,2,3,41.0,8,5,3,0.625,10,0.8,0,0.8,5.3,6,1,5,0.167,17,0.353,3,0.429,5.1,14,6,8,0.429,27,0.519,3,0.583,5.2,2016-17,Regular%20Season
203895,Jordan McRae,1610612739,CLE,20,12,8,288.0,6,3,3,0.5,25,0.24,0,0.24,10.7,35,7,27,0.2,52,0.673,3,0.714,8.8,41,10,30,0.244,77,0.532,3,0.554,9.1,2016-17,Regular%20Season
1626175,Jordan Mickey,1610612738,BOS,16,7,9,115.0,13,8,5,0.615,28,0.464,0,0.464,5.8,21,9,12,0.429,45,0.467,4,0.512,3.5,34,17,17,0.5,73,0.466,4,0.493,4.4,2016-17,Regular%20Season
101181,Jose Calderon,1610612737,ATL,33,13,20,479.0,15,4,11,0.267,36,0.417,0,0.417,16.4,58,11,47,0.19,102,0.569,5,0.598,8.8,73,15,58,0.205,138,0.529,5,0.549,10.4,2016-17,Regular%20Season
203962,Josh Huestis,1610612760,OKC,2,0,2,31.0,4,1,3,0.25,7,0.571,0,0.571,16.8,5,0,5,0.0,8,0.625,1,0.714,5.6,9,1,8,0.111,15,0.6,1,0.643,10.6,2016-17,Regular%20Season
201177,Josh McRoberts,1610612748,MIA,19,6,13,335.0,23,14,9,0.609,55,0.418,1,0.426,6.8,51,17,34,0.333,94,0.543,5,0.573,5.8,74,31,43,0.419,149,0.497,6,0.517,6.2,2016-17,Regular%20Season
1626196,Josh Richardson,1610612748,MIA,51,22,29,1593.0,35,11,23,0.314,108,0.324,6,0.343,12.4,133,27,105,0.203,309,0.43,32,0.48,9.6,168,38,128,0.226,417,0.403,38,0.443,10.2,2016-17,Regular%20Season
201950,Jrue Holiday,1610612740,NOP,66,32,34,2158.0,46,27,19,0.587,163,0.282,4,0.289,9.1,218,41,176,0.188,422,0.517,38,0.568,8.7,264,68,195,0.258,585,0.451,42,0.486,8.8,2016-17,Regular%20Season
1627823,Juancho Hernangomez,1610612743,DEN,51,24,27,802.0,43,29,14,0.674,128,0.336,7,0.355,5.5,144,42,98,0.292,230,0.626,18,0.679,5.0,187,71,112,0.38,358,0.522,25,0.562,5.2,2016-17,Regular%20Season
203944,Julius Randle,1610612747,LAL,74,24,50,2132.0,150,95,48,0.633,375,0.4,8,0.409,5.9,486,135,348,0.278,740,0.657,71,0.726,5.1,636,230,396,0.362,1114,0.571,79,0.614,5.3,2016-17,Regular%20Season
1626147,Justin Anderson,1610612755,PHI,65,22,43,1158.0,69,32,38,0.464,139,0.496,4,0.511,10.2,175,30,145,0.171,294,0.595,22,0.643,5.0,244,62,183,0.254,433,0.564,26,0.6,6.5,2016-17,Regular%20Season
203120,Justin Hamilton,1610612751,BKN,58,11,47,1100.0,69,47,20,0.681,156,0.442,2,0.448,6.3,182,64,117,0.352,352,0.517,32,0.569,5.0,251,111,137,0.442,507,0.495,34,0.531,5.3,2016-17,Regular%20Season
202712,Justin Harper,1610612755,PHI,2,1,1,27.0,2,0,2,0.0,6,0.333,0,0.333,12.3,3,2,1,0.667,6,0.5,1,0.6,4.4,5,2,3,0.4,12,0.417,1,0.455,7.5,2016-17,Regular%20Season
203200,Justin Holiday,1610612752,NYK,72,25,47,1494.0,27,10,17,0.37,97,0.278,6,0.297,13.4,197,38,157,0.193,315,0.625,26,0.682,7.7,224,48,174,0.214,412,0.544,32,0.589,8.4,2016-17,Regular%20Season
1626159,Justise Winslow,1610612748,MIA,18,4,14,625.0,23,18,6,0.783,86,0.267,2,0.274,7.0,71,17,53,0.239,159,0.447,17,0.5,6.3,94,35,59,0.372,244,0.385,19,0.418,6.5,2016-17,Regular%20Season
203994,Jusuf Nurkic,1610612757,POR,64,33,31,1383.0,154,113,33,0.734,392,0.393,8,0.401,4.9,311,107,199,0.344,553,0.562,49,0.617,4.1,465,220,232,0.473,941,0.494,57,0.526,4.4,2016-17,Regular%20Season
203909,KJ McDaniels,1610612751,BKN,36,21,15,471.0,15,10,5,0.667,53,0.283,3,0.3,6.2,67,17,50,0.254,122,0.549,8,0.588,6.6,82,27,55,0.329,174,0.471,11,0.503,6.5,2016-17,Regular%20Season
1626157,Karl-Anthony Towns,1610612750,MIN,82,31,51,3030.0,296,215,76,0.726,660,0.448,16,0.46,6.1,711,252,457,0.354,1045,0.68,63,0.724,4.4,1007,467,533,0.464,1704,0.591,79,0.62,4.9,2016-17,Regular%20Season
202695,Kawhi Leonard,1610612759,SAS,72,54,18,2422.0,79,41,38,0.519,211,0.374,8,0.389,9.3,347,94,254,0.271,568,0.611,32,0.647,7.0,426,135,292,0.317,778,0.548,40,0.577,7.5,2016-17,Regular%20Season
1627770,Kay Felder,1610612739,CLE,23,13,10,269.0,3,3,0,1.0,21,0.143,2,0.158,4.0,38,7,31,0.184,57,0.667,5,0.731,8.7,41,10,31,0.244,78,0.526,7,0.577,8.3,2016-17,Regular%20Season
203482,Kelly Olynyk,1610612738,BOS,73,48,25,1520.0,73,48,24,0.658,222,0.329,3,0.333,7.1,288,58,230,0.201,490,0.588,44,0.646,5.2,361,106,254,0.294,712,0.507,47,0.543,5.6,2016-17,Regular%20Season
1626162,Kelly Oubre Jr.,1610612764,WAS,71,45,26,1543.0,61,38,24,0.623,185,0.33,4,0.337,8.2,199,39,160,0.196,329,0.605,29,0.663,6.2,260,77,184,0.296,513,0.507,33,0.542,6.7,2016-17,Regular%20Season
202689,Kemba Walker,1610612766,CHA,76,34,42,2660.0,45,19,26,0.422,243,0.185,12,0.195,11.6,262,32,230,0.122,537,0.488,58,0.547,8.3,307,51,256,0.166,780,0.394,70,0.432,8.8,2016-17,Regular%20Season
202702,Kenneth Faried,1610612743,DEN,59,28,31,1272.0,179,139,35,0.777,371,0.482,5,0.489,5.3,274,91,182,0.332,423,0.648,31,0.699,4.9,453,230,217,0.508,792,0.572,36,0.599,5.1,2016-17,Regular%20Season
203145,Kent Bazemore,1610612737,ATL,67,38,29,1798.0,45,15,28,0.333,141,0.319,1,0.321,11.0,186,31,152,0.167,408,0.456,41,0.507,7.0,231,46,180,0.199,548,0.422,42,0.457,7.8,2016-17,Regular%20Season
203484,Kentavious Caldwell-Pope,1610612765,DET,71,31,40,2377.0,55,28,26,0.509,150,0.367,3,0.374,10.7,193,25,171,0.13,316,0.611,23,0.659,8.9,248,53,197,0.214,466,0.532,26,0.564,9.4,2016-17,Regular%20Season
201142,Kevin Durant,1610612744,GSW,61,51,10,2069.0,39,19,23,0.487,142,0.275,4,0.283,8.5,474,114,356,0.241,662,0.716,33,0.754,6.3,513,133,379,0.259,802,0.64,37,0.671,6.5,2016-17,Regular%20Season
201567,Kevin Love,1610612739,CLE,60,40,20,1885.0,148,93,53,0.628,328,0.451,11,0.467,6.6,518,149,366,0.288,758,0.683,48,0.73,4.4,666,242,419,0.363,1083,0.615,59,0.65,4.9,2016-17,Regular%20Season
202338,Kevin Seraphin,1610612754,IND,40,19,21,505.0,40,20,18,0.5,103,0.388,4,0.404,7.2,97,17,80,0.175,152,0.638,13,0.698,4.8,137,37,98,0.27,254,0.539,17,0.578,5.5,2016-17,Regular%20Season
1626172,Kevon Looney,1610612744,GSW,40,33,7,386.0,44,23,21,0.523,97,0.454,4,0.473,6.3,80,28,53,0.35,139,0.576,10,0.62,6.0,124,51,74,0.411,236,0.525,14,0.559,6.1,2016-17,Regular%20Season
203114,Khris Middleton,1610612749,MIL,29,19,10,889.0,11,3,8,0.273,46,0.239,2,0.25,12.8,112,23,90,0.205,189,0.593,16,0.647,7.1,123,26,98,0.211,235,0.523,18,0.567,7.6,2016-17,Regular%20Season
202691,Klay Thompson,1610612744,GSW,75,63,12,2563.0,49,20,28,0.408,184,0.266,6,0.275,13.6,236,54,185,0.229,469,0.503,37,0.546,8.0,285,74,213,0.26,652,0.437,43,0.468,8.9,2016-17,Regular%20Season
201585,Kosta Koufos,1610612758,SAC,69,26,43,1389.0,118,71,42,0.602,262,0.45,4,0.457,6.1,285,82,201,0.288,471,0.605,36,0.655,4.4,403,153,243,0.38,729,0.553,40,0.585,4.9,2016-17,Regular%20Season
1627739,Kris Dunn,1610612750,MIN,65,27,38,1189.0,24,12,12,0.5,89,0.27,4,0.282,9.8,142,33,109,0.232,280,0.507,32,0.573,6.8,166,45,121,0.271,369,0.45,36,0.498,7.2,2016-17,Regular%20Season
2743,Kris Humphries,1610612737,ATL,54,29,25,674.0,60,32,27,0.533,147,0.408,2,0.414,6.4,146,49,97,0.336,276,0.529,25,0.582,4.2,206,81,124,0.393,421,0.489,27,0.523,4.8,2016-17,Regular%20Season
204001,Kristaps Porzingis,1610612752,NYK,66,26,40,2164.0,111,70,39,0.631,242,0.459,6,0.47,8.6,364,122,240,0.335,652,0.558,53,0.608,5.2,475,192,279,0.404,894,0.531,59,0.569,6.0,2016-17,Regular%20Season
203937,Kyle Anderson,1610612759,SAS,63,46,17,995.0,33,23,12,0.697,103,0.32,1,0.324,6.7,175,39,134,0.223,267,0.655,16,0.697,6.3,208,62,146,0.298,368,0.565,17,0.593,6.4,2016-17,Regular%20Season
2594,Kyle Korver,1610612739,CLE,64,32,32,1667.0,7,1,7,0.143,77,0.091,3,0.095,21.3,179,36,141,0.201,367,0.488,36,0.541,7.4,186,37,148,0.199,444,0.419,39,0.459,8.0,2016-17,Regular%20Season
200768,Kyle Lowry,1610612761,TOR,59,35,24,2210.0,47,21,26,0.447,227,0.207,4,0.211,10.6,235,46,191,0.196,522,0.45,47,0.495,8.4,282,67,217,0.238,749,0.377,51,0.404,8.8,2016-17,Regular%20Season
203124,Kyle O'Quinn,1610612752,NYK,76,29,47,1210.0,157,107,46,0.682,329,0.477,7,0.488,5.7,282,97,181,0.344,477,0.591,38,0.642,4.3,439,204,227,0.465,805,0.545,45,0.578,4.8,2016-17,Regular%20Season
202713,Kyle Singler,1610612760,OKC,22,10,12,333.0,8,3,5,0.375,24,0.333,2,0.364,10.7,40,12,28,0.3,72,0.556,3,0.58,7.5,48,15,33,0.313,96,0.5,5,0.527,8.0,2016-17,Regular%20Season
1627787,Kyle Wiltjer,1610612745,HOU,7,6,1,26.0,4,1,3,0.25,5,0.8,0,0.8,7.4,6,1,5,0.167,10,0.6,2,0.75,7.5,10,2,8,0.2,15,0.667,2,0.769,7.5,2016-17,Regular%20Season
202681,Kyrie Irving,1610612739,CLE,71,46,25,2490.0,52,23,28,0.442,230,0.226,13,0.24,10.8,178,24,157,0.135,387,0.46,31,0.5,9.3,230,47,185,0.204,615,0.374,44,0.403,9.6,2016-17,Regular%20Season
200746,LaMarcus Aldridge,1610612759,SAS,71,52,19,2301.0,170,114,52,0.671,360,0.472,10,0.486,5.7,349,103,242,0.295,586,0.596,34,0.632,6.0,519,217,294,0.418,945,0.549,44,0.576,5.9,2016-17,Regular%20Season
203934,Lamar Patterson,1610612737,ATL,3,0,3,32.0,1,1,0,1.0,2,0.5,0,0.5,14.7,6,1,5,0.167,10,0.6,0,0.6,7.7,7,2,5,0.286,12,0.583,0,0.583,8.7,2016-17,Regular%20Season
202362,Lance Stephenson,1610612754,IND,15,7,8,342.0,4,1,3,0.25,29,0.138,4,0.16,8.5,48,6,42,0.125,72,0.667,3,0.696,6.7,52,7,45,0.135,99,0.525,7,0.565,6.8,2016-17,Regular%20Season
202498,Lance Thomas,1610612752,NYK,41,13,28,912.0,32,12,16,0.375,96,0.333,2,0.34,8.7,110,19,91,0.173,207,0.531,13,0.567,7.0,142,31,107,0.218,302,0.47,15,0.495,7.5,2016-17,Regular%20Season
204038,Langston Galloway,1610612758,SAC,59,24,35,1263.0,27,5,21,0.185,72,0.375,3,0.391,10.3,129,15,114,0.116,231,0.558,21,0.614,9.0,156,20,135,0.128,303,0.515,24,0.559,9.2,2016-17,Regular%20Season
1626204,Larry Nance Jr.,1610612747,LAL,61,20,41,1414.0,119,71,47,0.597,267,0.446,10,0.463,6.7,249,73,174,0.293,415,0.6,33,0.652,5.1,368,144,221,0.391,681,0.54,43,0.577,5.6,2016-17,Regular%20Season
202336,Larry Sanders,1610612739,CLE,2,1,1,6.0,3,2,0,0.667,4,0.75,0,0.75,6.2,1,0,1,0.0,1,1.0,0,1.0,1.5,4,2,1,0.5,5,0.8,0,0.8,4.6,2016-17,Regular%20Season
202730,Lavoy Allen,1610612754,IND,55,26,29,833.0,105,79,25,0.752,225,0.467,12,0.493,5.0,114,29,85,0.254,212,0.538,13,0.573,5.3,219,108,110,0.493,437,0.501,25,0.532,5.2,2016-17,Regular%20Season
2544,LeBron James,1610612739,CLE,74,51,23,2795.0,97,50,39,0.515,279,0.348,11,0.362,9.3,542,123,420,0.227,783,0.692,45,0.734,6.2,639,173,459,0.271,1061,0.602,56,0.636,6.7,2016-17,Regular%20Season
2571,Leandro Barbosa,1610612756,PHX,47,11,36,739.0,15,5,10,0.333,60,0.25,3,0.263,13.8,85,7,79,0.082,138,0.616,15,0.691,8.0,100,12,89,0.12,198,0.505,18,0.556,8.9,2016-17,Regular%20Season
101150,Lou Williams,1610612745,HOU,72,31,41,1800.0,26,11,15,0.423,144,0.181,6,0.188,14.0,176,26,149,0.148,312,0.564,20,0.603,9.4,202,37,164,0.183,456,0.443,26,0.47,10.0,2016-17,Regular%20Season
201601,Luc Mbah a Moute,1610612746,LAC,72,46,26,1644.0,44,21,23,0.477,125,0.352,5,0.367,10.6,125,35,90,0.28,292,0.428,32,0.481,8.2,169,56,113,0.331,417,0.405,37,0.445,8.8,2016-17,Regular%20Season
203512,Lucas Nogueira,1610612761,TOR,51,32,19,1036.0,79,50,28,0.633,155,0.51,6,0.53,6.9,159,48,107,0.302,304,0.523,28,0.576,4.6,238,98,135,0.412,459,0.519,34,0.56,5.4,2016-17,Regular%20Season
2449,Luis Scola,1610612751,BKN,33,7,26,427.0,47,28,17,0.596,85,0.553,3,0.573,5.5,87,24,64,0.276,160,0.544,19,0.617,5.0,134,52,81,0.388,244,0.549,22,0.604,5.1,2016-17,Regular%20Season
202337,Luke Babbitt,1610612748,MIA,56,30,26,918.0,12,1,11,0.083,42,0.286,5,0.324,20.0,129,27,103,0.209,278,0.464,23,0.506,6.3,141,28,114,0.199,319,0.442,28,0.485,7.4,2016-17,Regular%20Season
2736,Luol Deng,1610612747,LAL,56,18,38,1486.0,63,40,23,0.635,174,0.362,11,0.387,8.4,232,49,182,0.211,397,0.584,32,0.636,6.1,295,89,205,0.302,568,0.519,43,0.562,6.5,2016-17,Regular%20Season
1627781,Malachi Richardson,1610612758,SAC,10,4,6,119.0,3,0,3,0.0,6,0.5,0,0.5,19.5,20,2,18,0.1,32,0.625,3,0.69,6.8,23,2,21,0.087,38,0.605,3,0.657,8.5,2016-17,Regular%20Season
1627763,Malcolm Brogdon,1610612749,MIL,71,37,34,1898.0,47,20,28,0.426,136,0.346,5,0.359,12.0,166,44,123,0.265,369,0.45,26,0.484,8.4,213,64,151,0.3,505,0.422,31,0.449,9.2,2016-17,Regular%20Season
1627098,Malcolm Delaney,1610612737,ATL,59,33,26,1068.0,10,4,5,0.4,48,0.208,3,0.222,17.4,113,14,98,0.124,235,0.481,23,0.533,8.2,123,18,103,0.146,283,0.435,26,0.479,8.9,2016-17,Regular%20Season
1627736,Malik Beasley,1610612743,DEN,8,5,3,111.0,4,2,2,0.5,10,0.4,0,0.4,4.3,12,3,9,0.25,24,0.5,1,0.522,5.0,16,5,11,0.313,34,0.471,1,0.485,4.8,2016-17,Regular%20Season
202412,Manny Harris,1610612742,DAL,3,0,3,23.0,3,3,0,1.0,9,0.333,1,0.375,5.1,6,0,6,0.0,10,0.6,0,0.6,4.5,9,3,6,0.333,19,0.474,1,0.5,4.7,2016-17,Regular%20Season
1938,Manu Ginobili,1610612759,SAS,58,45,13,1100.0,28,15,13,0.536,96,0.292,7,0.315,11.6,127,21,104,0.165,229,0.555,11,0.583,8.0,155,36,117,0.232,325,0.477,18,0.505,8.6,2016-17,Regular%20Season
201188,Marc Gasol,1610612763,MEM,74,40,34,2531.0,60,29,29,0.483,170,0.353,10,0.375,10.3,404,147,252,0.364,703,0.575,74,0.642,5.0,464,176,281,0.379,871,0.533,84,0.59,5.7,2016-17,Regular%20Season
1626273,Marcelo Huertas,1610612747,LAL,14,0,14,190.0,2,0,2,0.0,9,0.222,0,0.222,14.5,22,3,19,0.136,37,0.595,0,0.595,8.8,24,3,21,0.125,45,0.533,0,0.533,9.3,2016-17,Regular%20Season
101162,Marcin Gortat,1610612764,WAS,82,49,33,2556.0,238,151,85,0.634,589,0.404,16,0.415,6.3,611,170,439,0.278,992,0.616,84,0.673,4.4,849,321,524,0.378,1576,0.539,100,0.575,5.0,2016-17,Regular%20Season
201158,Marco Belinelli,1610612766,CHA,68,30,38,1654.0,14,6,10,0.429,79,0.177,2,0.182,11.5,164,14,148,0.085,276,0.594,21,0.643,8.3,178,20,158,0.112,355,0.501,23,0.536,8.6,2016-17,Regular%20Season
1627875,Marcus Georges-Hunt,1610612753,ORL,3,1,2,37.0,1,0,1,0.0,2,0.5,0,0.5,5.9,8,1,7,0.125,11,0.727,0,0.727,5.9,9,1,8,0.111,13,0.692,0,0.692,5.9,2016-17,Regular%20Season
202694,Marcus Morris Sr.,1610612765,DET,79,36,43,2565.0,77,36,34,0.468,244,0.316,5,0.322,8.9,289,69,217,0.239,526,0.549,38,0.592,6.6,366,105,251,0.287,768,0.477,43,0.505,7.1,2016-17,Regular%20Season
203935,Marcus Smart,1610612738,BOS,78,51,27,2374.0,78,49,30,0.628,269,0.29,5,0.295,7.2,227,76,148,0.335,407,0.558,26,0.596,7.9,305,125,178,0.41,676,0.451,31,0.473,7.7,2016-17,Regular%20Season
201977,Marcus Thornton,1610612764,WAS,28,13,15,501.0,22,11,8,0.5,56,0.393,1,0.4,5.7,54,10,43,0.185,90,0.6,6,0.643,7.8,76,21,51,0.276,146,0.521,7,0.547,7.3,2016-17,Regular%20Season
1626209,Mario Hezonja,1610612753,ORL,51,15,36,879.0,20,8,12,0.4,76,0.263,3,0.274,12.0,126,31,97,0.246,208,0.606,18,0.663,5.4,146,39,109,0.267,283,0.516,21,0.557,6.3,2016-17,Regular%20Season
202693,Markieff Morris,1610612764,WAS,74,44,30,2345.0,107,68,37,0.636,259,0.413,9,0.428,5.5,386,106,274,0.275,602,0.641,53,0.703,5.4,493,174,311,0.353,861,0.573,62,0.617,5.4,2016-17,Regular%20Season
1627737,Marquese Chriss,1610612756,PHX,77,23,54,1686.0,94,60,31,0.638,272,0.346,6,0.353,5.6,246,59,184,0.24,406,0.606,35,0.663,5.5,340,119,215,0.35,676,0.503,41,0.535,5.5,2016-17,Regular%20Season
201578,Marreese Speights,1610612746,LAC,79,49,30,1255.0,88,73,14,0.83,221,0.398,4,0.406,4.8,285,93,190,0.326,475,0.6,37,0.651,4.0,373,166,204,0.445,696,0.536,41,0.569,4.2,2016-17,Regular%20Season
1627850,Marshall Plumlee,1610612752,NYK,14,4,10,157.0,23,11,11,0.478,54,0.426,0,0.426,5.1,28,7,21,0.25,49,0.571,3,0.609,6.4,51,18,32,0.353,103,0.495,3,0.51,5.8,2016-17,Regular%20Season
101107,Marvin Williams,1610612766,CHA,75,32,43,2261.0,89,52,36,0.584,220,0.405,8,0.42,8.4,411,91,317,0.221,670,0.613,61,0.675,5.8,500,143,353,0.286,889,0.562,69,0.61,6.3,2016-17,Regular%20Season
203486,Mason Plumlee,1610612743,DEN,81,38,43,2148.0,170,100,71,0.588,460,0.37,12,0.379,5.7,435,136,299,0.313,778,0.559,74,0.618,4.6,605,236,370,0.39,1236,0.489,86,0.526,4.9,2016-17,Regular%20Season
2440,Matt Barnes,1610612744,GSW,72,38,34,1737.0,70,39,30,0.557,202,0.347,6,0.357,7.9,314,76,237,0.242,502,0.625,31,0.667,5.4,384,115,267,0.299,701,0.548,37,0.578,5.9,2016-17,Regular%20Season
203521,Matthew Dellavedova,1610612749,MIL,62,33,29,1633.0,24,11,13,0.458,113,0.212,5,0.222,11.9,122,21,102,0.172,279,0.437,19,0.469,11.4,146,32,115,0.219,392,0.372,24,0.397,11.5,2016-17,Regular%20Season
203090,Maurice Harkless,1610612757,POR,74,36,38,2176.0,125,78,41,0.624,339,0.369,14,0.385,6.4,216,62,149,0.287,419,0.516,33,0.56,7.3,341,140,190,0.411,757,0.45,47,0.48,7.0,2016-17,Regular%20Season
1626254,Maurice Ndour,1610612752,NYK,23,7,16,282.0,22,13,10,0.591,52,0.423,2,0.44,7.3,41,10,30,0.244,77,0.532,6,0.577,6.1,63,23,40,0.365,129,0.488,8,0.521,6.6,2016-17,Regular%20Season
1897,Metta World Peace,1610612747,LAL,12,4,8,126.0,5,1,3,0.2,16,0.313,0,0.313,14.3,15,2,13,0.133,23,0.652,2,0.714,7.8,20,3,16,0.15,39,0.513,2,0.541,9.1,2016-17,Regular%20Season
203086,Meyers Leonard,1610612757,POR,69,34,35,1171.0,27,14,12,0.519,94,0.287,2,0.293,8.3,209,58,151,0.278,379,0.551,29,0.597,4.7,236,72,163,0.305,473,0.499,31,0.534,5.1,2016-17,Regular%20Season
201563,Michael Beasley,1610612749,MIL,52,21,31,899.0,40,27,12,0.675,100,0.4,2,0.408,5.9,153,54,98,0.353,241,0.635,16,0.68,4.9,193,81,110,0.42,341,0.566,18,0.598,5.1,2016-17,Regular%20Season
203487,Michael Carter-Williams,1610612741,CHI,41,23,18,812.0,24,10,13,0.417,88,0.273,4,0.286,12.0,129,27,102,0.209,218,0.592,11,0.623,6.6,153,37,115,0.242,306,0.5,15,0.526,7.5,2016-17,Regular%20Season
1627771,Michael Gbinije,1610612765,DET,2,2,0,8.0,1,1,0,1.0,3,0.333,0,0.333,4.3,1,0,1,0.0,1,1.0,0,1.0,6.0,2,1,1,0.5,4,0.5,0,0.5,5.2,2016-17,Regular%20Season
203077,Michael Kidd-Gilchrist,1610612766,CHA,81,36,45,2349.0,156,96,58,0.615,358,0.436,14,0.453,7.4,409,108,296,0.264,699,0.585,60,0.64,5.6,565,204,354,0.361,1055,0.536,74,0.576,6.1,2016-17,Regular%20Season
201144,Mike Conley,1610612763,MEM,68,34,34,2261.0,31,10,23,0.323,132,0.235,3,0.24,15.8,210,28,183,0.133,402,0.522,28,0.561,9.6,241,38,206,0.158,534,0.451,31,0.479,10.6,2016-17,Regular%20Season
2399,Mike Dunleavy,1610612737,ATL,45,26,19,747.0,18,7,11,0.389,64,0.281,1,0.286,11.8,97,19,79,0.196,206,0.471,13,0.503,6.9,115,26,90,0.226,270,0.426,14,0.449,7.6,2016-17,Regular%20Season
2034,Mike Miller,1610612743,DEN,15,6,9,143.0,2,0,2,0.0,7,0.286,0,0.286,24.5,35,5,30,0.143,52,0.673,2,0.7,5.0,37,5,32,0.135,59,0.627,2,0.649,6.0,2016-17,Regular%20Season
203488,Mike Muscala,1610612737,ATL,66,35,31,1204.0,75,49,25,0.653,200,0.375,2,0.379,8.1,164,58,105,0.354,366,0.448,40,0.503,5.5,239,107,130,0.448,565,0.423,42,0.457,6.3,2016-17,Regular%20Season
203118,Mike Scott,1610612737,ATL,15,6,9,175.0,10,2,8,0.2,27,0.37,1,0.385,8.2,27,6,20,0.222,48,0.563,3,0.6,6.9,37,8,28,0.216,75,0.493,4,0.521,7.3,2016-17,Regular%20Season
1627861,Mike Tobey,1610612766,CHA,1,0,1,11.0,2,2,0,1.0,3,0.667,0,0.667,2.8,1,0,1,0.0,2,0.5,0,0.5,8.5,3,2,1,0.667,5,0.6,0,0.6,4.7,2016-17,Regular%20Season
203101,Miles Plumlee,1610612766,CHA,34,13,21,424.0,38,19,16,0.5,104,0.365,1,0.369,7.6,57,26,31,0.456,140,0.407,18,0.467,4.2,95,45,47,0.474,243,0.391,19,0.424,5.5,2016-17,Regular%20Season
1627851,Mindaugas Kuzminskas,1610612752,NYK,52,19,33,877.0,47,31,18,0.66,129,0.364,2,0.37,5.5,79,18,62,0.228,156,0.506,11,0.545,8.3,126,49,80,0.389,285,0.442,13,0.463,7.3,2016-17,Regular%20Season
203141,Mirza Teletovic,1610612749,MIL,57,27,30,991.0,11,7,5,0.636,41,0.268,0,0.268,11.5,151,41,109,0.272,266,0.568,12,0.594,5.6,162,48,114,0.296,307,0.528,12,0.549,6.0,2016-17,Regular%20Season
101145,Monta Ellis,1610612754,IND,68,35,33,1873.0,18,5,13,0.278,127,0.142,4,0.146,14.4,184,30,152,0.163,309,0.595,13,0.622,9.1,202,35,165,0.173,435,0.464,17,0.483,9.6,2016-17,Regular%20Season
1626149,Montrezl Harrell,1610612745,HOU,53,36,17,1026.0,81,48,30,0.593,187,0.433,4,0.443,6.0,138,40,94,0.29,269,0.513,23,0.561,5.8,219,88,124,0.402,456,0.48,27,0.51,5.8,2016-17,Regular%20Season
1626167,Myles Turner,1610612754,IND,80,42,38,2520.0,137,87,45,0.635,317,0.432,9,0.445,6.2,446,183,266,0.41,917,0.486,108,0.551,4.3,583,270,311,0.463,1233,0.473,117,0.522,4.7,2016-17,Regular%20Season
202357,Nemanja Bjelica,1610612750,MIN,60,26,34,1123.0,57,36,20,0.632,136,0.419,5,0.435,7.7,187,61,125,0.326,307,0.609,15,0.64,5.7,244,97,145,0.398,443,0.551,20,0.577,6.1,2016-17,Regular%20Season
2403,Nene,1610612745,HOU,65,45,20,1172.0,95,59,34,0.621,246,0.386,5,0.394,7.2,187,78,108,0.417,378,0.495,37,0.548,4.9,282,137,142,0.486,623,0.453,42,0.485,5.6,2016-17,Regular%20Season
203457,Nerlens Noel,1610612742,DAL,49,22,27,1017.0,92,56,35,0.609,210,0.438,7,0.453,6.3,200,70,130,0.35,350,0.571,42,0.649,4.2,292,126,165,0.432,560,0.521,49,0.571,4.8,2016-17,Regular%20Season
2555,Nick Collison,1610612760,OKC,11,8,3,95.0,9,4,5,0.444,24,0.375,1,0.391,3.9,22,8,14,0.364,36,0.611,1,0.629,6.2,31,12,19,0.387,60,0.517,2,0.534,5.5,2016-17,Regular%20Season
201156,Nick Young,1610612747,LAL,50,18,32,1329.0,25,7,18,0.28,77,0.325,6,0.352,15.6,113,21,91,0.186,215,0.526,16,0.568,8.8,138,28,109,0.203,292,0.473,22,0.511,10.0,2016-17,Regular%20Season
201587,Nicolas Batum,1610612766,CHA,77,35,42,2617.0,46,26,17,0.565,248,0.185,9,0.192,10.0,435,94,341,0.216,632,0.688,37,0.731,5.8,481,120,358,0.249,878,0.548,46,0.578,6.2,2016-17,Regular%20Season
1627852,Nicolas Brussino,1610612742,DAL,35,12,23,484.0,26,13,14,0.5,50,0.52,0,0.52,12.5,69,14,55,0.203,113,0.611,4,0.633,7.2,95,27,69,0.284,163,0.583,4,0.597,8.7,2016-17,Regular%20Season
1627879,Nicolas Laprovittola,1610612759,SAS,5,4,1,87.0,1,0,1,0.0,6,0.167,0,0.167,22.2,8,1,7,0.125,17,0.471,1,0.5,9.6,9,1,8,0.111,23,0.391,1,0.409,11.0,2016-17,Regular%20Season
203917,Nik Stauskas,1610612755,PHI,68,22,46,1880.0,21,5,18,0.238,104,0.202,4,0.21,18.4,205,23,182,0.112,354,0.579,22,0.617,7.9,226,28,200,0.124,457,0.495,26,0.524,8.9,2016-17,Regular%20Season
203999,Nikola Jokic,1610612743,DEN,72,36,36,2008.0,209,156,47,0.746,424,0.493,7,0.501,5.0,499,170,321,0.341,802,0.622,75,0.686,4.4,708,326,368,0.46,1226,0.577,82,0.619,4.6,2016-17,Regular%20Season
202703,Nikola Mirotic,1610612741,CHI,68,37,31,1648.0,61,34,27,0.557,153,0.399,3,0.407,7.2,323,95,228,0.294,541,0.597,38,0.642,5.1,384,129,255,0.336,692,0.555,41,0.59,5.5,2016-17,Regular%20Season
202696,Nikola Vucevic,1610612753,ORL,75,27,48,2163.0,176,123,43,0.699,340,0.518,8,0.53,5.9,603,218,382,0.362,890,0.678,61,0.727,4.3,779,341,425,0.438,1226,0.635,69,0.673,4.7,2016-17,Regular%20Season
203943,Noah Vonleh,1610612757,POR,70,36,34,1238.0,131,99,30,0.756,324,0.404,8,0.415,5.0,256,89,163,0.348,458,0.559,49,0.626,4.0,387,188,193,0.486,780,0.496,57,0.535,4.3,2016-17,Regular%20Season
1626181,Norman Powell,1610612761,TOR,62,39,23,1194.0,26,14,12,0.538,112,0.232,5,0.243,13.1,140,25,117,0.179,266,0.526,18,0.565,7.3,166,39,129,0.235,378,0.439,23,0.468,8.2,2016-17,Regular%20Season
202708,Norris Cole,1610612760,OKC,6,2,4,93.0,0,0,0,0.0,6,0.0,0,0.0,0.0,10,2,8,0.2,22,0.455,3,0.526,10.8,10,2,8,0.2,28,0.357,3,0.4,10.8,2016-17,Regular%20Season
1627855,Okaro White,1610612748,MIA,28,21,7,411.0,25,15,10,0.6,61,0.41,2,0.424,7.7,57,14,43,0.246,114,0.5,15,0.576,5.2,82,29,53,0.354,175,0.469,17,0.519,6.0,2016-17,Regular%20Season
201600,Omer Asik,1610612740,NOP,29,11,18,474.0,48,31,15,0.646,87,0.552,1,0.558,3.9,115,38,75,0.33,206,0.558,18,0.612,4.0,163,69,90,0.423,293,0.556,19,0.595,3.9,2016-17,Regular%20Season
201956,Omri Casspi,1610612750,MIN,33,10,23,601.0,27,16,11,0.593,93,0.29,1,0.293,6.6,85,14,71,0.165,168,0.506,22,0.582,5.4,112,30,82,0.268,260,0.431,23,0.473,5.7,2016-17,Regular%20Season
203490,Otto Porter Jr.,1610612764,WAS,78,46,32,2534.0,117,59,54,0.504,337,0.347,8,0.356,8.6,396,78,313,0.197,660,0.6,50,0.649,5.7,513,137,367,0.267,996,0.515,58,0.547,6.4,2016-17,Regular%20Season
200782,P.J. Tucker,1610612761,TOR,77,34,43,2153.0,115,69,44,0.6,346,0.332,16,0.348,7.8,343,74,269,0.216,554,0.619,55,0.687,6.0,458,143,313,0.312,898,0.51,71,0.554,6.4,2016-17,Regular%20Season
1627783,Pascal Siakam,1610612761,TOR,47,31,16,790.0,63,38,24,0.603,133,0.474,4,0.488,7.1,118,34,84,0.288,215,0.549,20,0.605,5.4,181,72,108,0.398,348,0.52,24,0.559,6.0,2016-17,Regular%20Season
1626192,Pat Connaughton,1610612757,POR,26,9,17,279.0,10,5,5,0.5,18,0.556,0,0.556,11.6,42,9,33,0.214,67,0.627,7,0.7,5.6,52,14,38,0.269,85,0.612,7,0.667,6.8,2016-17,Regular%20Season
1627868,Patricio Garino,1610612753,ORL,3,1,2,30.0,1,1,0,1.0,2,0.5,0,0.5,3.1,6,0,6,0.0,9,0.667,0,0.667,7.9,7,1,6,0.143,11,0.636,0,0.636,7.2,2016-17,Regular%20Season
201976,Patrick Beverley,1610612745,HOU,65,46,19,2012.0,95,43,50,0.453,269,0.353,6,0.361,10.3,298,55,244,0.185,556,0.536,54,0.594,7.4,393,98,294,0.249,825,0.476,60,0.514,8.1,2016-17,Regular%20Season
1627775,Patrick McCaw,1610612744,GSW,49,40,9,866.0,21,5,15,0.238,58,0.362,2,0.375,11.9,79,19,59,0.241,135,0.585,13,0.648,8.9,100,24,74,0.24,193,0.518,15,0.562,9.5,2016-17,Regular%20Season
202335,Patrick Patterson,1610612761,TOR,62,41,21,1562.0,62,36,24,0.581,140,0.443,5,0.459,8.9,231,59,173,0.255,394,0.586,26,0.628,6.0,293,95,197,0.324,532,0.551,31,0.585,6.6,2016-17,Regular%20Season
201988,Patty Mills,1610612759,SAS,65,49,16,1441.0,24,7,18,0.292,99,0.242,6,0.258,18.0,117,6,111,0.051,203,0.576,12,0.613,12.0,141,13,129,0.092,302,0.467,18,0.496,13.3,2016-17,Regular%20Season
2200,Pau Gasol,1610612759,SAS,63,47,16,1599.0,107,72,33,0.673,255,0.42,7,0.431,6.7,384,123,262,0.32,583,0.659,39,0.706,4.4,491,195,295,0.397,836,0.587,46,0.622,4.9,2016-17,Regular%20Season
202331,Paul George,1610612754,IND,74,39,35,2658.0,58,28,29,0.483,206,0.282,7,0.291,9.7,430,91,339,0.212,707,0.608,55,0.66,6.0,488,119,368,0.244,912,0.535,62,0.574,6.4,2016-17,Regular%20Season
200794,Paul Millsap,1610612737,ATL,69,40,29,2343.0,111,65,38,0.586,303,0.366,7,0.375,7.8,422,130,292,0.308,784,0.538,61,0.584,5.0,533,195,330,0.366,1086,0.491,68,0.524,5.5,2016-17,Regular%20Season
1718,Paul Pierce,1610612746,LAC,18,10,8,230.0,1,1,0,1.0,8,0.125,0,0.125,2.6,47,11,35,0.234,65,0.723,7,0.81,5.7,48,12,35,0.25,73,0.658,7,0.727,5.6,2016-17,Regular%20Season
1627835,Paul Zipser,1610612741,CHI,42,20,22,817.0,15,5,10,0.333,66,0.227,2,0.234,13.9,110,19,88,0.173,195,0.564,21,0.632,6.0,125,24,98,0.192,261,0.479,23,0.525,7.0,2016-17,Regular%20Season
203510,Pierre Jackson,1610612742,DAL,5,2,3,78.0,1,0,1,0.0,7,0.143,0,0.143,26.7,8,1,7,0.125,16,0.5,2,0.571,10.8,9,1,8,0.111,23,0.391,2,0.429,12.6,2016-17,Regular%20Season
203112,Quincy Acy,1610612751,BKN,33,10,23,530.0,20,15,5,0.75,70,0.286,2,0.294,5.7,95,20,74,0.211,159,0.597,15,0.66,4.1,115,35,79,0.304,229,0.502,17,0.542,4.4,2016-17,Regular%20Season
1626188,Quinn Cook,1610612740,NOP,6,4,2,108.0,1,0,1,0.0,4,0.25,0,0.25,69.0,6,0,6,0.0,17,0.353,2,0.4,8.2,7,0,7,0.0,21,0.333,2,0.368,16.9,2016-17,Regular%20Season
1626154,RJ Hunter,1610612741,CHI,1,1,0,4.0,0,0,0,0.0,0,0.0,0,0.0,0.0,1,0,1,0.0,1,1.0,0,1.0,12.7,1,0,1,0.0,1,1.0,0,1.0,12.7,2016-17,Regular%20Season
200765,Rajon Rondo,1610612741,CHI,67,32,35,1820.0,73,22,50,0.301,233,0.313,5,0.32,11.8,282,26,258,0.092,453,0.623,23,0.656,7.5,355,48,308,0.135,684,0.519,28,0.541,8.4,2016-17,Regular%20Season
1626176,Rakeem Christmas,1610612754,IND,21,9,12,203.0,26,14,11,0.538,61,0.426,1,0.433,6.4,30,7,23,0.233,57,0.526,3,0.556,5.9,56,21,34,0.375,118,0.475,4,0.491,6.1,2016-17,Regular%20Season
201196,Ramon Sessions,1610612766,CHA,37,18,19,631.0,11,6,5,0.545,43,0.256,5,0.289,15.3,62,8,56,0.129,94,0.66,8,0.721,10.5,73,14,61,0.192,137,0.533,13,0.589,11.2,2016-17,Regular%20Season
200751,Randy Foye,1610612751,BKN,63,15,48,1198.0,9,4,6,0.444,79,0.114,1,0.115,16.9,145,16,130,0.11,280,0.518,24,0.566,8.5,154,20,136,0.13,359,0.429,25,0.461,9.1,2016-17,Regular%20Season
1626173,Rashad Vaughn,1610612749,MIL,23,11,12,377.0,4,1,3,0.25,21,0.19,0,0.19,20.2,44,6,38,0.136,77,0.571,6,0.62,6.5,48,7,41,0.146,98,0.49,6,0.522,7.7,2016-17,Regular%20Season
203526,Raul Neto,1610612762,UTA,19,9,10,226.0,4,1,3,0.25,14,0.286,1,0.308,23.9,26,2,25,0.077,53,0.491,7,0.565,10.3,30,3,28,0.1,67,0.448,8,0.508,12.1,2016-17,Regular%20Season
101109,Raymond Felton,1610612746,LAC,69,42,27,1499.0,33,12,19,0.364,122,0.27,7,0.287,11.6,185,39,147,0.211,298,0.621,16,0.656,9.2,218,51,166,0.234,420,0.519,23,0.549,9.6,2016-17,Regular%20Season
203493,Reggie Bullock Jr.,1610612765,DET,24,10,14,423.0,13,6,7,0.462,38,0.342,2,0.361,15.5,51,11,39,0.216,73,0.699,4,0.739,6.0,64,17,46,0.266,110,0.582,6,0.615,8.0,2016-17,Regular%20Season
202704,Reggie Jackson,1610612765,DET,48,20,28,1331.0,21,11,10,0.524,97,0.216,7,0.233,11.6,93,16,77,0.172,207,0.449,32,0.531,8.5,114,27,87,0.237,304,0.375,39,0.43,9.1,2016-17,Regular%20Season
202130,Reggie Williams,1610612740,NOP,3,1,2,48.0,2,1,1,0.5,4,0.5,0,0.5,14.4,4,1,3,0.25,10,0.4,1,0.444,5.7,6,2,4,0.333,14,0.429,1,0.462,8.6,2016-17,Regular%20Season
2210,Richard Jefferson,1610612739,CLE,69,45,24,1437.0,28,11,16,0.393,136,0.206,3,0.211,11.4,175,38,135,0.217,358,0.489,27,0.529,7.1,203,49,151,0.241,493,0.412,30,0.438,7.7,2016-17,Regular%20Season
1626158,Richaun Holmes,1610612755,PHI,56,16,40,1186.0,94,63,30,0.67,246,0.382,12,0.402,5.6,217,84,133,0.387,384,0.565,34,0.62,4.4,311,147,163,0.473,629,0.494,46,0.533,4.8,2016-17,Regular%20Season
201937,Ricky Rubio,1610612750,MIN,71,28,43,2344.0,68,19,49,0.279,202,0.337,12,0.358,14.3,236,32,205,0.136,423,0.558,32,0.604,9.6,304,51,254,0.168,625,0.486,44,0.523,10.6,2016-17,Regular%20Season
203496,Robert Covington,1610612755,PHI,67,27,40,2119.0,92,47,42,0.511,238,0.387,12,0.407,9.6,344,102,242,0.297,630,0.546,64,0.608,5.3,436,149,284,0.342,868,0.502,76,0.551,6.1,2016-17,Regular%20Season
201577,Robin Lopez,1610612741,CHI,81,40,41,2271.0,244,186,52,0.762,595,0.41,17,0.422,4.2,276,122,153,0.442,622,0.444,62,0.493,5.3,520,308,205,0.592,1216,0.428,79,0.457,4.8,2016-17,Regular%20Season
203918,Rodney Hood,1610612762,UTA,56,38,18,1548.0,16,7,10,0.438,63,0.254,3,0.267,13.5,186,38,147,0.204,317,0.587,24,0.635,7.5,202,45,157,0.223,378,0.534,27,0.575,8.0,2016-17,Regular%20Season
203585,Rodney McGruder,1610612748,MIA,71,35,36,1854.0,94,42,53,0.447,249,0.378,11,0.395,9.5,162,34,127,0.21,343,0.472,36,0.528,8.6,256,76,180,0.297,592,0.432,47,0.47,8.9,2016-17,Regular%20Season
201155,Rodney Stuckey,1610612754,IND,36,17,19,663.0,6,2,3,0.333,43,0.14,1,0.143,11.2,78,14,64,0.179,134,0.582,9,0.624,9.0,84,16,67,0.19,177,0.475,10,0.503,9.2,2016-17,Regular%20Season
1627758,Ron Baker,1610612752,NYK,42,9,33,816.0,12,5,7,0.417,43,0.279,0,0.279,7.5,86,19,69,0.221,159,0.541,8,0.57,9.0,98,24,76,0.245,202,0.485,8,0.505,8.8,2016-17,Regular%20Season
1626178,Rondae Hollis-Jefferson,1610612751,BKN,77,19,58,1741.0,95,58,36,0.611,280,0.339,7,0.348,7.3,351,89,261,0.254,620,0.566,50,0.616,5.3,446,147,297,0.33,900,0.496,57,0.529,5.8,2016-17,Regular%20Season
101179,Ronnie Price,1610612756,PHX,7,1,6,94.0,3,0,3,0.0,8,0.375,1,0.429,20.9,8,0,8,0.0,14,0.571,1,0.615,11.7,11,0,11,0.0,22,0.5,2,0.55,14.2,2016-17,Regular%20Season
201579,Roy Hibbert,1610612743,DEN,43,20,23,660.0,54,33,16,0.611,136,0.397,2,0.403,4.1,98,35,62,0.357,217,0.452,29,0.521,5.0,152,68,78,0.447,353,0.431,31,0.472,4.7,2016-17,Regular%20Season
200752,Rudy Gay,1610612758,SAC,30,11,19,1013.0,35,19,15,0.543,121,0.289,4,0.299,7.1,155,37,119,0.239,234,0.662,16,0.711,6.1,190,56,134,0.295,355,0.535,20,0.567,6.3,2016-17,Regular%20Season
203497,Rudy Gobert,1610612762,UTA,81,51,30,2744.0,314,227,82,0.723,707,0.444,5,0.447,5.1,721,222,493,0.308,1200,0.601,100,0.655,4.1,1035,449,575,0.434,1904,0.544,105,0.575,4.4,2016-17,Regular%20Season
201566,Russell Westbrook,1610612760,OKC,81,46,35,2802.0,137,73,63,0.533,490,0.28,13,0.287,8.9,727,107,616,0.147,907,0.802,29,0.828,6.1,864,180,679,0.208,1387,0.623,42,0.642,6.6,2016-17,Regular%20Season
201583,Ryan Anderson,1610612745,HOU,70,49,21,2062.0,112,77,36,0.688,269,0.416,9,0.431,6.7,218,70,145,0.321,424,0.514,41,0.569,6.3,330,147,181,0.445,693,0.476,50,0.513,6.4,2016-17,Regular%20Season
203527,Ryan Kelly,1610612737,ATL,10,2,8,89.0,1,0,1,0.0,6,0.167,1,0.2,11.6,17,7,10,0.412,32,0.531,5,0.63,3.9,18,7,11,0.389,38,0.474,6,0.563,4.4,2016-17,Regular%20Season
1626257,Salah Mejri,1610612742,DAL,65,25,40,855.0,95,53,39,0.558,194,0.49,1,0.492,7.4,206,75,130,0.364,321,0.642,22,0.689,4.7,301,128,169,0.425,515,0.584,23,0.612,5.5,2016-17,Regular%20Season
1626155,Sam Dekker,1610612745,HOU,73,50,23,1392.0,94,56,37,0.596,199,0.472,7,0.49,7.0,190,44,145,0.232,367,0.518,28,0.56,7.0,284,100,182,0.352,565,0.503,35,0.536,7.0,2016-17,Regular%20Season
2756,Sasha Vujacic,1610612752,NYK,22,7,15,332.0,12,4,8,0.333,30,0.4,1,0.414,11.8,47,8,39,0.17,81,0.58,9,0.653,9.7,59,12,47,0.203,111,0.532,10,0.584,10.1,2016-17,Regular%20Season
203930,Sean Kilpatrick,1610612751,BKN,65,14,51,1658.0,22,11,8,0.5,155,0.142,3,0.145,9.3,257,23,232,0.089,416,0.618,37,0.678,6.7,279,34,240,0.122,570,0.489,40,0.526,6.9,2016-17,Regular%20Season
203902,Semaj Christon,1610612760,OKC,44,26,18,737.0,19,2,17,0.105,79,0.241,4,0.253,15.6,68,12,58,0.176,130,0.523,9,0.562,9.2,87,14,75,0.161,209,0.416,13,0.444,10.5,2016-17,Regular%20Season
201586,Serge Ibaka,1610612761,TOR,78,37,41,2401.0,129,88,36,0.682,306,0.422,4,0.427,6.1,409,126,282,0.308,708,0.578,68,0.639,4.8,538,214,318,0.398,1013,0.531,72,0.572,5.1,2016-17,Regular%20Season
200771,Sergio Rodriguez,1610612755,PHI,57,18,39,1339.0,21,5,17,0.238,100,0.21,1,0.212,16.6,136,13,123,0.096,216,0.63,5,0.645,11.4,157,18,140,0.115,315,0.498,6,0.508,12.2,2016-17,Regular%20Season
203552,Seth Curry,1610612742,DAL,61,25,36,1821.0,25,7,20,0.28,98,0.255,7,0.275,15.8,150,20,131,0.133,292,0.514,25,0.562,9.8,175,27,151,0.154,389,0.45,32,0.49,10.8,2016-17,Regular%20Season
203498,Shabazz Muhammad,1610612750,MIN,74,28,46,1453.0,84,50,33,0.595,262,0.321,13,0.337,7.4,136,30,106,0.221,209,0.651,11,0.687,6.0,220,80,139,0.364,471,0.467,24,0.492,6.6,2016-17,Regular%20Season
203894,Shabazz Napier,1610612757,POR,32,15,17,409.0,8,3,5,0.375,27,0.296,0,0.296,13.6,53,8,45,0.151,92,0.576,9,0.639,8.1,61,11,50,0.18,119,0.513,9,0.555,8.9,2016-17,Regular%20Season
2733,Shaun Livingston,1610612744,GSW,67,56,11,1198.0,28,9,15,0.321,98,0.286,10,0.318,11.0,123,24,100,0.195,238,0.517,13,0.547,9.2,151,33,115,0.219,336,0.449,23,0.482,9.5,2016-17,Regular%20Season
1627848,Shawn Long,1610612755,PHI,17,5,12,234.0,41,27,13,0.659,79,0.519,3,0.539,5.9,44,14,30,0.318,82,0.537,5,0.571,4.2,85,41,43,0.482,161,0.528,8,0.556,5.0,2016-17,Regular%20Season
1627815,Sheldon Mac,1610612764,WAS,16,8,8,252.0,4,0,4,0.0,18,0.222,2,0.25,11.2,30,4,26,0.133,52,0.577,2,0.6,8.4,34,4,30,0.118,70,0.486,4,0.515,8.7,2016-17,Regular%20Season
202714,Shelvin Mack,1610612762,UTA,49,30,19,1110.0,20,2,19,0.1,84,0.238,3,0.247,17.7,105,17,90,0.162,208,0.505,18,0.553,7.9,125,19,109,0.152,291,0.43,21,0.463,9.6,2016-17,Regular%20Season
1627746,Skal Labissiere,1610612758,SAC,29,8,21,597.0,51,33,18,0.647,121,0.421,3,0.432,5.8,111,30,82,0.27,189,0.587,19,0.653,5.3,162,63,100,0.389,310,0.523,22,0.563,5.5,2016-17,Regular%20Season
203524,Solomon Hill,1610612740,NOP,76,33,43,2280.0,51,28,24,0.549,151,0.338,8,0.357,8.4,256,60,196,0.234,471,0.544,39,0.593,7.5,307,88,220,0.287,622,0.494,47,0.534,7.7,2016-17,Regular%20Season
203915,Spencer Dinwiddie,1610612751,BKN,50,13,37,1179.0,26,11,15,0.423,87,0.299,3,0.31,12.1,134,19,115,0.142,239,0.561,17,0.604,7.7,160,30,130,0.188,326,0.491,20,0.523,8.4,2016-17,Regular%20Season
201150,Spencer Hawes,1610612749,MIL,47,23,24,763.0,38,19,17,0.5,96,0.396,1,0.4,6.1,153,45,108,0.294,273,0.56,32,0.635,5.3,191,64,125,0.335,369,0.518,33,0.568,5.4,2016-17,Regular%20Season
1626169,Stanley Johnson,1610612765,DET,69,33,36,1264.0,36,17,18,0.472,116,0.31,1,0.313,9.0,153,23,130,0.15,270,0.567,23,0.619,6.5,189,40,148,0.212,386,0.49,24,0.522,6.9,2016-17,Regular%20Season
201939,Stephen Curry,1610612744,GSW,79,65,14,2639.0,61,36,27,0.59,294,0.207,10,0.215,11.1,292,38,256,0.13,591,0.494,42,0.532,9.5,353,74,283,0.21,885,0.399,52,0.424,9.8,2016-17,Regular%20Season
1627757,Stephen Zimmerman,1610612753,ORL,15,7,8,89.0,11,8,3,0.727,29,0.379,0,0.379,8.9,24,8,16,0.333,32,0.75,1,0.774,5.3,35,16,19,0.457,61,0.574,1,0.583,6.4,2016-17,Regular%20Season
200779,Steve Novak,1610612749,MIL,3,2,1,7.0,0,0,0,0.0,0,0.0,0,0.0,0.0,3,0,3,0.0,2,1.5,0,1.5,7.0,3,0,3,0.0,2,1.5,0,1.5,7.0,2016-17,Regular%20Season
203500,Steven Adams,1610612760,OKC,80,47,33,2389.0,281,201,71,0.715,645,0.436,11,0.443,5.3,332,111,220,0.334,619,0.536,56,0.59,5.5,613,312,291,0.509,1263,0.485,67,0.513,5.4,2016-17,Regular%20Season
204456,T.J. McConnell,1610612755,PHI,75,25,50,2003.0,39,7,37,0.179,193,0.202,7,0.21,15.0,212,20,195,0.094,374,0.567,24,0.606,9.3,251,27,232,0.108,566,0.443,31,0.469,10.2,2016-17,Regular%20Season
203933,T.J. Warren,1610612756,PHX,61,17,44,1959.0,123,68,54,0.553,275,0.447,5,0.456,9.3,212,59,156,0.278,352,0.602,25,0.648,7.4,335,127,210,0.379,623,0.538,30,0.565,8.1,2016-17,Regular%20Season
201959,Taj Gibson,1610612760,OKC,78,41,37,1989.0,158,104,48,0.658,435,0.363,9,0.371,6.1,327,93,233,0.284,560,0.584,39,0.628,5.2,485,197,281,0.406,992,0.489,48,0.514,5.5,2016-17,Regular%20Season
204028,Tarik Black,1610612747,LAL,65,23,42,1077.0,144,102,40,0.708,330,0.436,11,0.451,4.8,199,70,128,0.352,370,0.538,29,0.584,5.0,343,172,168,0.501,698,0.491,40,0.521,4.9,2016-17,Regular%20Season
1627752,Taurean Prince,1610612737,ATL,45,19,26,889.0,25,14,11,0.56,77,0.325,1,0.329,8.6,131,36,95,0.275,221,0.593,16,0.639,6.2,156,50,106,0.321,298,0.523,17,0.555,6.6,2016-17,Regular%20Season
203093,Terrence Jones,1610612749,MIL,53,19,34,1269.0,65,38,26,0.585,177,0.367,4,0.376,6.2,241,74,164,0.307,422,0.571,24,0.606,5.1,306,112,190,0.366,598,0.512,28,0.537,5.3,2016-17,Regular%20Season
203082,Terrence Ross,1610612753,ORL,71,33,38,1797.0,17,7,9,0.412,68,0.25,4,0.266,13.3,185,38,146,0.205,316,0.585,28,0.642,7.1,202,45,155,0.223,382,0.529,32,0.577,7.6,2016-17,Regular%20Season
1626179,Terry Rozier,1610612738,BOS,71,46,25,1244.0,40,17,23,0.425,124,0.323,6,0.339,10.9,187,33,154,0.176,330,0.567,25,0.613,7.2,227,50,177,0.22,454,0.5,31,0.537,7.8,2016-17,Regular%20Season
200757,Thabo Sefolosha,1610612737,ATL,61,32,29,1576.0,54,26,27,0.481,187,0.289,4,0.295,9.2,216,51,162,0.236,383,0.564,32,0.615,5.7,270,77,189,0.285,570,0.474,36,0.506,6.4,2016-17,Regular%20Season
201152,Thaddeus Young,1610612754,IND,73,40,33,2209.0,130,79,51,0.608,325,0.4,12,0.415,7.8,314,89,220,0.283,555,0.566,46,0.617,6.3,444,168,271,0.378,880,0.505,58,0.54,6.7,2016-17,Regular%20Season
203080,Thomas Robinson,1610612747,LAL,42,13,29,549.0,84,50,33,0.595,185,0.454,3,0.462,6.1,139,37,101,0.266,205,0.678,13,0.724,4.7,223,87,134,0.39,390,0.572,16,0.596,5.2,2016-17,Regular%20Season
1627748,Thon Maker,1610612749,MIL,41,21,20,498.0,40,23,16,0.575,87,0.46,0,0.46,7.2,74,25,49,0.338,163,0.454,24,0.532,5.6,114,48,65,0.421,248,0.46,24,0.509,6.2,2016-17,Regular%20Season
201168,Tiago Splitter,1610612755,PHI,8,1,7,76.0,8,6,1,0.75,20,0.4,2,0.444,3.4,14,3,12,0.214,21,0.667,4,0.824,5.4,22,9,13,0.409,41,0.537,6,0.629,4.8,2016-17,Regular%20Season
204025,Tim Frazier,1610612740,NOP,58,22,36,1448.0,34,15,18,0.441,148,0.23,8,0.243,9.8,139,22,121,0.158,332,0.419,39,0.474,8.0,173,37,139,0.214,480,0.36,47,0.4,8.3,2016-17,Regular%20Season
203501,Tim Hardaway Jr.,1610612737,ATL,76,41,35,2096.0,35,14,18,0.4,154,0.227,5,0.235,12.0,188,36,152,0.191,348,0.54,23,0.578,8.1,223,50,170,0.224,502,0.444,28,0.47,8.8,2016-17,Regular%20Season
1627817,Tim Quarterman,1610612757,POR,8,4,4,60.0,4,2,2,0.5,7,0.571,1,0.667,11.3,10,2,8,0.2,17,0.588,0,0.588,7.1,14,4,10,0.286,24,0.583,1,0.609,8.3,2016-17,Regular%20Season
202389,Timofey Mozgov,1610612747,LAL,54,16,38,1104.0,104,61,40,0.587,263,0.395,9,0.409,5.6,160,54,106,0.338,321,0.498,43,0.576,5.3,264,115,146,0.436,584,0.452,52,0.496,5.5,2016-17,Regular%20Season
1627789,Timothe Luwawu-Cabarrot,1610612755,PHI,57,18,39,1095.0,25,11,14,0.44,113,0.221,4,0.229,10.7,124,28,97,0.226,254,0.488,20,0.53,6.3,149,39,111,0.262,367,0.406,24,0.434,7.0,2016-17,Regular%20Season
202699,Tobias Harris,1610612765,DET,80,36,44,2516.0,63,27,32,0.429,219,0.288,9,0.3,8.9,353,80,271,0.227,590,0.598,56,0.661,5.9,416,107,303,0.257,807,0.515,65,0.561,6.3,2016-17,Regular%20Season
203107,Tomas Satoransky,1610612764,WAS,38,22,16,575.0,25,14,12,0.56,71,0.352,7,0.391,9.4,58,9,49,0.155,119,0.487,5,0.509,8.1,83,23,61,0.277,190,0.437,12,0.466,8.5,2016-17,Regular%20Season
201962,Toney Douglas,1610612763,MEM,20,12,8,362.0,13,4,9,0.308,28,0.464,0,0.464,10.6,48,6,42,0.125,81,0.593,10,0.676,8.6,61,10,51,0.164,109,0.56,10,0.616,9.1,2016-17,Regular%20Season
2754,Tony Allen,1610612763,MEM,71,36,35,1914.0,166,116,48,0.699,427,0.389,13,0.401,6.3,225,47,175,0.209,354,0.636,26,0.686,7.3,391,163,223,0.417,781,0.501,39,0.527,6.9,2016-17,Regular%20Season
2225,Tony Parker,1610612759,SAS,55,42,13,1389.0,8,2,7,0.25,125,0.064,5,0.067,12.5,104,8,95,0.077,228,0.456,22,0.505,10.8,112,10,102,0.089,353,0.317,27,0.344,11.1,2016-17,Regular%20Season
203503,Tony Snell,1610612749,MIL,74,39,35,2173.0,22,3,19,0.136,74,0.297,5,0.319,17.3,226,37,188,0.164,404,0.559,32,0.608,8.2,248,40,207,0.161,477,0.52,37,0.564,9.1,2016-17,Regular%20Season
1626203,Treveon Graham,1610612766,CHA,13,3,10,121.0,5,3,2,0.6,18,0.278,0,0.278,11.6,17,3,14,0.176,28,0.607,3,0.68,6.3,22,6,16,0.273,46,0.478,3,0.512,7.5,2016-17,Regular%20Season
2772,Trevor Ariza,1610612745,HOU,80,53,27,2773.0,54,22,32,0.407,207,0.261,7,0.27,12.3,404,102,302,0.252,652,0.62,48,0.669,6.4,458,124,334,0.271,858,0.534,55,0.57,7.1,2016-17,Regular%20Season
202344,Trevor Booker,1610612751,BKN,70,18,52,1734.0,141,95,45,0.674,378,0.373,5,0.378,6.5,425,107,317,0.252,657,0.647,49,0.699,5.1,566,202,362,0.357,1032,0.548,54,0.579,5.4,2016-17,Regular%20Season
203504,Trey Burke,1610612764,WAS,29,23,6,397.0,7,1,6,0.143,23,0.304,2,0.333,13.1,40,6,34,0.15,79,0.506,5,0.541,10.5,47,7,40,0.149,102,0.461,7,0.495,10.9,2016-17,Regular%20Season
1626168,Trey Lyles,1610612762,UTA,64,40,24,1113.0,48,31,17,0.646,133,0.361,5,0.375,8.2,187,37,152,0.198,361,0.518,33,0.57,5.3,235,68,169,0.289,493,0.477,38,0.516,5.9,2016-17,Regular%20Season
202684,Tristan Thompson,1610612739,CLE,78,50,28,2336.0,286,200,80,0.699,697,0.41,14,0.419,5.4,429,118,309,0.275,778,0.551,64,0.601,5.3,715,318,389,0.445,1473,0.485,78,0.513,5.3,2016-17,Regular%20Season
203584,Troy Daniels,1610612763,MEM,44,23,21,913.0,22,8,14,0.364,55,0.4,1,0.407,11.5,78,20,58,0.256,150,0.52,12,0.565,7.0,100,28,72,0.28,205,0.488,13,0.521,8.0,2016-17,Regular%20Season
1627786,Troy Williams,1610612745,HOU,18,11,7,484.0,15,7,7,0.467,50,0.3,1,0.306,9.2,54,9,44,0.167,107,0.505,10,0.557,5.8,69,16,51,0.232,157,0.439,11,0.473,6.5,2016-17,Regular%20Season
201951,Ty Lawson,1610612758,SAC,62,24,38,1570.0,44,15,29,0.341,143,0.308,4,0.317,11.8,135,9,127,0.067,236,0.572,12,0.603,10.6,179,24,156,0.134,378,0.474,16,0.494,10.9,2016-17,Regular%20Season
203898,Tyler Ennis,1610612747,LAL,26,12,14,350.0,9,2,8,0.222,33,0.273,2,0.29,15.7,36,8,29,0.222,63,0.571,8,0.655,9.0,45,10,37,0.222,96,0.469,10,0.523,10.4,2016-17,Regular%20Season
204020,Tyler Johnson,1610612748,MIA,72,35,37,2147.0,50,26,23,0.52,225,0.222,9,0.231,9.9,243,40,204,0.165,505,0.481,48,0.532,7.7,293,66,227,0.225,730,0.401,57,0.435,8.1,2016-17,Regular%20Season
1627755,Tyler Ulis,1610612756,PHX,38,8,30,925.0,19,3,15,0.158,89,0.213,4,0.224,18.5,75,7,68,0.093,150,0.5,13,0.547,10.3,94,10,83,0.106,239,0.393,17,0.423,12.0,2016-17,Regular%20Season
203092,Tyler Zeller,1610612738,BOS,39,26,13,458.0,43,30,12,0.698,102,0.422,3,0.434,7.4,81,33,48,0.407,153,0.529,10,0.566,5.5,124,63,60,0.508,254,0.488,13,0.515,6.2,2016-17,Regular%20Season
201936,Tyreke Evans,1610612758,SAC,38,16,22,758.0,13,6,7,0.462,90,0.144,3,0.149,5.9,124,30,95,0.242,202,0.614,12,0.653,6.4,137,36,102,0.263,292,0.469,15,0.495,6.5,2016-17,Regular%20Season
2199,Tyson Chandler,1610612756,PHX,45,14,31,1229.0,138,94,41,0.681,310,0.445,10,0.46,5.4,367,111,253,0.302,538,0.682,35,0.73,4.2,505,205,294,0.406,845,0.598,45,0.631,4.5,2016-17,Regular%20Season
1626145,Tyus Jones,1610612750,MIN,36,13,23,594.0,10,2,8,0.2,41,0.244,1,0.25,17.2,57,4,53,0.07,84,0.679,2,0.695,11.9,67,6,61,0.09,125,0.536,3,0.549,12.7,2016-17,Regular%20Season
2617,Udonis Haslem,1610612748,MIA,10,6,4,110.0,8,6,2,0.75,23,0.348,0,0.348,9.4,27,9,17,0.333,40,0.675,9,0.871,4.1,35,15,19,0.429,63,0.556,9,0.648,5.4,2016-17,Regular%20Season
203506,Victor Oladipo,1610612760,OKC,67,39,28,2223.0,39,11,27,0.282,149,0.262,5,0.271,14.9,252,34,219,0.135,474,0.532,56,0.603,7.1,291,45,246,0.155,622,0.468,61,0.519,8.1,2016-17,Regular%20Season
1713,Vince Carter,1610612763,MEM,68,33,35,1699.0,36,19,16,0.528,141,0.255,1,0.257,8.9,190,40,152,0.211,362,0.525,32,0.576,7.0,226,59,168,0.261,502,0.45,33,0.482,7.3,2016-17,Regular%20Season
1627735,Wade Baldwin IV,1610612763,MEM,19,8,11,330.0,11,5,6,0.455,38,0.289,1,0.297,10.6,35,4,31,0.114,70,0.5,8,0.565,7.4,46,9,37,0.196,108,0.426,9,0.465,8.1,2016-17,Regular%20Season
201961,Wayne Ellington,1610612748,MIA,54,31,23,1329.0,18,5,14,0.278,78,0.231,2,0.237,15.9,114,16,96,0.14,208,0.548,11,0.579,8.0,132,21,110,0.159,286,0.462,13,0.484,9.2,2016-17,Regular%20Season
1627782,Wayne Selden,1610612763,MEM,9,3,6,204.0,1,0,1,0.0,8,0.125,0,0.125,6.0,15,5,10,0.333,31,0.484,2,0.517,9.9,16,5,11,0.313,39,0.41,2,0.432,9.7,2016-17,Regular%20Season
202325,Wesley Johnson,1610612746,LAC,56,36,20,739.0,26,6,19,0.231,51,0.51,0,0.51,13.9,155,39,116,0.252,249,0.622,14,0.66,5.8,181,45,135,0.249,299,0.605,14,0.635,6.9,2016-17,Regular%20Season
202083,Wesley Matthews,1610612742,DAL,69,27,42,2359.0,18,3,15,0.167,110,0.164,5,0.171,16.4,241,40,202,0.166,434,0.555,32,0.6,7.6,259,43,217,0.166,543,0.477,37,0.512,8.2,2016-17,Regular%20Season
203115,Will Barton,1610612743,DEN,57,28,29,1638.0,55,24,29,0.436,182,0.302,7,0.314,10.5,197,32,165,0.162,365,0.54,33,0.593,5.9,252,56,194,0.222,547,0.461,40,0.497,6.9,2016-17,Regular%20Season
1626161,Willie Cauley-Stein,1610612758,SAC,68,25,43,1387.0,85,55,28,0.647,202,0.421,9,0.44,6.8,254,85,167,0.335,409,0.621,23,0.658,5.4,339,140,195,0.413,611,0.555,32,0.585,5.7,2016-17,Regular%20Season
203186,Willie Reed,1610612748,MIA,70,38,32,1026.0,129,97,33,0.752,253,0.51,3,0.516,4.8,203,78,127,0.384,377,0.538,37,0.597,4.5,332,175,160,0.527,630,0.527,40,0.563,4.6,2016-17,Regular%20Season
1626195,Willy Hernangomez,1610612752,NYK,67,25,42,1306.0,170,105,51,0.618,380,0.447,7,0.456,5.7,332,99,233,0.298,522,0.636,48,0.7,4.0,502,204,284,0.406,901,0.557,55,0.593,4.6,2016-17,Regular%20Season
201163,Wilson Chandler,1610612743,DEN,70,34,36,2165.0,103,65,32,0.631,243,0.424,7,0.436,6.9,350,88,262,0.251,566,0.618,48,0.676,5.6,453,153,294,0.338,806,0.562,55,0.603,5.9,2016-17,Regular%20Season
1627812,Yogi Ferrell,1610612742,DAL,42,18,24,1130.0,20,7,14,0.35,87,0.23,5,0.244,13.6,91,13,78,0.143,189,0.481,15,0.523,9.5,111,20,92,0.18,276,0.402,20,0.434,10.4,2016-17,Regular%20Season
203897,Zach LaVine,1610612750,MIN,46,15,31,1710.0,18,2,15,0.111,114,0.158,6,0.167,19.2,141,12,131,0.085,266,0.53,22,0.578,8.3,159,14,146,0.088,380,0.418,28,0.452,9.5,2016-17,Regular%20Season
2216,Zach Randolph,1610612763,MEM,73,38,35,1786.0,182,127,50,0.698,465,0.391,13,0.403,4.9,416,126,289,0.303,598,0.696,49,0.758,4.6,598,253,339,0.423,1058,0.565,62,0.6,4.7,2016-17,Regular%20Season
2585,Zaza Pachulia,1610612744,GSW,70,58,12,1268.0,140,89,47,0.636,322,0.435,6,0.443,6.1,270,98,173,0.363,489,0.552,52,0.618,4.8,410,187,220,0.456,810,0.506,58,0.545,5.3,2016-17,Regular%20Season
201166,Aaron Brooks,1610612754,IND,1,0,1,7.0,0,0,0,0.0,1,0.0,0,0.0,0.0,1,0,1,0.0,1,1.0,0,1.0,2.3,1,0,1,0.0,2,0.5,0,0.5,2.3,2016-17,Playoffs
201143,Al Horford,1610612738,BOS,18,9,9,610.0,31,16,14,0.516,75,0.413,2,0.425,6.4,87,27,60,0.31,175,0.497,15,0.544,5.7,118,43,74,0.364,250,0.472,17,0.506,5.9,2016-17,Playoffs
202329,Al-Farouq Aminu,1610612757,POR,4,0,4,113.0,5,2,3,0.4,14,0.357,1,0.385,6.6,21,6,14,0.286,40,0.525,8,0.656,5.0,26,8,17,0.308,54,0.481,9,0.578,5.3,2016-17,Playoffs
203518,Alex Abrines,1610612760,OKC,4,1,3,76.0,2,2,0,1.0,9,0.222,0,0.222,4.0,7,1,6,0.143,16,0.438,2,0.5,9.0,9,3,6,0.333,25,0.36,2,0.391,7.9,2016-17,Playoffs
203459,Allen Crabbe,1610612757,POR,4,0,4,92.0,0,0,0,0.0,7,0.0,0,0.0,0.0,12,2,10,0.167,18,0.667,1,0.706,6.8,12,2,10,0.167,25,0.48,1,0.5,6.8,2016-17,Playoffs
101161,Amir Johnson,1610612738,BOS,11,3,8,123.0,17,12,4,0.706,32,0.531,0,0.531,3.4,13,5,8,0.385,48,0.271,8,0.325,2.9,30,17,12,0.567,80,0.375,8,0.417,3.2,2016-17,Playoffs
2738,Andre Iguodala,1610612744,GSW,15,14,1,409.0,9,3,6,0.333,31,0.29,3,0.321,14.3,56,10,46,0.179,83,0.675,5,0.718,8.2,65,13,52,0.2,114,0.57,8,0.613,9.1,2016-17,Playoffs
203460,Andre Roberson,1610612760,OKC,5,1,4,185.0,18,7,10,0.389,34,0.529,1,0.545,7.6,13,5,8,0.385,35,0.371,2,0.394,6.3,31,12,18,0.387,69,0.449,3,0.47,7.0,2016-17,Playoffs
1626150,Andrew Harrison,1610612763,MEM,5,2,3,111.0,4,0,4,0.0,8,0.5,1,0.571,13.3,7,0,7,0.0,12,0.583,1,0.636,7.3,11,0,11,0.0,20,0.55,2,0.611,9.5,2016-17,Playoffs
201627,Anthony Morrow,1610612741,CHI,2,0,2,25.0,0,0,0,0.0,1,0.0,0,0.0,0.0,3,1,2,0.333,4,0.75,0,0.75,13.0,3,1,2,0.333,5,0.6,0,0.6,13.0,2016-17,Playoffs
203085,Austin Rivers,1610612746,LAC,3,1,2,90.0,1,0,1,0.0,7,0.143,0,0.143,32.7,7,1,6,0.143,16,0.438,3,0.538,8.5,8,1,7,0.125,23,0.348,3,0.4,11.5,2016-17,Playoffs
202340,Avery Bradley,1610612738,BOS,18,9,9,645.0,18,9,10,0.5,60,0.3,2,0.31,11.8,53,9,44,0.17,130,0.408,11,0.445,6.5,71,18,54,0.254,190,0.374,13,0.401,7.9,2016-17,Playoffs
201933,Blake Griffin,1610612746,LAC,3,2,1,99.0,3,2,1,0.667,13,0.231,0,0.231,21.9,15,6,9,0.4,26,0.577,3,0.652,3.7,18,8,10,0.444,39,0.462,3,0.5,6.7,2016-17,Playoffs
201628,Bobby Brown,1610612745,HOU,2,2,0,9.0,0,0,0,0.0,0,0.0,0,0.0,0.0,2,0,2,0.0,2,1.0,0,1.0,8.8,2,0,2,0.0,2,1.0,0,1.0,8.8,2016-17,Playoffs
1626171,Bobby Portis,1610612741,CHI,6,2,4,121.0,5,4,0,0.8,12,0.417,0,0.417,3.3,31,3,29,0.097,43,0.721,3,0.775,6.0,36,7,29,0.194,55,0.655,3,0.692,5.7,2016-17,Playoffs
202711,Bojan Bogdanovic,1610612764,WAS,13,7,6,264.0,10,5,5,0.5,20,0.5,0,0.5,10.9,46,16,29,0.348,71,0.648,4,0.687,5.6,56,21,34,0.375,91,0.615,4,0.644,6.6,2016-17,Playoffs
2564,Boris Diaw,1610612762,UTA,9,3,6,173.0,3,1,2,0.333,21,0.143,0,0.143,14.1,18,4,14,0.222,45,0.4,4,0.439,5.3,21,5,16,0.238,66,0.318,4,0.339,6.6,2016-17,Playoffs
203078,Bradley Beal,1610612764,WAS,13,7,6,505.0,15,7,9,0.467,51,0.294,2,0.306,8.0,29,3,26,0.103,66,0.439,3,0.46,10.4,44,10,35,0.227,117,0.376,5,0.393,9.6,2016-17,Playoffs
201148,Brandan Wright,1610612763,MEM,2,0,2,12.0,1,0,1,0.0,2,0.5,1,1.0,12.4,1,0,1,0.0,4,0.25,0,0.25,6.8,2,0,2,0.0,6,0.333,1,0.4,9.6,2016-17,Playoffs
101138,Brandon Bass,1610612746,LAC,1,0,1,4.0,1,0,1,0.0,2,0.5,0,0.5,4.0,0,0,0,0.0,0,0.0,0,0.0,0.0,1,0,1,0.0,2,0.5,0,0.5,4.0,2016-17,Playoffs
201943,Brandon Jennings,1610612764,WAS,9,5,4,123.0,5,3,2,0.6,10,0.5,1,0.556,9.3,14,1,14,0.071,28,0.5,3,0.56,9.8,19,4,16,0.211,38,0.5,4,0.559,9.6,2016-17,Playoffs
1627854,Bryn Forbes,1610612759,SAS,5,2,3,67.0,0,0,0,0.0,1,0.0,0,0.0,0.0,6,1,5,0.167,15,0.4,2,0.462,8.7,6,1,5,0.167,16,0.375,2,0.429,8.7,2016-17,Playoffs
203468,CJ McCollum,1610612757,POR,4,0,4,140.0,8,1,7,0.125,23,0.348,0,0.348,11.2,16,5,11,0.313,27,0.593,0,0.593,7.3,24,6,18,0.25,50,0.48,0,0.48,8.6,2016-17,Playoffs
101139,CJ Miles,1610612754,IND,4,0,4,82.0,4,4,0,1.0,6,0.667,0,0.667,5.3,4,1,3,0.25,5,0.8,0,0.8,6.4,8,5,3,0.625,11,0.727,0,0.727,5.8,2016-17,Playoffs
1626166,Cameron Payne,1610612741,CHI,1,0,1,4.0,0,0,0,0.0,0,0.0,0,0.0,0.0,1,0,1,0.0,1,1.0,0,1.0,8.7,1,0,1,0.0,1,1.0,0,1.0,8.7,2016-17,Playoffs
101112,Channing Frye,1610612739,CLE,9,8,1,127.0,0,0,0,0.0,8,0.0,1,0.0,0.0,22,9,13,0.409,44,0.5,7,0.595,5.8,22,9,13,0.409,52,0.423,8,0.5,5.8,2016-17,Playoffs
101108,Chris Paul,1610612746,LAC,7,3,4,260.0,4,0,4,0.0,19,0.211,0,0.211,23.0,31,1,30,0.032,53,0.585,4,0.633,8.2,35,1,34,0.029,72,0.486,4,0.515,9.9,2016-17,Playoffs
203991,Clint Capela,1610612745,HOU,11,6,5,286.0,26,20,6,0.769,80,0.325,3,0.338,6.3,70,33,37,0.471,117,0.598,12,0.667,4.2,96,53,43,0.552,197,0.487,15,0.527,4.7,2016-17,Playoffs
202709,Cory Joseph,1610612761,TOR,6,2,4,150.0,4,2,2,0.5,10,0.4,0,0.4,9.4,17,5,12,0.294,28,0.607,1,0.63,7.9,21,7,14,0.333,38,0.553,1,0.568,8.2,2016-17,Playoffs
1626245,Cristiano Felicio,1610612741,CHI,6,2,4,82.0,7,5,2,0.714,21,0.333,0,0.333,4.8,19,5,14,0.263,27,0.704,2,0.76,4.5,26,10,16,0.385,48,0.542,2,0.565,4.6,2016-17,Playoffs
2563,Dahntay Jones,1610612739,CLE,5,4,1,23.0,1,0,1,0.0,3,0.333,0,0.333,40.2,6,1,6,0.167,9,0.667,0,0.667,10.3,7,1,7,0.143,12,0.583,0,0.583,14.0,2016-17,Playoffs
1627745,Damian Jones,1610612744,GSW,4,4,0,21.0,4,4,0,1.0,6,0.667,0,0.667,5.5,2,0,2,0.0,1,2.0,0,2.0,11.1,6,4,2,0.667,7,0.857,0,0.857,7.4,2016-17,Playoffs
203081,Damian Lillard,1610612757,POR,4,0,4,151.0,4,0,4,0.0,19,0.211,0,0.211,7.9,14,2,12,0.143,25,0.56,1,0.583,8.8,18,2,16,0.111,44,0.409,1,0.419,8.6,2016-17,Playoffs
1627849,Daniel Ochefu,1610612764,WAS,1,1,0,1.0,0,0,0,0.0,0,0.0,0,0.0,0.0,1,0,1,0.0,1,1.0,0,1.0,3.0,1,0,1,0.0,1,1.0,0,1.0,3.0,2016-17,Playoffs
201980,Danny Green,1610612759,SAS,16,8,8,436.0,13,5,8,0.385,36,0.361,0,0.361,14.0,44,6,38,0.136,102,0.431,6,0.458,7.0,57,11,46,0.193,138,0.413,6,0.432,8.8,2016-17,Playoffs
203957,Dante Exum,1610612762,UTA,3,1,2,53.0,2,2,0,1.0,5,0.4,0,0.4,3.1,4,1,3,0.25,8,0.5,0,0.5,6.2,6,3,3,0.5,13,0.462,0,0.462,5.2,2016-17,Playoffs
101135,David Lee,1610612759,SAS,14,8,6,243.0,20,14,6,0.7,48,0.417,3,0.444,6.4,37,12,25,0.324,68,0.544,3,0.569,5.4,57,26,31,0.456,116,0.491,6,0.518,5.7,2016-17,Playoffs
2561,David West,1610612744,GSW,16,15,1,207.0,7,4,3,0.571,25,0.28,2,0.304,10.8,39,16,22,0.41,63,0.619,4,0.661,4.5,46,20,25,0.435,88,0.523,6,0.561,5.5,2016-17,Playoffs
202722,Davis Bertans,1610612759,SAS,9,3,6,89.0,5,2,3,0.4,9,0.556,0,0.556,10.8,15,4,12,0.267,26,0.577,2,0.625,5.6,20,6,15,0.3,35,0.571,2,0.606,6.9,2016-17,Playoffs
201599,DeAndre Jordan,1610612746,LAC,7,3,4,264.0,25,18,7,0.72,65,0.385,1,0.391,3.9,76,22,54,0.289,107,0.71,6,0.752,5.6,101,40,61,0.396,172,0.587,7,0.612,5.2,2016-17,Playoffs
201942,DeMar DeRozan,1610612761,TOR,10,4,6,373.0,4,3,1,0.75,32,0.125,2,0.133,6.1,45,6,39,0.133,68,0.662,5,0.714,7.0,49,9,40,0.184,100,0.49,7,0.527,6.9,2016-17,Playoffs
201960,DeMarre Carroll,1610612761,TOR,10,4,6,155.0,4,2,2,0.5,13,0.308,1,0.333,6.7,23,3,20,0.13,37,0.622,2,0.657,6.3,27,5,22,0.185,50,0.54,3,0.574,6.3,2016-17,Playoffs
1627749,Dejounte Murray,1610612759,SAS,7,2,5,132.0,4,3,1,0.75,22,0.182,4,0.222,3.3,23,4,19,0.174,43,0.535,3,0.575,4.2,27,7,20,0.259,65,0.415,7,0.466,4.1,2016-17,Playoffs
1626153,Delon Wright,1610612761,TOR,5,3,2,67.0,4,3,1,0.75,6,0.667,0,0.667,6.1,9,0,9,0.0,18,0.5,3,0.6,9.5,13,3,10,0.231,24,0.542,3,0.619,8.5,2016-17,Playoffs
203471,Dennis Schroder,1610612737,ATL,6,2,4,211.0,4,0,4,0.0,21,0.19,1,0.2,7.6,10,2,8,0.2,29,0.345,7,0.455,10.8,14,2,12,0.143,50,0.28,8,0.333,9.9,2016-17,Playoffs
1627756,Denzel Valentine,1610612741,CHI,2,0,2,20.0,0,0,0,0.0,1,0.0,0,0.0,0.0,8,3,5,0.375,10,0.8,1,0.889,5.7,8,3,5,0.375,11,0.727,1,0.8,5.7,2016-17,Playoffs
101114,Deron Williams,1610612739,CLE,12,8,4,190.0,3,3,0,1.0,15,0.2,2,0.231,11.3,20,3,18,0.15,36,0.556,4,0.625,9.9,23,6,18,0.261,51,0.451,6,0.511,10.1,2016-17,Playoffs
202324,Derrick Favors,1610612762,UTA,11,4,7,225.0,15,12,3,0.8,49,0.306,0,0.306,3.9,45,11,34,0.244,78,0.577,7,0.634,4.2,60,23,37,0.383,127,0.472,7,0.5,4.1,2016-17,Playoffs
202682,Derrick Williams,1610612739,CLE,2,2,0,12.0,1,0,1,0.0,1,1.0,0,1.0,15.9,1,0,1,0.0,1,1.0,0,1.0,2.4,2,0,2,0.0,2,1.0,0,1.0,9.1,2016-17,Playoffs
203473,Dewayne Dedmon,1610612759,SAS,12,6,6,97.0,21,12,8,0.571,28,0.75,0,0.75,6.5,26,10,16,0.385,45,0.578,2,0.605,4.4,47,22,24,0.468,73,0.644,2,0.662,5.3,2016-17,Playoffs
1627738,Deyonta Davis,1610612763,MEM,2,1,1,9.0,2,2,0,1.0,6,0.333,2,0.5,2.1,3,0,3,0.0,1,3.0,0,3.0,4.7,5,2,3,0.4,7,0.714,2,1.0,3.7,2016-17,Playoffs
1627734,Domantas Sabonis,1610612760,OKC,1,0,1,4.0,0,0,0,0.0,1,0.0,0,0.0,0.0,2,0,2,0.0,2,1.0,0,1.0,7.3,2,0,2,0.0,3,0.667,0,0.667,7.3,2016-17,Playoffs
203926,Doug McDermott,1610612760,OKC,4,1,3,63.0,0,0,0,0.0,4,0.0,0,0.0,0.0,5,1,4,0.2,9,0.556,1,0.625,10.4,5,1,4,0.2,13,0.385,1,0.417,10.4,2016-17,Playoffs
203110,Draymond Green,1610612744,GSW,17,16,1,593.0,20,12,8,0.6,58,0.345,1,0.351,6.4,135,45,90,0.333,237,0.57,18,0.616,4.3,155,57,98,0.368,295,0.525,19,0.562,4.5,2016-17,Playoffs
2730,Dwight Howard,1610612737,ATL,6,2,4,157.0,18,14,4,0.778,43,0.419,1,0.429,5.1,46,18,28,0.391,77,0.597,5,0.639,3.9,64,32,32,0.5,120,0.533,6,0.561,4.2,2016-17,Playoffs
2548,Dwyane Wade,1610612741,CHI,6,2,4,190.0,6,1,5,0.167,17,0.353,2,0.4,11.5,24,4,20,0.167,46,0.522,4,0.571,7.0,30,5,25,0.167,63,0.476,6,0.526,7.9,2016-17,Playoffs
202683,Enes Freedom,1610612760,OKC,4,1,3,42.0,3,2,1,0.667,10,0.3,0,0.3,2.8,6,2,4,0.333,16,0.375,1,0.4,5.8,9,4,5,0.444,26,0.346,1,0.36,4.8,2016-17,Playoffs
201569,Eric Gordon,1610612745,HOU,11,6,5,358.0,5,2,3,0.4,28,0.179,1,0.185,12.2,38,4,34,0.105,85,0.447,7,0.487,7.8,43,6,37,0.14,113,0.381,8,0.41,8.3,2016-17,Playoffs
101141,Ersan Ilyasova,1610612737,ATL,6,2,4,90.0,14,9,4,0.643,30,0.467,1,0.483,6.9,17,4,13,0.235,36,0.472,5,0.548,4.1,31,13,17,0.419,66,0.47,6,0.517,5.3,2016-17,Playoffs
202323,Evan Turner,1610612757,POR,4,0,4,124.0,3,1,2,0.333,17,0.176,0,0.176,15.2,20,4,15,0.2,30,0.667,2,0.714,8.4,23,5,17,0.217,47,0.489,2,0.511,9.3,2016-17,Playoffs
1627832,Fred VanVleet,1610612761,TOR,1,0,1,2.0,0,0,0,0.0,0,0.0,0,0.0,0.0,1,0,1,0.0,1,1.0,0,1.0,6.9,1,0,1,0.0,1,1.0,0,1.0,6.9,2016-17,Playoffs
201588,George Hill,1610612762,UTA,8,4,4,281.0,8,4,4,0.5,22,0.364,0,0.364,10.8,25,3,22,0.12,47,0.532,3,0.568,8.6,33,7,26,0.212,69,0.478,3,0.5,9.1,2016-17,Playoffs
101123,Gerald Green,1610612738,BOS,8,5,3,151.0,2,1,1,0.5,8,0.25,0,0.25,17.5,18,5,13,0.278,38,0.474,2,0.5,5.1,20,6,14,0.3,46,0.435,2,0.455,6.4,2016-17,Playoffs
203507,Giannis Antetokounmpo,1610612749,MIL,6,2,4,243.0,10,7,3,0.7,34,0.294,1,0.303,8.1,47,14,32,0.298,76,0.618,6,0.671,6.0,57,21,35,0.368,110,0.518,7,0.553,6.4,2016-17,Playoffs
203922,Glenn Robinson III,1610612754,IND,2,0,2,18.0,0,0,0,0.0,1,0.0,0,0.0,0.0,3,0,3,0.0,6,0.5,1,0.6,4.8,3,0,3,0.0,7,0.429,1,0.5,4.8,2016-17,Playoffs
202330,Gordon Hayward,1610612762,UTA,11,4,7,411.0,7,2,5,0.286,31,0.226,2,0.241,8.8,60,9,50,0.15,81,0.741,5,0.789,7.8,67,11,55,0.164,112,0.598,7,0.638,8.0,2016-17,Playoffs
202328,Greg Monroe,1610612749,MIL,6,2,4,141.0,17,12,5,0.706,38,0.447,0,0.447,4.1,27,11,16,0.407,49,0.551,7,0.643,3.9,44,23,21,0.523,87,0.506,7,0.55,4.0,2016-17,Playoffs
203546,Ian Clark,1610612744,GSW,13,13,0,186.0,4,2,2,0.5,18,0.222,0,0.222,10.7,22,4,19,0.182,32,0.688,1,0.71,7.1,26,6,21,0.231,50,0.52,1,0.531,8.2,2016-17,Playoffs
101133,Ian Mahinmi,1610612764,WAS,4,3,1,52.0,3,2,1,0.667,10,0.3,0,0.3,8.7,8,2,6,0.25,12,0.667,1,0.727,4.1,11,4,7,0.364,22,0.5,1,0.524,5.4,2016-17,Playoffs
202697,Iman Shumpert,1610612739,CLE,13,10,3,229.0,6,1,5,0.167,16,0.375,0,0.375,5.7,41,6,35,0.146,65,0.631,4,0.672,6.5,47,7,40,0.149,81,0.58,4,0.61,6.5,2016-17,Playoffs
203477,Isaiah Canaan,1610612741,CHI,2,0,2,70.0,0,0,0,0.0,2,0.0,0,0.0,0.0,4,0,4,0.0,7,0.571,0,0.571,7.1,4,0,4,0.0,9,0.444,0,0.444,7.1,2016-17,Playoffs
1627819,Isaiah Taylor,1610612745,HOU,2,1,1,6.0,1,1,0,1.0,2,0.5,0,0.5,3.4,1,0,1,0.0,1,1.0,0,1.0,9.8,2,1,1,0.5,3,0.667,0,0.667,6.6,2016-17,Playoffs
202738,Isaiah Thomas,1610612738,BOS,15,8,7,521.0,5,3,2,0.6,43,0.116,1,0.119,14.1,42,8,34,0.19,87,0.483,5,0.512,9.2,47,11,36,0.234,130,0.362,6,0.379,9.7,2016-17,Playoffs
200755,JJ Redick,1610612746,LAC,6,3,3,164.0,0,0,0,0.0,7,0.0,0,0.0,0.0,12,2,10,0.167,15,0.8,1,0.857,6.7,12,2,10,0.167,22,0.545,1,0.571,6.7,2016-17,Playoffs
2747,JR Smith,1610612739,CLE,16,12,4,440.0,5,1,4,0.2,14,0.357,0,0.357,13.7,37,3,33,0.081,60,0.617,4,0.661,9.2,42,4,37,0.095,74,0.568,4,0.6,9.7,2016-17,Playoffs
203210,JaMychal Green,1610612763,MEM,6,2,4,118.0,3,1,2,0.333,16,0.188,0,0.188,5.5,17,4,13,0.235,30,0.567,7,0.739,4.4,20,5,15,0.25,46,0.435,7,0.513,4.5,2016-17,Playoffs
201580,JaVale McGee,1610612744,GSW,15,14,1,139.0,22,13,8,0.591,37,0.595,0,0.595,7.6,26,9,17,0.346,57,0.456,10,0.553,3.9,48,22,25,0.458,94,0.511,10,0.571,5.5,2016-17,Playoffs
203109,Jae Crowder,1610612738,BOS,18,9,9,596.0,20,7,12,0.35,64,0.313,6,0.345,10.5,95,21,75,0.221,146,0.651,9,0.693,6.2,115,28,87,0.243,210,0.548,15,0.59,6.9,2016-17,Playoffs
1627774,Jake Layman,1610612757,POR,1,0,1,10.0,0,0,0,0.0,0,0.0,0,0.0,0.0,1,0,1,0.0,6,0.167,1,0.2,3.5,1,0,1,0.0,6,0.167,1,0.2,3.5,2016-17,Playoffs
1627751,Jakob Poeltl,1610612761,TOR,4,1,3,23.0,6,3,2,0.5,11,0.545,0,0.545,3.0,6,1,5,0.167,8,0.75,1,0.857,3.2,12,4,7,0.333,19,0.632,1,0.667,3.1,2016-17,Playoffs
2037,Jamal Crawford,1610612746,LAC,5,2,3,146.0,2,1,1,0.5,7,0.286,1,0.333,3.9,7,1,6,0.143,14,0.5,0,0.5,9.1,9,2,7,0.222,21,0.429,1,0.45,8.0,2016-17,Playoffs
203516,James Ennis III,1610612763,MEM,6,2,4,159.0,8,2,6,0.25,21,0.381,1,0.4,11.6,17,4,13,0.235,36,0.472,3,0.515,5.4,25,6,19,0.24,57,0.439,4,0.472,7.4,2016-17,Playoffs
201935,James Harden,1610612745,HOU,11,6,5,407.0,7,4,3,0.571,46,0.152,1,0.156,10.7,53,12,40,0.226,111,0.477,8,0.515,6.6,60,16,43,0.267,157,0.382,9,0.405,7.1,2016-17,Playoffs
2592,James Jones,1610612739,CLE,3,2,1,21.0,1,0,0,0.0,0,0.0,0,0.0,0.0,3,0,3,0.0,7,0.429,1,0.5,8.0,4,0,3,0.0,7,0.571,1,0.667,8.0,2016-17,Playoffs
203949,James Michael McAdoo,1610612744,GSW,5,5,0,40.0,4,3,1,0.75,7,0.571,1,0.667,4.3,8,4,4,0.5,19,0.421,0,0.421,6.1,12,7,5,0.583,26,0.462,1,0.48,5.5,2016-17,Playoffs
203923,James Young,1610612738,BOS,4,1,3,28.0,1,0,1,0.0,3,0.333,0,0.333,24.8,6,0,6,0.0,8,0.75,1,0.857,5.3,7,0,7,0.0,11,0.636,1,0.7,8.0,2016-17,Playoffs
1626185,Jarell Martin,1610612763,MEM,2,0,2,8.0,2,1,1,0.5,5,0.4,0,0.4,3.7,2,1,1,0.5,2,1.0,0,1.0,4.3,4,2,2,0.5,7,0.571,0,0.571,4.0,2016-17,Playoffs
201160,Jason Smith,1610612764,WAS,13,7,6,157.0,10,5,4,0.5,24,0.417,2,0.455,6.6,19,8,11,0.421,40,0.475,1,0.487,5.1,29,13,15,0.448,64,0.453,3,0.475,5.6,2016-17,Playoffs
1891,Jason Terry,1610612749,MIL,5,2,3,63.0,2,0,2,0.0,6,0.333,0,0.333,16.0,6,0,5,0.0,12,0.5,2,0.6,10.4,8,0,7,0.0,18,0.444,2,0.5,12.0,2016-17,Playoffs
1627759,Jaylen Brown,1610612738,BOS,13,6,7,184.0,12,8,4,0.667,20,0.6,0,0.6,7.7,24,4,21,0.167,37,0.649,3,0.706,6.8,36,12,25,0.333,57,0.632,3,0.667,7.1,2016-17,Playoffs
201952,Jeff Teague,1610612754,IND,4,0,4,142.0,0,0,0,0.0,10,0.0,1,0.0,0.0,13,2,11,0.154,24,0.542,0,0.542,7.1,13,2,11,0.154,34,0.382,1,0.394,7.1,2016-17,Playoffs
203481,Jeff Withey,1610612762,UTA,2,1,1,18.0,3,1,2,0.333,4,0.75,0,0.75,11.1,1,0,1,0.0,6,0.167,1,0.2,5.1,4,1,3,0.25,10,0.4,1,0.444,9.6,2016-17,Playoffs
203924,Jerami Grant,1610612760,OKC,5,1,4,111.0,7,5,2,0.714,12,0.583,1,0.636,8.0,12,4,8,0.333,20,0.6,2,0.667,6.6,19,9,10,0.474,32,0.594,3,0.655,7.1,2016-17,Playoffs
1626170,Jerian Grant,1610612741,CHI,2,1,1,36.0,0,0,0,0.0,2,0.0,0,0.0,0.0,3,0,3,0.0,6,0.5,0,0.5,8.9,3,0,3,0.0,8,0.375,0,0.375,8.9,2016-17,Playoffs
202710,Jimmy Butler,1610612741,CHI,6,2,4,239.0,9,7,2,0.778,32,0.281,1,0.29,7.6,35,8,27,0.229,65,0.538,10,0.636,6.4,44,15,29,0.341,97,0.454,11,0.512,6.6,2016-17,Playoffs
204060,Joe Ingles,1610612762,UTA,11,4,7,333.0,2,1,1,0.5,15,0.133,0,0.133,13.6,39,5,34,0.128,57,0.684,1,0.696,9.3,41,6,35,0.146,72,0.569,1,0.577,9.5,2016-17,Playoffs
2207,Joe Johnson,1610612762,UTA,10,4,6,296.0,8,5,3,0.625,19,0.421,1,0.444,7.9,35,3,32,0.086,57,0.614,2,0.636,6.5,43,8,35,0.186,76,0.566,3,0.589,6.8,2016-17,Playoffs
201202,Joel Anthony,1610612759,SAS,2,0,2,13.0,2,1,1,0.5,3,0.667,0,0.667,5.7,2,0,2,0.0,4,0.5,0,0.5,4.9,4,1,3,0.25,7,0.571,0,0.571,5.3,2016-17,Playoffs
1627762,Joel Bolomboy,1610612762,UTA,2,0,2,9.0,0,0,0,0.0,3,0.0,0,0.0,0.0,2,0,2,0.0,2,1.0,0,1.0,4.7,2,0,2,0.0,5,0.4,0,0.4,4.7,2016-17,Playoffs
203530,Joffrey Lauvergne,1610612741,CHI,3,0,3,26.0,5,4,0,0.8,9,0.556,0,0.556,3.6,4,1,3,0.25,10,0.4,1,0.444,4.1,9,5,3,0.556,19,0.474,1,0.5,3.8,2016-17,Playoffs
203089,John Henson,1610612749,MIL,1,0,1,9.0,2,2,0,1.0,3,0.667,0,0.667,5.2,2,0,2,0.0,1,2.0,0,2.0,3.4,4,2,2,0.5,4,1.0,0,1.0,4.3,2016-17,Playoffs
202322,John Wall,1610612764,WAS,13,7,6,507.0,7,0,7,0.0,67,0.104,4,0.111,12.9,41,5,37,0.122,77,0.532,2,0.547,10.5,48,5,44,0.104,144,0.333,6,0.348,10.8,2016-17,Playoffs
201973,Jonas Jerebko,1610612738,BOS,9,4,5,109.0,7,2,5,0.286,16,0.438,0,0.438,11.8,22,6,16,0.273,32,0.688,1,0.71,6.4,29,8,21,0.276,48,0.604,1,0.617,7.7,2016-17,Playoffs
202685,Jonas Valanciunas,1610612761,TOR,10,4,6,226.0,9,6,3,0.667,45,0.2,1,0.205,5.1,58,25,33,0.431,91,0.637,5,0.674,3.3,67,31,36,0.463,136,0.493,6,0.515,3.5,2016-17,Playoffs
203613,Jonathon Simmons,1610612759,SAS,10,4,6,218.0,9,4,4,0.444,31,0.29,1,0.3,3.5,19,6,14,0.316,39,0.487,2,0.514,5.3,28,10,18,0.357,70,0.4,3,0.418,4.8,2016-17,Playoffs
1626175,Jordan Mickey,1610612738,BOS,1,0,1,10.0,0,0,0,0.0,0,0.0,0,0.0,0.0,5,0,5,0.0,7,0.714,1,0.833,4.1,5,0,5,0.0,7,0.714,1,0.833,4.1,2016-17,Playoffs
101181,Jose Calderon,1610612737,ATL,5,2,3,67.0,2,1,1,0.5,9,0.222,2,0.286,12.3,6,2,4,0.333,13,0.462,0,0.462,7.9,8,3,5,0.375,22,0.364,2,0.4,9.0,2016-17,Playoffs
203994,Jusuf Nurkic,1610612757,POR,1,0,1,17.0,0,0,0,0.0,2,0.0,0,0.0,0.0,11,5,6,0.455,12,0.917,0,0.917,3.2,11,5,6,0.455,14,0.786,0,0.786,3.2,2016-17,Playoffs
202695,Kawhi Leonard,1610612759,SAS,12,7,5,429.0,19,10,8,0.526,39,0.487,0,0.487,8.8,74,21,52,0.284,100,0.74,5,0.779,6.7,93,31,60,0.333,139,0.669,5,0.694,7.1,2016-17,Playoffs
203482,Kelly Olynyk,1610612738,BOS,15,8,7,300.0,14,12,2,0.857,44,0.318,0,0.318,6.0,43,9,34,0.209,87,0.494,9,0.551,5.5,57,21,36,0.368,131,0.435,9,0.467,5.6,2016-17,Playoffs
1626162,Kelly Oubre Jr.,1610612764,WAS,10,5,5,179.0,9,3,6,0.333,32,0.281,1,0.29,9.7,19,4,15,0.211,33,0.576,1,0.594,5.2,28,7,21,0.25,65,0.431,2,0.444,6.7,2016-17,Playoffs
203145,Kent Bazemore,1610612737,ATL,6,2,4,150.0,4,2,2,0.5,16,0.25,0,0.25,9.0,19,4,15,0.211,31,0.613,1,0.633,7.0,23,6,17,0.261,47,0.489,1,0.5,7.3,2016-17,Playoffs
201142,Kevin Durant,1610612744,GSW,15,14,1,533.0,16,9,5,0.563,37,0.432,3,0.471,6.9,103,35,67,0.34,152,0.678,11,0.73,5.9,119,44,72,0.37,189,0.63,14,0.68,6.0,2016-17,Playoffs
201567,Kevin Love,1610612739,CLE,18,13,5,578.0,36,23,10,0.639,88,0.409,4,0.429,5.0,155,59,95,0.381,244,0.635,13,0.671,4.5,191,82,105,0.429,332,0.575,17,0.606,4.6,2016-17,Playoffs
202338,Kevin Seraphin,1610612754,IND,4,0,4,59.0,8,7,2,0.875,21,0.381,2,0.421,6.1,6,1,5,0.167,17,0.353,2,0.4,3.9,14,8,7,0.571,38,0.368,4,0.412,5.2,2016-17,Playoffs
203114,Khris Middleton,1610612749,MIL,6,2,4,231.0,0,0,0,0.0,10,0.0,0,0.0,0.0,28,2,26,0.071,55,0.509,7,0.583,7.5,28,2,26,0.071,65,0.431,7,0.483,7.5,2016-17,Playoffs
202691,Klay Thompson,1610612744,GSW,17,16,1,596.0,11,5,6,0.455,38,0.289,0,0.289,11.7,55,8,47,0.145,118,0.466,16,0.539,7.6,66,13,53,0.197,156,0.423,16,0.471,8.3,2016-17,Playoffs
203937,Kyle Anderson,1610612759,SAS,13,5,8,186.0,12,6,6,0.5,33,0.364,1,0.375,7.3,34,3,30,0.088,51,0.667,0,0.667,7.9,46,9,36,0.196,84,0.548,1,0.554,7.7,2016-17,Playoffs
2594,Kyle Korver,1610612739,CLE,14,11,3,251.0,2,1,1,0.5,3,0.667,0,0.667,22.1,28,7,21,0.25,63,0.444,6,0.491,6.9,30,8,22,0.267,66,0.455,6,0.5,7.9,2016-17,Playoffs
200768,Kyle Lowry,1610612761,TOR,8,4,4,300.0,3,1,2,0.333,26,0.115,0,0.115,7.2,22,5,17,0.227,47,0.468,4,0.512,6.8,25,6,19,0.24,73,0.342,4,0.362,6.9,2016-17,Playoffs
202713,Kyle Singler,1610612760,OKC,1,0,1,10.0,0,0,0,0.0,1,0.0,0,0.0,0.0,1,0,1,0.0,2,0.5,1,1.0,3.7,1,0,1,0.0,3,0.333,1,0.5,3.7,2016-17,Playoffs
202681,Kyrie Irving,1610612739,CLE,17,12,5,623.0,13,5,8,0.385,69,0.188,0,0.188,11.2,38,8,30,0.211,103,0.369,6,0.392,9.1,51,13,38,0.255,172,0.297,6,0.307,9.6,2016-17,Playoffs
200746,LaMarcus Aldridge,1610612759,SAS,16,8,8,537.0,43,36,9,0.837,101,0.426,3,0.439,4.8,76,16,60,0.211,116,0.655,8,0.704,7.1,119,52,69,0.437,217,0.548,11,0.578,6.2,2016-17,Playoffs
202362,Lance Stephenson,1610612754,IND,4,0,4,107.0,1,0,1,0.0,10,0.1,0,0.1,14.1,20,3,17,0.15,26,0.769,1,0.8,5.6,21,3,18,0.143,36,0.583,1,0.6,6.0,2016-17,Playoffs
202730,Lavoy Allen,1610612754,IND,2,0,2,10.0,0,0,0,0.0,2,0.0,0,0.0,0.0,2,1,1,0.5,3,0.667,0,0.667,4.4,2,1,1,0.5,5,0.4,0,0.4,4.4,2016-17,Playoffs
2544,LeBron James,1610612739,CLE,18,13,5,744.0,19,9,10,0.474,67,0.284,2,0.292,12.1,145,28,114,0.193,223,0.65,15,0.697,5.9,164,37,124,0.226,290,0.566,17,0.601,6.6,2016-17,Playoffs
101150,Lou Williams,1610612745,HOU,9,6,3,233.0,7,5,2,0.714,28,0.25,1,0.259,5.7,23,3,20,0.13,38,0.605,4,0.676,11.3,30,8,22,0.267,66,0.455,5,0.492,10.0,2016-17,Playoffs
201601,Luc Mbah a Moute,1610612746,LAC,7,3,4,224.0,10,3,7,0.3,22,0.455,1,0.476,10.1,24,5,18,0.208,42,0.571,2,0.6,10.3,34,8,25,0.235,64,0.531,3,0.557,10.2,2016-17,Playoffs
203512,Lucas Nogueira,1610612761,TOR,2,1,1,3.0,2,2,0,1.0,2,1.0,0,1.0,4.4,3,0,3,0.0,3,1.0,0,1.0,4.9,5,2,3,0.4,5,1.0,0,1.0,4.7,2016-17,Playoffs
1627763,Malcolm Brogdon,1610612749,MIL,6,2,4,183.0,3,1,3,0.333,11,0.273,1,0.3,21.2,23,2,21,0.087,40,0.575,3,0.622,9.2,26,3,24,0.115,51,0.51,4,0.553,10.7,2016-17,Playoffs
1627098,Malcolm Delaney,1610612737,ATL,1,1,0,3.0,0,0,0,0.0,0,0.0,0,0.0,0.0,1,1,0,1.0,1,1.0,0,1.0,14.3,1,1,0,1.0,1,1.0,0,1.0,14.3,2016-17,Playoffs
1938,Manu Ginobili,1610612759,SAS,15,8,7,279.0,10,4,6,0.4,24,0.417,0,0.417,6.7,29,5,24,0.172,47,0.617,5,0.69,7.0,39,9,30,0.231,71,0.549,5,0.591,6.9,2016-17,Playoffs
201188,Marc Gasol,1610612763,MEM,6,2,4,240.0,7,5,2,0.714,17,0.412,0,0.412,12.3,32,10,22,0.313,60,0.533,5,0.582,4.9,39,15,24,0.385,77,0.506,5,0.542,6.3,2016-17,Playoffs
101162,Marcin Gortat,1610612764,WAS,13,7,6,409.0,52,31,19,0.596,124,0.419,4,0.433,5.7,91,24,67,0.264,154,0.591,11,0.636,4.5,143,55,86,0.385,278,0.514,15,0.544,5.0,2016-17,Playoffs
203935,Marcus Smart,1610612738,BOS,17,9,8,498.0,22,12,10,0.545,70,0.314,0,0.314,10.1,62,22,38,0.355,112,0.554,15,0.639,6.8,84,34,48,0.405,182,0.462,15,0.503,7.7,2016-17,Playoffs
202693,Markieff Morris,1610612764,WAS,13,7,6,373.0,18,8,9,0.444,50,0.36,1,0.367,9.5,65,25,40,0.385,109,0.596,12,0.67,5.8,83,33,49,0.398,159,0.522,13,0.568,6.6,2016-17,Playoffs
201578,Marreese Speights,1610612746,LAC,7,3,4,98.0,4,4,0,1.0,13,0.308,0,0.308,3.6,16,4,12,0.25,37,0.432,4,0.485,4.7,20,8,12,0.4,50,0.4,4,0.435,4.5,2016-17,Playoffs
2440,Matt Barnes,1610612744,GSW,5,4,1,45.0,0,0,0,0.0,3,0.0,0,0.0,0.0,9,3,6,0.333,18,0.5,2,0.563,3.9,9,3,6,0.333,21,0.429,2,0.474,3.9,2016-17,Playoffs
203521,Matthew Dellavedova,1610612749,MIL,6,2,4,159.0,1,1,0,1.0,5,0.2,0,0.2,4.4,11,3,9,0.273,25,0.44,0,0.44,11.8,12,4,9,0.333,30,0.4,0,0.4,11.3,2016-17,Playoffs
203090,Maurice Harkless,1610612757,POR,4,0,4,99.0,7,7,0,1.0,29,0.241,1,0.25,4.7,6,2,4,0.333,22,0.273,1,0.286,6.3,13,9,4,0.692,51,0.255,2,0.265,5.4,2016-17,Playoffs
203086,Meyers Leonard,1610612757,POR,3,0,3,30.0,2,0,2,0.0,4,0.5,0,0.5,8.2,6,1,5,0.167,13,0.462,1,0.5,6.3,8,1,7,0.125,17,0.471,1,0.5,6.8,2016-17,Playoffs
201563,Michael Beasley,1610612749,MIL,3,2,1,41.0,2,2,0,1.0,5,0.4,0,0.4,2.4,7,0,7,0.0,12,0.583,1,0.636,4.1,9,2,7,0.222,17,0.529,1,0.563,3.7,2016-17,Playoffs
203487,Michael Carter-Williams,1610612741,CHI,1,0,1,23.0,1,1,0,1.0,3,0.333,1,0.5,3.4,3,0,3,0.0,6,0.5,0,0.5,8.4,4,1,3,0.25,9,0.444,1,0.5,7.1,2016-17,Playoffs
201144,Mike Conley,1610612763,MEM,6,2,4,224.0,1,1,0,1.0,10,0.1,0,0.1,16.0,19,3,16,0.158,38,0.5,1,0.514,9.1,20,4,16,0.2,48,0.417,1,0.426,9.5,2016-17,Playoffs
2399,Mike Dunleavy,1610612737,ATL,4,2,2,46.0,1,1,0,1.0,2,0.5,0,0.5,1.3,4,2,2,0.5,10,0.4,1,0.444,17.0,5,3,2,0.6,12,0.417,1,0.455,13.9,2016-17,Playoffs
203488,Mike Muscala,1610612737,ATL,5,1,4,73.0,6,3,3,0.5,14,0.429,0,0.429,4.7,10,3,7,0.3,25,0.4,2,0.435,4.6,16,6,10,0.375,39,0.41,2,0.432,4.6,2016-17,Playoffs
203141,Mirza Teletovic,1610612749,MIL,2,0,2,21.0,0,0,0,0.0,1,0.0,0,0.0,0.0,3,1,2,0.333,5,0.6,0,0.6,4.2,3,1,2,0.333,6,0.5,0,0.5,4.2,2016-17,Playoffs
101145,Monta Ellis,1610612754,IND,4,0,4,76.0,1,0,1,0.0,5,0.2,0,0.2,15.3,7,0,7,0.0,9,0.778,0,0.778,22.1,8,0,8,0.0,14,0.571,0,0.571,21.3,2016-17,Playoffs
1626149,Montrezl Harrell,1610612745,HOU,4,2,2,19.0,1,0,1,0.0,3,0.333,0,0.333,29.3,5,1,4,0.2,10,0.5,0,0.5,5.0,6,1,5,0.167,13,0.462,0,0.462,9.1,2016-17,Playoffs
1626167,Myles Turner,1610612754,IND,4,0,4,133.0,6,4,2,0.667,16,0.375,1,0.4,6.3,21,6,14,0.286,49,0.429,6,0.488,4.6,27,10,16,0.37,65,0.415,7,0.466,5.0,2016-17,Playoffs
2403,Nene,1610612745,HOU,8,5,3,160.0,11,4,7,0.364,28,0.393,0,0.393,8.7,31,16,15,0.516,57,0.544,7,0.62,3.8,42,20,22,0.476,85,0.494,7,0.538,5.1,2016-17,Playoffs
202703,Nikola Mirotic,1610612741,CHI,6,2,4,162.0,4,3,1,0.75,11,0.364,0,0.364,7.2,26,7,19,0.269,54,0.481,4,0.52,4.6,30,10,20,0.333,65,0.462,4,0.492,4.9,2016-17,Playoffs
203943,Noah Vonleh,1610612757,POR,4,0,4,100.0,9,5,4,0.556,30,0.3,1,0.31,4.0,20,7,13,0.35,36,0.556,2,0.588,5.5,29,12,17,0.414,66,0.439,3,0.46,5.0,2016-17,Playoffs
1626181,Norman Powell,1610612761,TOR,8,3,5,221.0,5,3,2,0.6,25,0.2,0,0.2,9.3,23,1,23,0.043,39,0.59,2,0.622,8.0,28,4,25,0.143,64,0.438,2,0.452,8.2,2016-17,Playoffs
202708,Norris Cole,1610612760,OKC,1,0,1,9.0,0,0,0,0.0,1,0.0,0,0.0,0.0,1,0,1,0.0,5,0.2,1,0.25,6.5,1,0,1,0.0,6,0.167,1,0.2,6.5,2016-17,Playoffs
203490,Otto Porter Jr.,1610612764,WAS,13,7,6,428.0,15,8,7,0.533,62,0.242,4,0.259,7.1,75,13,62,0.173,126,0.595,15,0.676,5.1,90,21,69,0.233,188,0.479,19,0.533,5.4,2016-17,Playoffs
200782,P.J. Tucker,1610612761,TOR,10,4,6,251.0,15,12,2,0.8,38,0.395,0,0.395,4.1,42,7,35,0.167,51,0.824,4,0.894,5.4,57,19,37,0.333,89,0.64,4,0.671,5.0,2016-17,Playoffs
1627783,Pascal Siakam,1610612761,TOR,2,0,2,10.0,2,2,0,1.0,3,0.667,0,0.667,4.5,1,0,1,0.0,1,1.0,0,1.0,5.0,3,2,1,0.667,4,0.75,0,0.75,4.7,2016-17,Playoffs
1626192,Pat Connaughton,1610612757,POR,2,0,2,20.0,1,1,0,1.0,1,1.0,0,1.0,1.6,6,1,6,0.167,9,0.667,1,0.75,5.7,7,2,6,0.286,10,0.7,1,0.778,5.2,2016-17,Playoffs
201976,Patrick Beverley,1610612745,HOU,10,5,5,297.0,21,10,10,0.476,50,0.42,0,0.42,10.0,40,7,33,0.175,74,0.541,10,0.625,8.5,61,17,43,0.279,124,0.492,10,0.535,9.0,2016-17,Playoffs
1627775,Patrick McCaw,1610612744,GSW,11,10,1,171.0,10,2,8,0.2,17,0.588,0,0.588,6.9,23,5,18,0.217,47,0.489,8,0.59,8.5,33,7,26,0.212,64,0.516,8,0.589,8.1,2016-17,Playoffs
202335,Patrick Patterson,1610612761,TOR,9,3,6,170.0,1,1,0,1.0,7,0.143,0,0.143,2.2,19,2,17,0.105,30,0.633,2,0.679,6.0,20,3,17,0.15,37,0.541,2,0.571,5.8,2016-17,Playoffs
201988,Patty Mills,1610612759,SAS,16,8,8,416.0,5,3,2,0.6,29,0.172,1,0.179,16.3,29,2,27,0.069,51,0.569,4,0.617,11.0,34,5,29,0.147,80,0.425,5,0.453,11.8,2016-17,Playoffs
2200,Pau Gasol,1610612759,SAS,16,8,8,365.0,39,29,7,0.744,77,0.506,2,0.52,4.9,75,22,53,0.293,141,0.532,10,0.573,4.2,114,51,60,0.447,218,0.523,12,0.553,4.4,2016-17,Playoffs
202331,Paul George,1610612754,IND,4,0,4,172.0,5,3,2,0.6,23,0.217,2,0.238,12.9,30,2,29,0.067,45,0.667,3,0.714,6.5,35,5,31,0.143,68,0.515,5,0.556,7.4,2016-17,Playoffs
200794,Paul Millsap,1610612737,ATL,6,2,4,219.0,9,6,3,0.667,33,0.273,1,0.281,9.6,47,17,30,0.362,72,0.653,2,0.671,4.0,56,23,33,0.411,105,0.533,3,0.549,4.9,2016-17,Playoffs
1718,Paul Pierce,1610612746,LAC,6,2,4,92.0,2,1,1,0.5,4,0.5,0,0.5,15.3,12,3,9,0.25,20,0.6,1,0.632,5.6,14,4,10,0.286,24,0.583,1,0.609,7.0,2016-17,Playoffs
1627835,Paul Zipser,1610612741,CHI,6,2,4,136.0,3,1,2,0.333,5,0.6,0,0.6,10.3,18,5,13,0.278,32,0.563,3,0.621,5.9,21,6,15,0.286,37,0.568,3,0.618,6.5,2016-17,Playoffs
200765,Rajon Rondo,1610612741,CHI,2,2,0,67.0,7,4,4,0.571,11,0.636,0,0.636,9.5,10,3,7,0.3,12,0.833,0,0.833,7.1,17,7,11,0.412,23,0.739,0,0.739,8.2,2016-17,Playoffs
203526,Raul Neto,1610612762,UTA,3,2,1,28.0,0,0,0,0.0,0,0.0,0,0.0,0.0,7,3,4,0.429,12,0.583,1,0.636,8.3,7,3,4,0.429,12,0.583,1,0.636,8.3,2016-17,Playoffs
101109,Raymond Felton,1610612746,LAC,6,2,4,113.0,2,1,1,0.5,6,0.333,0,0.333,12.5,8,2,6,0.25,15,0.533,2,0.615,9.8,10,3,7,0.3,21,0.476,2,0.526,10.3,2016-17,Playoffs
2210,Richard Jefferson,1610612739,CLE,11,6,5,163.0,10,7,3,0.7,25,0.4,0,0.4,7.3,15,6,9,0.4,34,0.441,4,0.5,9.2,25,13,12,0.52,59,0.424,4,0.455,8.5,2016-17,Playoffs
201577,Robin Lopez,1610612741,CHI,6,2,4,162.0,28,21,4,0.75,53,0.528,0,0.528,3.8,15,4,11,0.267,32,0.469,2,0.5,7.3,43,25,15,0.581,85,0.506,2,0.518,5.1,2016-17,Playoffs
203918,Rodney Hood,1610612762,UTA,10,4,6,257.0,1,1,0,1.0,11,0.091,0,0.091,4.0,29,6,23,0.207,50,0.58,4,0.63,6.4,30,7,23,0.233,61,0.492,4,0.526,6.3,2016-17,Playoffs
203497,Rudy Gobert,1610612762,UTA,8,3,5,246.0,22,13,9,0.591,68,0.324,2,0.333,5.5,67,11,56,0.164,106,0.632,9,0.691,4.1,89,24,65,0.27,174,0.511,11,0.546,4.5,2016-17,Playoffs
201566,Russell Westbrook,1610612760,OKC,5,1,4,194.0,9,3,6,0.333,32,0.281,1,0.29,8.9,49,16,33,0.327,67,0.731,1,0.742,6.4,58,19,39,0.328,99,0.586,2,0.598,6.8,2016-17,Playoffs
201583,Ryan Anderson,1610612745,HOU,11,6,5,336.0,15,9,6,0.6,49,0.306,2,0.319,6.2,42,15,27,0.357,99,0.424,11,0.477,6.3,57,24,33,0.421,148,0.385,13,0.422,6.3,2016-17,Playoffs
1626155,Sam Dekker,1610612745,HOU,3,2,1,27.0,5,1,4,0.2,11,0.455,0,0.455,11.3,5,2,3,0.4,10,0.5,1,0.556,6.7,10,3,7,0.3,21,0.476,1,0.5,9.0,2016-17,Playoffs
203902,Semaj Christon,1610612760,OKC,2,0,2,21.0,0,0,0,0.0,0,0.0,0,0.0,0.0,3,0,3,0.0,3,1.0,0,1.0,11.9,3,0,3,0.0,3,1.0,0,1.0,11.9,2016-17,Playoffs
201586,Serge Ibaka,1610612761,TOR,10,4,6,306.0,9,7,1,0.778,26,0.346,0,0.346,3.0,56,21,35,0.375,96,0.583,5,0.615,3.7,65,28,36,0.431,122,0.533,5,0.556,3.6,2016-17,Playoffs
203894,Shabazz Napier,1610612757,POR,2,0,2,32.0,1,0,2,0.0,4,0.25,0,0.25,4.8,3,0,2,0.0,6,0.5,0,0.5,6.7,4,0,4,0.0,10,0.4,0,0.4,5.7,2016-17,Playoffs
2733,Shaun Livingston,1610612744,GSW,11,10,1,185.0,10,4,6,0.4,15,0.667,1,0.714,9.7,19,2,17,0.105,41,0.463,6,0.543,8.4,29,6,23,0.207,56,0.518,7,0.592,8.8,2016-17,Playoffs
1627815,Sheldon Mac,1610612764,WAS,2,1,1,7.0,0,0,0,0.0,0,0.0,0,0.0,0.0,2,0,2,0.0,2,1.0,0,1.0,3.3,2,0,2,0.0,2,1.0,0,1.0,3.3,2016-17,Playoffs
202714,Shelvin Mack,1610612762,UTA,7,1,6,146.0,3,1,2,0.333,18,0.167,1,0.176,14.6,22,0,22,0.0,31,0.71,0,0.71,9.3,25,1,24,0.04,49,0.51,1,0.521,9.9,2016-17,Playoffs
201150,Spencer Hawes,1610612749,MIL,3,2,1,17.0,2,1,1,0.5,3,0.667,0,0.667,2.7,2,0,2,0.0,4,0.5,0,0.5,4.2,4,1,3,0.25,7,0.571,0,0.571,3.4,2016-17,Playoffs
201939,Stephen Curry,1610612744,GSW,17,16,1,601.0,22,13,8,0.591,68,0.324,1,0.328,9.8,84,11,75,0.131,157,0.535,8,0.564,10.4,106,24,83,0.226,225,0.471,9,0.491,10.3,2016-17,Playoffs
203500,Steven Adams,1610612760,OKC,5,1,4,157.0,17,6,10,0.353,32,0.531,0,0.531,10.7,17,4,13,0.235,48,0.354,1,0.362,5.7,34,10,23,0.294,80,0.425,1,0.43,8.1,2016-17,Playoffs
201959,Taj Gibson,1610612760,OKC,5,1,4,118.0,3,1,2,0.333,11,0.273,0,0.273,10.2,15,3,12,0.2,26,0.577,2,0.625,6.9,18,4,14,0.222,37,0.486,2,0.514,7.4,2016-17,Playoffs
1627752,Taurean Prince,1610612737,ATL,6,2,4,187.0,7,2,5,0.286,23,0.304,0,0.304,14.3,25,5,20,0.2,42,0.595,2,0.625,9.0,32,7,25,0.219,65,0.492,2,0.508,10.1,2016-17,Playoffs
1626179,Terry Rozier,1610612738,BOS,15,9,6,261.0,12,8,5,0.667,30,0.4,0,0.4,8.4,32,10,22,0.313,64,0.5,4,0.533,7.1,44,18,27,0.409,94,0.468,4,0.489,7.3,2016-17,Playoffs
201152,Thaddeus Young,1610612754,IND,4,0,4,140.0,22,15,7,0.682,38,0.579,0,0.579,7.1,14,1,12,0.071,27,0.519,2,0.56,5.6,36,16,19,0.444,65,0.554,2,0.571,6.6,2016-17,Playoffs
1627748,Thon Maker,1610612749,MIL,6,2,4,116.0,8,6,2,0.75,19,0.421,0,0.421,9.6,11,4,7,0.364,38,0.289,6,0.344,6.9,19,10,9,0.526,57,0.333,6,0.373,8.1,2016-17,Playoffs
203501,Tim Hardaway Jr.,1610612737,ATL,6,2,4,200.0,3,0,3,0.0,19,0.158,1,0.167,27.5,13,4,9,0.308,21,0.619,2,0.684,9.2,16,4,12,0.25,40,0.4,3,0.432,12.7,2016-17,Playoffs
203107,Tomas Satoransky,1610612764,WAS,3,2,1,27.0,1,1,0,1.0,2,0.5,0,0.5,5.0,4,0,4,0.0,7,0.571,1,0.667,8.6,5,1,4,0.2,9,0.556,1,0.625,7.9,2016-17,Playoffs
2225,Tony Parker,1610612759,SAS,8,5,3,211.0,2,0,2,0.0,18,0.111,2,0.125,17.4,18,0,18,0.0,35,0.514,2,0.545,12.0,20,0,20,0.0,53,0.377,4,0.408,12.5,2016-17,Playoffs
203503,Tony Snell,1610612749,MIL,5,2,3,149.0,2,0,2,0.0,3,0.667,0,0.667,10.9,12,1,11,0.083,22,0.545,2,0.6,10.3,14,1,13,0.071,25,0.56,2,0.609,10.4,2016-17,Playoffs
2772,Trevor Ariza,1610612745,HOU,11,6,5,413.0,8,3,5,0.375,32,0.25,0,0.25,17.2,48,14,34,0.292,91,0.527,8,0.578,7.0,56,17,39,0.304,123,0.455,8,0.487,8.4,2016-17,Playoffs
1626168,Trey Lyles,1610612762,UTA,2,0,2,9.0,0,0,0,0.0,2,0.0,0,0.0,0.0,2,0,2,0.0,4,0.5,2,1.0,6.0,2,0,2,0.0,6,0.333,2,0.5,6.0,2016-17,Playoffs
202684,Tristan Thompson,1610612739,CLE,18,13,5,562.0,69,45,24,0.652,156,0.442,5,0.457,5.4,81,31,50,0.383,160,0.506,12,0.547,6.4,150,76,74,0.507,316,0.475,17,0.502,5.9,2016-17,Playoffs
203584,Troy Daniels,1610612763,MEM,3,1,2,46.0,1,0,1,0.0,2,0.5,0,0.5,19.9,4,2,2,0.5,10,0.4,1,0.444,6.3,5,2,3,0.4,12,0.417,1,0.455,9.0,2016-17,Playoffs
1627786,Troy Williams,1610612745,HOU,4,2,2,16.0,2,0,2,0.0,5,0.4,0,0.4,10.8,5,0,5,0.0,6,0.833,0,0.833,7.5,7,0,7,0.0,11,0.636,0,0.636,8.4,2016-17,Playoffs
203092,Tyler Zeller,1610612738,BOS,8,3,5,65.0,8,7,0,0.875,15,0.533,0,0.533,2.7,11,3,8,0.273,18,0.611,1,0.647,4.5,19,10,8,0.526,33,0.576,1,0.594,3.8,2016-17,Playoffs
203506,Victor Oladipo,1610612760,OKC,5,1,4,181.0,2,2,0,1.0,11,0.182,1,0.2,11.2,26,6,20,0.231,44,0.591,3,0.634,6.5,28,8,20,0.286,55,0.509,4,0.549,6.9,2016-17,Playoffs
1713,Vince Carter,1610612763,MEM,5,2,3,161.0,4,2,2,0.5,13,0.308,0,0.308,4.5,16,3,13,0.188,31,0.516,3,0.571,8.6,20,5,15,0.25,44,0.455,3,0.488,7.8,2016-17,Playoffs
1627735,Wade Baldwin IV,1610612763,MEM,3,1,2,12.0,1,0,1,0.0,4,0.25,0,0.25,2.5,3,0,3,0.0,1,3.0,0,3.0,5.6,4,0,4,0.0,5,0.8,0,0.8,4.8,2016-17,Playoffs
1627782,Wayne Selden,1610612763,MEM,4,2,2,88.0,3,1,2,0.333,8,0.375,0,0.375,9.3,6,2,4,0.333,11,0.545,0,0.545,11.5,9,3,6,0.333,19,0.474,0,0.474,10.7,2016-17,Playoffs
202325,Wesley Johnson,1610612746,LAC,2,1,1,7.0,0,0,0,0.0,0,0.0,0,0.0,0.0,2,0,2,0.0,2,1.0,0,1.0,9.6,2,0,2,0.0,2,1.0,0,1.0,9.6,2016-17,Playoffs
2216,Zach Randolph,1610612763,MEM,6,2,4,191.0,9,7,2,0.778,47,0.191,1,0.196,2.8,40,11,29,0.275,59,0.678,3,0.714,4.8,49,18,31,0.367,106,0.462,4,0.48,4.4,2016-17,Playoffs
2585,Zaza Pachulia,1610612744,GSW,15,14,1,212.0,18,10,6,0.556,60,0.3,0,0.3,5.8,39,13,27,0.333,83,0.47,10,0.534,4.0,57,23,33,0.404,143,0.399,10,0.429,4.5,2016-17,Playoffs
201166,Aaron Brooks,1610612750,MIN,13,6,7,136.0,7,1,6,0.143,16,0.438,0,0.438,18.7,10,2,9,0.2,20,0.5,4,0.625,7.2,17,3,15,0.176,36,0.472,4,0.531,11.5,2017-18,Regular%20Season
203932,Aaron Gordon,1610612753,ORL,58,19,39,1909.0,87,54,30,0.621,260,0.335,5,0.341,7.9,370,86,285,0.232,576,0.642,34,0.683,5.6,457,140,315,0.306,787,0.581,39,0.611,6.0,2017-18,Regular%20Season
1626151,Aaron Harrison,1610612742,DAL,7,2,5,190.0,4,1,3,0.25,6,0.667,0,0.667,13.3,20,2,18,0.1,36,0.556,2,0.588,10.5,24,3,21,0.125,42,0.571,2,0.6,11.0,2017-18,Regular%20Season
1628935,Aaron Jackson,1610612745,HOU,1,0,1,35.0,2,1,1,0.5,5,0.4,0,0.4,4.8,1,0,1,0.0,2,0.5,0,0.5,13.8,3,1,2,0.333,7,0.429,0,0.429,7.8,2017-18,Regular%20Season
1627846,Abdel Nader,1610612738,BOS,26,18,8,347.0,13,7,6,0.538,42,0.31,1,0.317,6.4,58,14,44,0.241,85,0.682,6,0.734,7.2,71,21,50,0.296,123,0.577,7,0.612,7.0,2017-18,Regular%20Season
203940,Adreian Payne,1610612753,ORL,3,0,3,40.0,2,1,1,0.5,5,0.4,0,0.4,6.0,7,2,5,0.286,11,0.636,0,0.636,4.2,9,3,6,0.333,16,0.563,0,0.563,4.6,2017-18,Regular%20Season
201143,Al Horford,1610612738,BOS,69,44,25,2175.0,100,58,42,0.58,258,0.388,2,0.391,8.3,408,107,294,0.262,653,0.625,39,0.664,5.9,508,165,336,0.325,879,0.578,41,0.606,6.4,2017-18,Regular%20Season
2744,Al Jefferson,1610612754,IND,33,15,18,469.0,30,23,7,0.767,96,0.313,0,0.313,4.9,113,32,81,0.283,186,0.608,12,0.649,4.4,143,55,88,0.385,269,0.532,12,0.556,4.5,2017-18,Regular%20Season
202329,Al-Farouq Aminu,1610612757,POR,69,40,29,2072.0,97,38,56,0.392,261,0.372,4,0.377,8.9,428,96,323,0.224,672,0.637,41,0.678,5.2,525,134,379,0.255,887,0.592,45,0.624,5.9,2017-18,Regular%20Season
1626210,Alan Williams,1610612756,PHX,5,1,4,70.0,3,1,1,0.333,20,0.15,0,0.15,9.8,19,4,15,0.211,31,0.613,0,0.613,3.4,22,5,16,0.227,48,0.458,0,0.458,4.0,2017-18,Regular%20Season
202692,Alec Burks,1610612762,UTA,58,32,26,1011.0,19,13,6,0.684,94,0.202,5,0.213,11.1,173,31,143,0.179,277,0.625,20,0.673,6.0,192,44,149,0.229,360,0.533,25,0.573,6.5,2017-18,Regular%20Season
1628409,Alec Peters,1610612756,PHX,15,1,14,179.0,8,7,1,0.875,21,0.381,2,0.421,5.0,29,6,24,0.207,42,0.69,1,0.707,5.7,37,13,25,0.351,59,0.627,3,0.661,5.6,2017-18,Regular%20Season
203518,Alex Abrines,1610612760,OKC,53,32,21,938.0,25,11,13,0.44,66,0.379,2,0.391,12.3,86,19,65,0.221,176,0.489,14,0.531,8.5,111,30,78,0.27,239,0.464,16,0.498,9.4,2017-18,Regular%20Season
1627936,Alex Caruso,1610612747,LAL,27,13,14,461.0,15,8,7,0.533,41,0.366,4,0.405,11.2,50,6,44,0.12,88,0.568,7,0.617,10.1,65,14,51,0.215,124,0.524,11,0.575,10.4,2017-18,Regular%20Season
203458,Alex Len,1610612756,PHX,68,20,48,1393.0,175,111,59,0.634,420,0.417,7,0.424,5.0,343,113,231,0.329,588,0.583,31,0.616,4.1,518,224,290,0.432,965,0.537,38,0.559,4.4,2017-18,Regular%20Season
1627816,Alex Poythress,1610612754,IND,12,4,8,70.0,7,6,1,0.857,22,0.318,1,0.333,5.0,10,2,8,0.2,16,0.625,0,0.625,8.6,17,8,9,0.471,37,0.459,1,0.472,7.2,2017-18,Regular%20Season
1628035,Alfonzo McKinnie,1610612761,TOR,5,4,1,29.0,1,1,0,1.0,2,0.5,0,0.5,1.2,6,2,4,0.333,11,0.545,2,0.667,3.6,7,3,4,0.429,12,0.583,2,0.7,3.2,2017-18,Regular%20Season
203459,Allen Crabbe,1610612751,BKN,72,24,48,2104.0,27,10,17,0.37,139,0.194,6,0.203,13.4,288,48,239,0.167,457,0.63,22,0.662,6.8,315,58,256,0.184,579,0.544,28,0.572,7.3,2017-18,Regular%20Season
101161,Amir Johnson,1610612755,PHI,71,44,27,1133.0,123,89,31,0.724,290,0.424,7,0.435,5.7,207,75,132,0.362,410,0.505,49,0.573,5.4,330,164,163,0.497,683,0.483,56,0.526,5.5,2017-18,Regular%20Season
203083,Andre Drummond,1610612765,DET,78,37,41,2625.0,399,268,125,0.672,831,0.48,18,0.491,5.1,848,283,561,0.334,1239,0.684,61,0.72,3.5,1247,551,686,0.442,2001,0.623,79,0.649,4.0,2017-18,Regular%20Season
2738,Andre Iguodala,1610612744,GSW,61,44,17,1556.0,50,16,34,0.32,134,0.373,6,0.391,10.6,196,38,157,0.194,369,0.531,25,0.57,7.6,246,54,191,0.22,487,0.505,31,0.539,8.2,2017-18,Regular%20Season
201281,Andre Ingram,1610612747,LAL,2,1,1,64.0,1,0,1,0.0,1,1.0,0,1.0,8.2,5,0,5,0.0,7,0.714,1,0.833,10.6,6,0,6,0.0,8,0.75,1,0.857,10.2,2017-18,Regular%20Season
203460,Andre Roberson,1610612760,OKC,37,24,13,983.0,68,43,22,0.632,167,0.407,5,0.42,7.1,104,27,76,0.26,199,0.523,17,0.571,6.2,172,70,98,0.407,362,0.475,22,0.506,6.5,2017-18,Regular%20Season
101106,Andrew Bogut,1610612747,LAL,21,6,15,207.0,26,19,7,0.731,52,0.5,2,0.52,6.2,52,16,36,0.308,81,0.642,6,0.693,4.7,78,35,43,0.449,126,0.619,8,0.661,5.2,2017-18,Regular%20Season
1626150,Andrew Harrison,1610612763,MEM,50,14,36,1231.0,23,3,20,0.13,121,0.19,4,0.197,11.7,108,18,92,0.167,213,0.507,19,0.557,9.6,131,21,112,0.16,327,0.401,23,0.431,10.0,2017-18,Regular%20Season
1628510,Andrew White III,1610612737,ATL,10,1,9,162.0,4,2,2,0.5,18,0.222,0,0.222,4.9,28,0,28,0.0,51,0.549,4,0.596,7.9,32,2,30,0.063,68,0.471,4,0.5,7.5,2017-18,Regular%20Season
203952,Andrew Wiggins,1610612750,MIN,82,47,35,2979.0,82,45,35,0.549,300,0.273,7,0.28,8.8,276,61,216,0.221,522,0.529,44,0.577,6.5,358,106,251,0.296,818,0.438,51,0.467,7.0,2017-18,Regular%20Season
1627790,Ante Zizic,1610612739,CLE,19,11,8,181.0,24,19,6,0.792,56,0.429,1,0.436,4.2,36,9,26,0.25,67,0.537,5,0.581,5.0,60,28,32,0.467,117,0.513,6,0.541,4.7,2017-18,Regular%20Season
203076,Anthony Davis,1610612740,NOP,75,45,30,2727.0,187,122,61,0.652,432,0.433,9,0.442,6.5,644,208,434,0.323,997,0.646,51,0.681,4.8,831,330,495,0.397,1401,0.593,60,0.62,5.2,2017-18,Regular%20Season
201229,Anthony Tolliver,1610612765,DET,75,36,39,1688.0,50,16,32,0.32,131,0.382,2,0.388,9.8,191,41,150,0.215,421,0.454,33,0.492,7.5,241,57,182,0.237,533,0.452,35,0.484,8.0,2017-18,Regular%20Season
1628469,Antonio Blakeney,1610612741,CHI,14,3,11,278.0,4,2,2,0.5,13,0.308,0,0.308,12.9,28,2,26,0.071,56,0.5,4,0.538,6.3,32,4,28,0.125,69,0.464,4,0.492,7.1,2017-18,Regular%20Season
1628499,Antonius Cleveland,1610612737,ATL,7,2,5,80.0,3,2,1,0.667,12,0.25,1,0.273,6.3,11,3,8,0.273,19,0.579,1,0.611,7.3,14,5,9,0.357,31,0.452,2,0.483,7.1,2017-18,Regular%20Season
203382,Aron Baynes,1610612738,BOS,77,50,27,1431.0,128,87,39,0.68,330,0.388,6,0.395,5.0,292,99,190,0.339,546,0.535,57,0.597,4.5,420,186,229,0.443,851,0.494,63,0.533,4.6,2017-18,Regular%20Season
201167,Arron Afflalo,1610612753,ORL,28,8,20,429.0,4,0,4,0.0,34,0.118,0,0.118,17.9,61,13,47,0.213,100,0.61,7,0.656,8.7,65,13,51,0.2,129,0.504,7,0.533,9.3,2017-18,Regular%20Season
203085,Austin Rivers,1610612746,LAC,53,24,29,1787.0,26,8,20,0.308,122,0.213,7,0.226,13.4,116,18,97,0.155,261,0.444,30,0.502,8.6,142,26,117,0.183,377,0.377,37,0.418,9.6,2017-18,Regular%20Season
202340,Avery Bradley,1610612746,LAC,41,19,22,1284.0,22,10,12,0.455,107,0.206,7,0.22,8.1,94,10,84,0.106,169,0.556,18,0.623,7.3,116,20,96,0.172,273,0.425,25,0.468,7.5,2017-18,Regular%20Season
1628389,Bam Adebayo,1610612748,MIA,64,31,33,1322.0,116,75,41,0.647,282,0.411,5,0.419,6.4,260,75,185,0.288,416,0.625,25,0.665,5.5,376,150,226,0.399,663,0.567,30,0.594,5.8,2017-18,Regular%20Season
203463,Ben McLemore,1610612763,MEM,46,5,41,988.0,34,14,19,0.412,108,0.315,0,0.315,9.4,105,8,96,0.076,197,0.533,24,0.607,7.6,139,22,115,0.158,296,0.47,24,0.511,8.0,2017-18,Regular%20Season
1628500,Ben Moore,1610612754,IND,1,0,1,6.0,0,0,0,0.0,0,0.0,0,0.0,0.0,1,0,1,0.0,2,0.5,0,0.5,9.7,1,0,1,0.0,2,0.5,0,0.5,9.7,2017-18,Regular%20Season
1627732,Ben Simmons,1610612755,PHI,80,51,29,2703.0,145,64,79,0.441,413,0.351,9,0.359,10.1,512,84,425,0.164,777,0.659,35,0.69,6.6,657,148,504,0.225,1110,0.592,44,0.616,7.4,2017-18,Regular%20Season
202687,Bismack Biyombo,1610612753,ORL,79,24,55,1448.0,144,96,45,0.667,381,0.378,8,0.386,5.2,324,101,221,0.312,582,0.557,35,0.592,4.3,468,197,266,0.421,935,0.501,43,0.525,4.6,2017-18,Regular%20Season
201933,Blake Griffin,1610612765,DET,58,28,30,1970.0,73,44,30,0.603,269,0.271,12,0.284,8.5,355,76,275,0.214,598,0.594,39,0.635,4.7,428,120,305,0.28,831,0.515,51,0.549,5.4,2017-18,Regular%20Season
1626246,Boban Marjanovic,1610612746,LAC,30,11,19,306.0,48,38,10,0.792,109,0.44,4,0.457,3.2,93,31,62,0.333,148,0.628,12,0.684,3.9,141,69,72,0.489,249,0.566,16,0.605,3.7,2017-18,Regular%20Season
201628,Bobby Brown,1610612745,HOU,3,3,0,36.0,0,0,1,0.0,1,0.0,0,0.0,0.0,7,0,7,0.0,11,0.636,0,0.636,16.3,7,0,8,0.0,11,0.636,0,0.636,16.2,2017-18,Regular%20Season
1626171,Bobby Portis,1610612741,CHI,72,25,47,1615.0,158,100,51,0.633,365,0.433,4,0.438,5.7,331,62,269,0.187,530,0.625,33,0.666,4.9,489,162,320,0.331,865,0.565,37,0.591,5.2,2017-18,Regular%20Season
203992,Bogdan Bogdanovic,1610612758,SAC,76,26,50,2137.0,31,18,13,0.581,138,0.225,5,0.233,8.1,192,36,155,0.188,365,0.526,38,0.587,7.5,223,54,168,0.242,492,0.453,43,0.497,7.6,2017-18,Regular%20Season
202711,Bojan Bogdanovic,1610612754,IND,75,44,31,2326.0,30,6,24,0.2,155,0.194,5,0.2,15.3,240,33,204,0.138,395,0.608,23,0.645,7.1,270,39,228,0.144,528,0.511,28,0.54,8.0,2017-18,Regular%20Season
203078,Bradley Beal,1610612764,WAS,81,42,39,2940.0,61,27,34,0.443,254,0.24,10,0.25,12.3,302,50,249,0.166,521,0.58,27,0.611,8.1,363,77,283,0.212,757,0.48,37,0.504,8.8,2017-18,Regular%20Season
201148,Brandan Wright,1610612745,HOU,27,11,16,373.0,33,21,12,0.636,65,0.508,2,0.524,5.5,62,25,37,0.403,120,0.517,7,0.549,5.6,95,46,49,0.484,179,0.531,9,0.559,5.6,2017-18,Regular%20Season
1627742,Brandon Ingram,1610612747,LAL,59,27,32,1975.0,57,33,23,0.579,209,0.273,7,0.282,8.4,257,56,202,0.218,417,0.616,26,0.657,6.5,314,89,225,0.283,619,0.507,33,0.536,6.8,2017-18,Regular%20Season
201943,Brandon Jennings,1610612749,MIL,10,8,2,170.0,5,2,3,0.4,15,0.333,0,0.333,12.6,26,1,25,0.038,47,0.553,2,0.578,8.6,31,3,28,0.097,61,0.508,2,0.525,9.2,2017-18,Regular%20Season
203464,Brandon Paul,1610612759,SAS,36,18,18,481.0,6,2,4,0.333,33,0.182,1,0.188,8.6,62,9,53,0.145,119,0.521,11,0.574,8.0,68,11,57,0.162,147,0.463,12,0.504,8.1,2017-18,Regular%20Season
1627362,Briante Weber,1610612763,MEM,14,5,9,218.0,8,0,8,0.0,22,0.364,1,0.381,18.3,27,5,22,0.185,43,0.628,2,0.659,7.6,35,5,30,0.143,65,0.538,3,0.565,10.1,2017-18,Regular%20Season
1627744,Brice Johnson,1610612763,MEM,12,1,11,85.0,8,5,3,0.625,22,0.364,0,0.364,7.3,21,8,11,0.381,27,0.778,1,0.808,3.7,29,13,14,0.448,44,0.659,1,0.674,4.8,2017-18,Regular%20Season
201572,Brook Lopez,1610612747,LAL,71,33,38,1660.0,73,45,27,0.616,158,0.462,1,0.465,7.3,215,93,121,0.433,428,0.502,35,0.547,6.1,288,138,148,0.479,573,0.503,36,0.536,6.4,2017-18,Regular%20Season
203998,Bruno Caboclo,1610612758,SAC,10,3,7,105.0,7,6,1,0.857,20,0.35,0,0.35,6.2,15,3,12,0.2,31,0.484,4,0.556,5.4,22,9,13,0.409,47,0.468,4,0.512,5.6,2017-18,Regular%20Season
1627854,Bryn Forbes,1610612759,SAS,59,34,25,1270.0,12,1,12,0.083,49,0.245,1,0.25,16.4,98,13,85,0.133,198,0.495,17,0.541,9.6,110,14,97,0.127,243,0.453,18,0.489,10.5,2017-18,Regular%20Season
1627741,Buddy Hield,1610612758,SAC,77,26,51,1979.0,55,18,36,0.327,177,0.311,5,0.32,11.2,252,25,225,0.099,438,0.575,35,0.625,7.1,307,43,261,0.14,611,0.502,40,0.538,7.8,2017-18,Regular%20Season
203710,C.J. Williams,1610612746,LAC,28,16,12,629.0,12,4,8,0.333,39,0.308,2,0.324,9.5,44,9,35,0.205,88,0.5,9,0.557,9.7,56,13,43,0.232,126,0.444,11,0.487,9.7,2017-18,Regular%20Season
203468,CJ McCollum,1610612757,POR,80,48,32,2898.0,53,22,30,0.415,236,0.225,11,0.236,11.5,268,37,230,0.138,469,0.571,31,0.612,9.9,321,59,260,0.184,697,0.461,42,0.49,10.2,2017-18,Regular%20Season
101139,CJ Miles,1610612761,TOR,61,44,17,1195.0,18,7,12,0.389,71,0.254,6,0.277,16.0,134,22,112,0.164,225,0.596,5,0.609,9.1,152,29,124,0.191,287,0.53,11,0.551,9.9,2017-18,Regular%20Season
1628403,Caleb Swanigan,1610612757,POR,17,9,8,158.0,15,12,3,0.8,55,0.273,0,0.273,3.4,39,9,30,0.231,64,0.609,6,0.672,4.4,54,21,33,0.389,114,0.474,6,0.5,4.1,2017-18,Regular%20Season
1626166,Cameron Payne,1610612741,CHI,22,7,15,511.0,18,8,10,0.444,67,0.269,2,0.277,13.6,46,3,43,0.065,83,0.554,6,0.597,9.6,64,11,53,0.172,143,0.448,8,0.474,10.7,2017-18,Regular%20Season
1627747,Caris LeVert,1610612751,BKN,67,24,43,1751.0,53,28,26,0.528,219,0.242,16,0.261,8.1,202,38,165,0.188,339,0.596,24,0.641,6.8,255,66,191,0.259,552,0.462,40,0.498,7.0,2017-18,Regular%20Season
2546,Carmelo Anthony,1610612760,OKC,75,45,30,2426.0,64,31,34,0.484,212,0.302,9,0.315,10.2,373,68,304,0.182,657,0.568,38,0.603,5.3,437,99,338,0.227,832,0.525,47,0.557,6.0,2017-18,Regular%20Season
1626224,Cedi Osman,1610612739,CLE,43,25,18,604.0,19,7,11,0.368,84,0.226,3,0.235,10.1,101,8,92,0.079,145,0.697,12,0.759,6.0,120,15,103,0.125,210,0.571,15,0.615,6.7,2017-18,Regular%20Season
202718,Chandler Parsons,1610612763,MEM,35,12,23,676.0,14,5,9,0.357,57,0.246,2,0.255,9.0,76,9,66,0.118,130,0.585,9,0.628,6.9,90,14,75,0.156,176,0.511,11,0.545,7.3,2017-18,Regular%20Season
101112,Channing Frye,1610612747,LAL,43,27,16,634.0,12,8,4,0.667,33,0.364,2,0.387,9.9,123,37,86,0.301,227,0.542,20,0.594,4.8,135,45,90,0.333,250,0.54,22,0.592,5.2,2017-18,Regular%20Season
1628429,Charles Cooke,1610612740,NOP,2,0,2,8.0,0,0,0,0.0,0,0.0,0,0.0,0.0,2,1,1,0.5,2,1.0,0,1.0,7.2,2,1,1,0.5,2,1.0,0,1.0,7.2,2017-18,Regular%20Season
1627767,Cheick Diallo,1610612740,NOP,46,27,19,571.0,47,30,15,0.638,147,0.32,2,0.324,6.5,164,41,118,0.25,268,0.612,14,0.646,4.2,211,71,133,0.336,395,0.534,16,0.557,4.7,2017-18,Regular%20Season
1627778,Chinanu Onuaku,1610612745,HOU,1,0,1,22.0,1,1,0,1.0,6,0.167,0,0.167,12.7,3,1,2,0.333,7,0.429,1,0.5,3.8,4,2,2,0.5,13,0.308,1,0.333,6.1,2017-18,Regular%20Season
1628449,Chris Boucher,1610612744,GSW,1,1,0,1.0,0,0,0,0.0,1,0.0,0,0.0,0.0,1,0,1,0.0,1,1.0,0,1.0,0.9,1,0,1,0.0,1,1.0,0,1.0,0.9,2017-18,Regular%20Season
1626191,Chris McCullough,1610612764,WAS,13,7,6,69.0,7,4,3,0.571,20,0.35,1,0.368,9.4,18,2,16,0.111,27,0.667,3,0.75,4.2,25,6,19,0.24,45,0.556,4,0.61,5.7,2017-18,Regular%20Season
101108,Chris Paul,1610612745,HOU,57,49,8,1825.0,37,8,27,0.216,121,0.306,3,0.314,13.4,276,42,235,0.152,506,0.545,44,0.597,7.1,313,50,262,0.16,619,0.506,47,0.547,7.8,2017-18,Regular%20Season
203991,Clint Capela,1610612745,HOU,74,62,12,2034.0,241,154,84,0.639,509,0.473,8,0.481,6.4,561,160,397,0.285,856,0.655,50,0.696,4.4,802,314,481,0.392,1343,0.597,58,0.624,5.0,2017-18,Regular%20Season
203469,Cody Zeller,1610612766,CHA,33,14,19,627.0,67,48,19,0.716,186,0.36,2,0.364,4.6,110,42,68,0.382,193,0.57,12,0.608,5.3,177,90,87,0.508,375,0.472,14,0.49,5.0,2017-18,Regular%20Season
202332,Cole Aldrich,1610612750,MIN,9,7,2,29.0,3,2,1,0.667,14,0.214,0,0.214,3.0,12,1,11,0.083,15,0.8,1,0.857,2.8,15,3,12,0.2,25,0.6,1,0.625,2.9,2017-18,Regular%20Season
201147,Corey Brewer,1610612760,OKC,56,26,30,1041.0,43,14,29,0.326,139,0.309,2,0.314,10.7,111,21,88,0.189,194,0.572,19,0.634,7.8,154,35,117,0.227,328,0.47,21,0.502,8.6,2017-18,Regular%20Season
202709,Cory Joseph,1610612754,IND,79,48,31,2141.0,39,7,31,0.179,124,0.315,4,0.325,14.0,224,39,188,0.174,425,0.527,35,0.574,8.4,263,46,219,0.175,541,0.486,39,0.524,9.2,2017-18,Regular%20Season
201584,Courtney Lee,1610612752,NYK,67,26,41,2098.0,29,11,18,0.379,106,0.274,2,0.279,11.6,190,23,166,0.121,319,0.596,23,0.642,9.9,219,34,184,0.155,420,0.521,25,0.554,10.1,2017-18,Regular%20Season
1626245,Cristiano Felicio,1610612741,CHI,49,12,37,906.0,82,59,22,0.72,238,0.345,4,0.35,5.5,148,48,100,0.324,257,0.576,21,0.627,4.9,230,107,122,0.465,483,0.476,25,0.502,5.1,2017-18,Regular%20Season
1626156,D'Angelo Russell,1610612751,BKN,45,14,31,1179.0,30,11,20,0.367,95,0.316,3,0.326,13.3,159,17,140,0.107,265,0.6,15,0.636,7.0,189,28,160,0.148,347,0.545,18,0.574,8.0,2017-18,Regular%20Season
201571,D.J. Augustin,1610612753,ORL,67,21,46,1626.0,30,3,25,0.1,134,0.224,3,0.229,15.1,130,11,118,0.085,255,0.51,24,0.563,10.4,160,14,143,0.088,379,0.422,27,0.455,11.3,2017-18,Regular%20Season
1628391,D.J. Wilson,1610612749,MIL,8,4,4,48.0,2,0,2,0.0,4,0.5,0,0.5,13.0,8,1,7,0.125,9,0.889,0,0.889,4.7,10,1,9,0.1,12,0.833,0,0.833,6.4,2017-18,Regular%20Season
1626177,Dakari Johnson,1610612760,OKC,19,15,4,129.0,16,11,5,0.688,38,0.421,2,0.444,6.0,15,6,9,0.4,39,0.385,4,0.429,8.5,31,17,14,0.548,76,0.408,6,0.443,7.2,2017-18,Regular%20Season
1627745,Damian Jones,1610612744,GSW,8,4,4,68.0,5,5,0,1.0,16,0.313,0,0.313,5.6,9,2,7,0.222,25,0.36,4,0.429,4.7,14,7,7,0.5,40,0.35,4,0.389,5.0,2017-18,Regular%20Season
203081,Damian Lillard,1610612757,POR,71,43,28,2606.0,62,20,41,0.323,241,0.257,11,0.27,13.5,263,32,228,0.122,465,0.566,28,0.602,8.5,325,52,269,0.16,701,0.464,39,0.491,9.5,2017-18,Regular%20Season
2863,Damien Wilkins,1610612754,IND,11,6,5,116.0,5,4,1,0.8,13,0.385,0,0.385,9.2,11,1,10,0.091,17,0.647,2,0.733,6.3,16,5,11,0.313,29,0.552,2,0.593,7.2,2017-18,Regular%20Season
1627814,Damion Lee,1610612737,ATL,15,4,11,404.0,11,3,8,0.273,46,0.239,2,0.25,9.8,60,7,53,0.117,93,0.645,4,0.674,7.1,71,10,61,0.141,139,0.511,6,0.534,7.6,2017-18,Regular%20Season
1628422,Damyean Dotson,1610612752,NYK,31,9,22,411.0,9,1,8,0.111,27,0.333,0,0.333,15.5,75,11,64,0.147,108,0.694,5,0.728,6.7,84,12,72,0.143,132,0.636,5,0.661,7.6,2017-18,Regular%20Season
1627772,Daniel Hamilton,1610612760,OKC,3,2,1,22.0,0,0,0,0.0,5,0.0,0,0.0,0.0,5,0,5,0.0,9,0.556,1,0.625,3.8,5,0,5,0.0,13,0.385,1,0.417,3.8,2017-18,Regular%20Season
1628464,Daniel Theis,1610612738,BOS,58,40,18,889.0,86,58,28,0.674,206,0.417,2,0.422,6.4,173,72,101,0.416,308,0.562,31,0.625,4.2,259,130,129,0.502,487,0.532,33,0.57,5.0,2017-18,Regular%20Season
201568,Danilo Gallinari,1610612746,LAC,21,11,10,671.0,9,4,5,0.444,52,0.173,3,0.184,9.9,92,22,70,0.239,156,0.59,14,0.648,6.7,101,26,75,0.257,206,0.49,17,0.534,7.0,2017-18,Regular%20Season
201980,Danny Green,1610612759,SAS,67,38,29,1745.0,41,17,24,0.415,129,0.318,4,0.328,11.3,208,34,175,0.163,397,0.524,33,0.571,6.0,249,51,199,0.205,517,0.482,37,0.519,6.9,2017-18,Regular%20Season
201967,Dante Cunningham,1610612751,BKN,69,34,35,1507.0,78,39,38,0.5,218,0.358,3,0.363,6.8,220,50,168,0.227,413,0.533,27,0.57,6.0,298,89,206,0.299,601,0.496,30,0.522,6.3,2017-18,Regular%20Season
203957,Dante Exum,1610612762,UTA,13,9,4,225.0,4,3,1,0.75,17,0.235,1,0.25,5.8,22,4,18,0.182,49,0.449,0,0.449,5.5,26,7,19,0.269,66,0.394,1,0.4,5.6,2017-18,Regular%20Season
1627863,Danuel House Jr.,1610612756,PHX,21,5,16,385.0,13,7,6,0.538,37,0.351,0,0.351,8.3,63,7,56,0.111,91,0.692,7,0.75,7.3,76,14,62,0.184,127,0.598,7,0.633,7.4,2017-18,Regular%20Season
203967,Dario Saric,1610612755,PHI,76,48,28,2276.0,152,88,61,0.579,387,0.393,13,0.406,7.1,364,79,285,0.217,703,0.518,61,0.567,5.0,516,167,346,0.324,1051,0.491,74,0.528,5.6,2017-18,Regular%20Season
203121,Darius Miller,1610612740,NOP,63,39,24,1609.0,17,5,12,0.294,40,0.425,3,0.459,16.5,146,35,110,0.24,292,0.5,27,0.551,8.7,163,40,122,0.245,327,0.498,30,0.549,9.5,2017-18,Regular%20Season
201589,Darrell Arthur,1610612743,DEN,10,6,4,106.0,3,2,1,0.667,10,0.3,0,0.3,7.3,12,6,6,0.5,28,0.429,3,0.48,4.4,15,8,7,0.533,36,0.417,3,0.455,5.0,2017-18,Regular%20Season
201954,Darren Collison,1610612754,IND,63,37,26,1844.0,37,5,33,0.135,109,0.339,3,0.349,16.4,141,12,126,0.085,264,0.534,16,0.569,11.1,178,17,159,0.096,369,0.482,19,0.509,12.2,2017-18,Regular%20Season
1626199,Darrun Hilliard,1610612759,SAS,5,3,2,59.0,0,0,0,0.0,5,0.0,0,0.0,0.0,7,2,5,0.286,15,0.467,1,0.5,7.5,7,2,5,0.286,20,0.35,1,0.368,7.5,2017-18,Regular%20Season
1628021,David Nwaba,1610612741,CHI,68,26,42,1606.0,88,43,43,0.489,270,0.326,11,0.34,7.8,234,40,194,0.171,425,0.551,41,0.609,7.0,322,83,237,0.258,676,0.476,52,0.516,7.2,2017-18,Regular%20Season
2561,David West,1610612744,GSW,68,48,20,941.0,64,42,21,0.656,141,0.454,3,0.464,6.8,174,67,107,0.385,319,0.545,33,0.608,5.3,238,109,128,0.458,450,0.529,36,0.575,5.7,2017-18,Regular%20Season
202722,Davis Bertans,1610612759,SAS,56,29,27,964.0,18,12,6,0.667,52,0.346,3,0.367,6.1,135,40,95,0.296,263,0.513,17,0.549,5.4,153,52,101,0.34,306,0.5,20,0.535,5.5,2017-18,Regular%20Season
1628432,Davon Reed,1610612756,PHX,16,2,14,204.0,2,0,2,0.0,17,0.118,0,0.118,17.6,37,3,33,0.081,63,0.587,6,0.649,5.9,39,3,35,0.077,78,0.5,6,0.542,6.5,2017-18,Regular%20Season
1628368,De'Aaron Fox,1610612758,SAC,67,24,43,1897.0,33,15,18,0.455,147,0.224,6,0.234,12.2,171,19,153,0.111,327,0.523,22,0.561,9.0,204,34,171,0.167,470,0.434,28,0.462,9.5,2017-18,Regular%20Season
201599,DeAndre Jordan,1610612746,LAC,76,38,38,2386.0,326,224,103,0.687,700,0.466,8,0.471,5.0,827,188,636,0.227,1173,0.705,53,0.738,4.6,1153,412,739,0.357,1811,0.637,61,0.659,4.7,2017-18,Regular%20Season
202732,DeAndre Liggins,1610612740,NOP,37,20,17,565.0,7,2,5,0.286,31,0.226,3,0.25,13.5,67,19,46,0.284,110,0.609,9,0.663,6.5,74,21,51,0.284,140,0.529,12,0.578,7.1,2017-18,Regular%20Season
1627761,DeAndre' Bembry,1610612737,ATL,21,8,13,406.0,8,3,5,0.375,34,0.235,2,0.25,14.0,64,13,51,0.203,108,0.593,7,0.634,7.3,72,16,56,0.222,141,0.511,9,0.545,8.1,2017-18,Regular%20Season
201942,DeMar DeRozan,1610612761,TOR,80,57,23,2712.0,59,19,40,0.322,234,0.252,11,0.265,10.5,256,34,221,0.133,428,0.598,28,0.64,8.9,315,53,261,0.168,646,0.488,39,0.519,9.2,2017-18,Regular%20Season
202326,DeMarcus Cousins,1610612740,NOP,48,27,21,1737.0,105,71,31,0.676,285,0.368,4,0.374,5.9,512,157,356,0.307,768,0.667,35,0.698,4.2,617,228,387,0.37,1010,0.611,39,0.635,4.5,2017-18,Regular%20Season
201960,DeMarre Carroll,1610612751,BKN,69,23,46,2070.0,103,54,50,0.524,332,0.31,13,0.323,9.0,360,76,284,0.211,624,0.577,44,0.621,6.1,463,130,334,0.281,925,0.501,57,0.533,6.8,2017-18,Regular%20Season
1627749,Dejounte Murray,1610612759,SAS,78,44,34,1737.0,110,52,56,0.473,302,0.364,11,0.378,8.3,349,59,290,0.169,595,0.587,42,0.631,5.7,459,111,346,0.242,884,0.519,53,0.552,6.4,2017-18,Regular%20Season
1626153,Delon Wright,1610612761,TOR,67,47,20,1397.0,45,18,27,0.4,165,0.273,7,0.285,7.9,153,16,135,0.105,284,0.539,20,0.58,8.2,198,34,162,0.172,443,0.447,27,0.476,8.1,2017-18,Regular%20Season
1627743,Demetrius Jackson,1610612755,PHI,6,5,1,45.0,5,2,3,0.4,7,0.714,0,0.714,12.7,7,1,6,0.143,11,0.636,2,0.778,8.2,12,3,9,0.25,18,0.667,2,0.75,10.1,2017-18,Regular%20Season
203471,Dennis Schroder,1610612737,ATL,65,20,45,2016.0,43,10,33,0.233,213,0.202,7,0.209,14.2,163,14,149,0.086,312,0.522,27,0.572,9.2,206,24,182,0.117,521,0.395,34,0.423,10.2,2017-18,Regular%20Season
1628372,Dennis Smith Jr.,1610612742,DAL,69,22,47,2049.0,50,20,29,0.4,259,0.193,12,0.202,10.1,210,32,179,0.152,422,0.498,38,0.547,7.5,260,52,208,0.2,677,0.384,50,0.415,8.0,2017-18,Regular%20Season
1627756,Denzel Valentine,1610612741,CHI,73,24,49,2007.0,47,16,31,0.34,152,0.309,3,0.315,13.9,339,61,278,0.18,576,0.589,50,0.644,6.1,386,77,309,0.199,715,0.54,53,0.583,7.1,2017-18,Regular%20Season
202324,Derrick Favors,1610612762,UTA,77,46,31,2153.0,198,140,53,0.707,467,0.424,9,0.432,4.9,354,126,227,0.356,638,0.555,44,0.596,4.7,552,266,280,0.482,1066,0.518,53,0.545,4.8,2017-18,Regular%20Season
1627884,Derrick Jones Jr.,1610612748,MIA,17,9,8,236.0,21,12,9,0.571,34,0.618,1,0.636,8.0,17,0,17,0.0,33,0.515,2,0.548,7.4,38,12,26,0.316,67,0.567,3,0.594,7.7,2017-18,Regular%20Season
201565,Derrick Rose,1610612750,MIN,17,9,8,351.0,12,5,6,0.417,35,0.343,0,0.343,13.0,22,6,16,0.273,42,0.524,6,0.611,9.7,34,11,22,0.324,77,0.442,6,0.479,10.8,2017-18,Regular%20Season
1628476,Derrick Walton Jr.,1610612748,MIA,10,6,4,105.0,2,0,2,0.0,5,0.4,0,0.4,19.6,14,3,11,0.214,29,0.483,4,0.56,8.5,16,3,13,0.188,34,0.471,4,0.533,9.9,2017-18,Regular%20Season
1628401,Derrick White,1610612759,SAS,11,4,7,116.0,5,2,3,0.4,13,0.385,0,0.385,12.5,21,8,13,0.381,33,0.636,1,0.656,4.9,26,10,16,0.385,45,0.578,1,0.591,6.3,2017-18,Regular%20Season
202682,Derrick Williams,1610612747,LAL,1,0,1,8.0,0,0,0,0.0,3,0.0,0,0.0,0.0,1,0,1,0.0,1,1.0,0,1.0,3.5,1,0,1,0.0,3,0.333,0,0.333,3.5,2017-18,Regular%20Season
1626164,Devin Booker,1610612756,PHX,54,16,38,1865.0,26,10,17,0.385,157,0.166,6,0.172,12.1,218,22,195,0.101,373,0.584,31,0.637,7.8,244,32,212,0.131,523,0.467,37,0.502,8.4,2017-18,Regular%20Season
2734,Devin Harris,1610612743,DEN,54,26,28,1069.0,12,3,9,0.25,69,0.174,1,0.176,17.3,115,26,90,0.226,207,0.556,16,0.602,8.5,127,29,99,0.228,269,0.472,17,0.504,9.3,2017-18,Regular%20Season
1628421,Devin Robinson,1610612764,WAS,1,0,1,13.0,2,1,0,0.5,4,0.5,0,0.5,2.2,3,1,2,0.333,4,0.75,0,0.75,5.6,5,2,2,0.4,8,0.625,0,0.625,4.7,2017-18,Regular%20Season
203473,Dewayne Dedmon,1610612737,ATL,61,18,43,1520.0,100,60,39,0.6,267,0.375,4,0.38,6.3,381,116,261,0.304,586,0.65,23,0.677,4.4,481,176,300,0.366,817,0.589,27,0.609,4.8,2017-18,Regular%20Season
1627738,Deyonta Davis,1610612763,MEM,58,15,43,913.0,75,41,29,0.547,163,0.46,3,0.469,5.9,175,55,119,0.314,309,0.566,21,0.608,4.8,250,96,148,0.384,454,0.551,24,0.581,5.1,2017-18,Regular%20Season
1628415,Dillon Brooks,1610612763,MEM,75,19,56,2202.0,48,18,30,0.375,183,0.262,1,0.264,9.0,208,46,163,0.221,377,0.552,26,0.593,6.9,256,64,193,0.25,545,0.47,27,0.494,7.3,2017-18,Regular%20Season
203079,Dion Waiters,1610612748,MIA,28,15,13,854.0,8,1,7,0.125,60,0.133,3,0.14,15.5,68,6,62,0.088,129,0.527,10,0.571,9.3,76,7,69,0.092,187,0.406,13,0.437,9.9,2017-18,Regular%20Season
1717,Dirk Nowitzki,1610612742,DAL,76,24,52,1872.0,22,14,6,0.636,79,0.278,2,0.286,9.7,416,136,279,0.327,677,0.614,50,0.663,4.3,438,150,285,0.342,726,0.603,52,0.65,4.5,2017-18,Regular%20Season
1627734,Domantas Sabonis,1610612754,IND,73,44,29,1800.0,165,115,50,0.697,446,0.37,11,0.379,6.1,407,122,281,0.3,690,0.59,44,0.63,4.1,572,237,331,0.414,1094,0.523,55,0.551,4.7,2017-18,Regular%20Season
1628378,Donovan Mitchell,1610612762,UTA,75,44,31,2523.0,52,23,30,0.442,251,0.207,11,0.217,11.8,244,41,202,0.168,460,0.53,27,0.564,8.4,296,64,232,0.216,697,0.425,38,0.449,9.0,2017-18,Regular%20Season
1627827,Dorian Finney-Smith,1610612742,DAL,20,3,17,444.0,22,11,11,0.5,55,0.4,0,0.4,8.0,53,13,40,0.245,98,0.541,14,0.631,4.8,75,24,51,0.32,147,0.51,14,0.564,5.7,2017-18,Regular%20Season
203926,Doug McDermott,1610612742,DAL,68,27,41,1548.0,40,24,16,0.6,133,0.301,3,0.308,6.1,159,38,121,0.239,288,0.552,21,0.596,6.5,199,62,137,0.312,412,0.483,24,0.513,6.5,2017-18,Regular%20Season
1627733,Dragan Bender,1610612756,PHX,77,20,57,1978.0,40,22,17,0.55,164,0.244,6,0.253,8.9,321,71,250,0.221,594,0.54,52,0.592,4.8,361,93,267,0.258,720,0.501,58,0.545,5.2,2017-18,Regular%20Season
203110,Draymond Green,1610612744,GSW,69,47,22,2277.0,75,50,22,0.667,215,0.349,6,0.359,6.4,460,118,338,0.257,798,0.576,44,0.61,5.0,535,168,360,0.314,969,0.552,50,0.582,5.2,2017-18,Regular%20Season
1628407,Dwayne Bacon,1610612766,CHA,38,17,21,634.0,4,1,3,0.25,38,0.105,1,0.108,12.5,120,23,97,0.192,179,0.67,8,0.702,6.0,124,24,100,0.194,207,0.599,9,0.626,6.2,2017-18,Regular%20Season
202779,Dwight Buycks,1610612765,DET,20,6,14,370.0,12,3,9,0.25,48,0.25,2,0.261,12.0,29,3,26,0.103,76,0.382,8,0.426,8.2,41,6,35,0.146,124,0.331,10,0.36,9.3,2017-18,Regular%20Season
2730,Dwight Howard,1610612766,CHA,81,35,46,2463.0,255,172,74,0.675,620,0.411,11,0.419,4.1,757,226,525,0.299,1118,0.677,68,0.721,3.8,1012,398,599,0.393,1694,0.597,79,0.627,3.9,2017-18,Regular%20Season
203939,Dwight Powell,1610612742,DAL,76,22,54,1649.0,135,78,57,0.578,386,0.35,6,0.355,6.6,309,79,229,0.256,522,0.592,48,0.652,5.3,444,157,286,0.354,872,0.509,54,0.543,5.7,2017-18,Regular%20Season
2548,Dwyane Wade,1610612748,MIA,63,35,28,1454.0,50,28,22,0.56,173,0.289,6,0.299,8.3,202,43,160,0.213,367,0.55,35,0.608,6.5,252,71,182,0.282,530,0.475,41,0.515,6.9,2017-18,Regular%20Season
202734,E'Twaun Moore,1610612740,NOP,79,45,34,2480.0,57,22,34,0.386,165,0.345,4,0.354,11.0,181,31,147,0.171,361,0.501,33,0.552,9.5,238,53,181,0.223,515,0.462,37,0.498,9.9,2017-18,Regular%20Season
202334,Ed Davis,1610612757,POR,78,48,30,1471.0,183,122,58,0.667,476,0.384,11,0.394,5.3,392,116,271,0.296,653,0.6,54,0.654,4.0,575,238,329,0.414,1103,0.521,65,0.554,4.4,2017-18,Regular%20Season
1628410,Edmond Sumner,1610612754,IND,1,0,1,2.0,0,0,0,0.0,0,0.0,0,0.0,0.0,1,0,1,0.0,1,1.0,0,1.0,6.5,1,0,1,0.0,1,1.0,0,1.0,6.5,2017-18,Regular%20Season
202327,Ekpe Udoh,1610612762,UTA,50,27,23,719.0,68,39,29,0.574,155,0.439,2,0.444,7.5,82,27,56,0.329,198,0.414,21,0.463,5.4,150,66,85,0.44,343,0.437,23,0.469,6.4,2017-18,Regular%20Season
203901,Elfrid Payton,1610612756,PHX,59,13,46,1702.0,64,29,34,0.453,239,0.268,7,0.276,10.9,210,25,182,0.119,338,0.621,17,0.654,8.0,274,54,216,0.197,570,0.481,24,0.502,8.7,2017-18,Regular%20Season
2731,Emeka Okafor,1610612740,NOP,26,16,10,353.0,47,23,23,0.489,83,0.566,0,0.566,5.7,73,24,48,0.329,159,0.459,17,0.514,5.3,120,47,71,0.392,239,0.502,17,0.541,5.5,2017-18,Regular%20Season
1626144,Emmanuel Mudiay,1610612752,NYK,53,21,32,1125.0,26,13,13,0.5,125,0.208,4,0.215,10.2,126,18,106,0.143,210,0.6,9,0.627,8.0,152,31,119,0.204,330,0.461,13,0.479,8.4,2017-18,Regular%20Season
202683,Enes Freedom,1610612752,NYK,70,26,44,1807.0,271,202,58,0.745,637,0.425,12,0.434,4.6,504,142,362,0.282,824,0.612,66,0.665,4.0,775,344,420,0.444,1432,0.541,78,0.572,4.2,2017-18,Regular%20Season
202339,Eric Bledsoe,1610612749,MIL,72,39,33,2281.0,51,19,33,0.373,203,0.251,5,0.258,8.6,233,41,189,0.176,447,0.521,36,0.567,9.0,284,60,222,0.211,633,0.449,41,0.48,8.9,2017-18,Regular%20Season
201569,Eric Gordon,1610612745,HOU,63,50,13,1990.0,25,9,18,0.36,117,0.214,9,0.231,14.7,145,14,129,0.097,253,0.573,13,0.604,9.0,170,23,147,0.135,362,0.47,22,0.5,10.0,2017-18,Regular%20Season
203961,Eric Moreland,1610612765,DET,62,30,32,787.0,81,52,29,0.642,240,0.338,5,0.345,4.4,197,56,140,0.284,338,0.583,21,0.621,4.1,278,108,169,0.388,560,0.496,26,0.521,4.2,2017-18,Regular%20Season
1628571,Erik McCree,1610612762,UTA,1,1,0,4.0,0,0,0,0.0,0,0.0,0,0.0,0.0,1,0,1,0.0,1,1.0,0,1.0,0.8,1,0,1,0.0,1,1.0,0,1.0,0.8,2017-18,Regular%20Season
101141,Ersan Ilyasova,1610612755,PHI,69,36,33,1730.0,118,71,46,0.602,286,0.413,8,0.424,6.4,287,75,210,0.261,488,0.588,28,0.624,5.4,405,146,256,0.36,743,0.545,36,0.573,5.7,2017-18,Regular%20Season
203095,Evan Fournier,1610612753,ORL,55,20,35,1776.0,23,10,14,0.435,126,0.183,2,0.185,12.6,157,27,128,0.172,300,0.523,28,0.577,8.1,180,37,142,0.206,416,0.433,30,0.466,8.7,2017-18,Regular%20Season
202323,Evan Turner,1610612757,POR,72,43,29,1872.0,30,12,17,0.4,152,0.197,4,0.203,10.6,214,56,159,0.262,400,0.535,46,0.605,5.7,244,68,176,0.279,537,0.454,50,0.501,6.3,2017-18,Regular%20Season
1626163,Frank Kaminsky,1610612766,CHA,75,34,41,1771.0,46,22,24,0.478,160,0.288,7,0.301,9.7,242,40,201,0.165,426,0.568,35,0.619,6.1,288,62,225,0.215,562,0.512,42,0.554,6.7,2017-18,Regular%20Season
1628412,Frank Mason III,1610612758,SAC,45,16,29,879.0,30,11,19,0.367,89,0.337,4,0.353,12.0,100,14,83,0.14,156,0.641,7,0.671,8.3,130,25,102,0.192,243,0.535,11,0.56,9.2,2017-18,Regular%20Season
1628373,Frank Ntilikina,1610612752,NYK,62,22,40,1477.0,37,12,26,0.324,101,0.366,3,0.378,13.3,138,28,110,0.203,262,0.527,20,0.57,9.4,175,40,136,0.229,359,0.487,23,0.521,10.3,2017-18,Regular%20Season
1627832,Fred VanVleet,1610612761,TOR,67,48,19,1372.0,25,6,18,0.24,133,0.188,4,0.194,17.9,159,25,134,0.157,326,0.488,20,0.52,8.8,184,31,152,0.168,456,0.404,24,0.426,10.0,2017-18,Regular%20Season
1627788,Furkan Korkmaz,1610612755,PHI,7,5,2,47.0,2,0,2,0.0,3,0.667,0,0.667,7.7,9,0,9,0.0,11,0.818,0,0.818,8.5,11,0,11,0.0,13,0.846,0,0.846,8.4,2017-18,Regular%20Season
202066,Garrett Temple,1610612758,SAC,54,19,35,1392.0,22,11,11,0.5,90,0.244,2,0.25,8.4,129,17,109,0.132,239,0.54,16,0.578,8.3,151,28,120,0.185,315,0.479,18,0.508,8.3,2017-18,Regular%20Season
203914,Gary Harris,1610612743,DEN,61,32,29,2087.0,37,16,20,0.432,130,0.285,1,0.287,10.3,134,19,116,0.142,229,0.585,14,0.623,9.3,171,35,136,0.205,357,0.479,15,0.5,9.5,2017-18,Regular%20Season
1627780,Gary Payton II,1610612747,LAL,15,5,10,181.0,13,8,6,0.615,37,0.351,0,0.351,5.4,31,6,25,0.194,54,0.574,2,0.596,4.5,44,14,31,0.318,88,0.5,2,0.512,4.8,2017-18,Regular%20Season
201588,George Hill,1610612739,CLE,59,26,33,1637.0,42,15,26,0.357,113,0.372,4,0.385,14.2,139,26,112,0.187,263,0.529,20,0.572,8.7,181,41,138,0.227,373,0.485,24,0.519,10.0,2017-18,Regular%20Season
1627777,Georges Niang,1610612762,UTA,4,4,0,20.0,3,0,3,0.0,4,0.75,0,0.75,16.6,5,0,5,0.0,7,0.714,0,0.714,7.6,8,0,8,0.0,10,0.8,0,0.8,10.9,2017-18,Regular%20Season
1627834,Georgios Papagiannis,1610612757,POR,15,3,12,119.0,13,9,2,0.692,27,0.481,0,0.481,4.5,24,8,16,0.333,41,0.585,0,0.585,3.8,37,17,18,0.459,62,0.597,0,0.597,4.0,2017-18,Regular%20Season
101123,Gerald Green,1610612745,HOU,37,29,8,876.0,15,4,11,0.267,65,0.231,1,0.234,14.3,118,13,105,0.11,205,0.576,10,0.605,6.6,133,17,116,0.128,263,0.506,11,0.528,7.5,2017-18,Regular%20Season
1628492,Gian Clavell,1610612742,DAL,2,0,2,35.0,1,0,1,0.0,1,1.0,0,1.0,18.7,6,1,5,0.167,8,0.75,1,0.857,6.6,7,1,6,0.143,9,0.778,1,0.875,8.3,2017-18,Regular%20Season
203507,Giannis Antetokounmpo,1610612749,MIL,74,39,35,2715.0,156,96,56,0.615,439,0.355,8,0.362,6.7,587,127,452,0.216,909,0.646,49,0.683,5.7,743,223,508,0.3,1273,0.584,57,0.611,5.9,2017-18,Regular%20Season
203922,Glenn Robinson III,1610612754,IND,16,10,6,258.0,11,5,7,0.455,29,0.379,1,0.393,8.9,26,5,21,0.192,44,0.591,2,0.619,7.4,37,10,28,0.27,72,0.514,3,0.536,8.0,2017-18,Regular%20Season
201609,Goran Dragic,1610612748,MIA,74,38,36,2349.0,54,27,26,0.5,209,0.258,9,0.27,11.1,245,31,214,0.127,480,0.51,42,0.559,9.1,299,58,240,0.194,677,0.442,51,0.478,9.4,2017-18,Regular%20Season
202330,Gordon Hayward,1610612738,BOS,1,0,1,5.0,0,0,0,0.0,2,0.0,0,0.0,0.0,1,0,1,0.0,2,0.5,0,0.5,21.8,1,0,1,0.0,4,0.25,0,0.25,21.8,2017-18,Regular%20Season
203476,Gorgui Dieng,1610612750,MIN,78,45,33,1319.0,106,58,48,0.547,211,0.502,2,0.507,7.7,254,74,179,0.291,434,0.585,23,0.618,5.3,360,132,227,0.367,620,0.581,25,0.605,6.0,2017-18,Regular%20Season
202328,Greg Monroe,1610612738,BOS,48,20,28,1014.0,109,77,32,0.706,267,0.408,7,0.419,4.9,235,77,158,0.328,356,0.66,24,0.708,3.9,344,154,190,0.448,598,0.575,31,0.607,4.2,2017-18,Regular%20Season
1627824,Guerschon Yabusele,1610612738,BOS,23,15,8,205.0,17,8,8,0.471,46,0.37,3,0.395,8.7,35,4,31,0.114,66,0.53,6,0.583,6.0,52,12,39,0.231,104,0.5,9,0.547,6.8,2017-18,Regular%20Season
203084,Harrison Barnes,1610612742,DAL,77,24,53,2634.0,77,38,37,0.494,261,0.295,8,0.304,8.5,391,66,323,0.169,659,0.593,57,0.65,6.1,468,104,360,0.222,879,0.532,65,0.575,6.5,2017-18,Regular%20Season
202355,Hassan Whiteside,1610612748,MIA,54,30,24,1364.0,174,116,57,0.667,407,0.428,7,0.435,4.8,444,153,290,0.345,669,0.664,41,0.707,3.5,618,269,347,0.435,1051,0.588,48,0.616,3.8,2017-18,Regular%20Season
1627740,Henry Ellenson,1610612765,DET,30,15,15,313.0,10,5,5,0.5,31,0.323,0,0.323,6.6,71,17,52,0.239,121,0.587,9,0.634,5.4,81,22,57,0.272,148,0.547,9,0.583,5.5,2017-18,Regular%20Season
203546,Ian Clark,1610612740,NOP,50,27,23,1097.0,10,1,9,0.1,58,0.172,3,0.182,13.1,114,14,100,0.123,198,0.576,16,0.626,9.2,124,15,109,0.121,253,0.49,19,0.53,9.5,2017-18,Regular%20Season
101133,Ian Mahinmi,1610612764,WAS,74,39,35,1115.0,135,80,55,0.593,306,0.441,9,0.455,5.5,177,50,127,0.282,356,0.497,39,0.558,5.3,312,130,182,0.417,639,0.488,48,0.528,5.4,2017-18,Regular%20Season
1628387,Ike Anigbogu,1610612754,IND,6,3,3,21.0,5,4,1,0.8,9,0.556,0,0.556,4.7,4,1,3,0.25,14,0.286,1,0.308,9.3,9,5,4,0.556,21,0.429,1,0.45,6.8,2017-18,Regular%20Season
202697,Iman Shumpert,1610612758,SAC,13,8,5,269.0,7,0,6,0.0,22,0.318,0,0.318,19.7,34,6,29,0.176,52,0.654,3,0.694,6.7,41,6,35,0.146,72,0.569,3,0.594,8.6,2017-18,Regular%20Season
203477,Isaiah Canaan,1610612756,PHX,18,8,10,387.0,6,4,2,0.667,34,0.176,2,0.188,7.7,39,4,35,0.103,75,0.52,4,0.549,7.3,45,8,37,0.178,107,0.421,6,0.446,7.4,2017-18,Regular%20Season
1628439,Isaiah Hicks,1610612752,NYK,12,4,8,166.0,10,6,4,0.6,34,0.294,1,0.303,7.0,31,7,24,0.226,68,0.456,5,0.492,5.9,41,13,28,0.317,99,0.414,6,0.441,6.2,2017-18,Regular%20Season
1627819,Isaiah Taylor,1610612737,ATL,50,14,36,975.0,22,4,18,0.182,85,0.259,3,0.268,15.3,72,13,60,0.181,131,0.55,12,0.605,9.5,94,17,78,0.181,212,0.443,15,0.477,10.9,2017-18,Regular%20Season
202738,Isaiah Thomas,1610612747,LAL,29,14,15,788.0,17,6,11,0.353,61,0.279,3,0.293,14.9,48,9,39,0.188,102,0.471,9,0.516,10.9,65,15,50,0.231,163,0.399,12,0.43,11.9,2017-18,Regular%20Season
1627785,Isaiah Whitehead,1610612751,BKN,11,2,9,147.0,3,3,0,1.0,11,0.273,0,0.273,4.1,18,5,13,0.278,27,0.667,2,0.72,8.0,21,8,13,0.381,38,0.553,2,0.583,7.4,2017-18,Regular%20Season
202397,Ish Smith,1610612765,DET,74,35,39,1876.0,27,6,21,0.222,159,0.17,1,0.171,11.2,197,33,161,0.168,406,0.485,43,0.543,8.6,224,39,182,0.174,561,0.399,44,0.433,8.9,2017-18,Regular%20Season
1628397,Ivan Rabb,1610612763,MEM,29,4,25,495.0,53,42,10,0.792,132,0.402,4,0.414,5.8,105,36,70,0.343,177,0.593,10,0.629,5.2,158,78,80,0.494,293,0.539,14,0.566,5.4,2017-18,Regular%20Season
1627826,Ivica Zubac,1610612747,LAL,31,14,17,374.0,43,30,13,0.698,93,0.462,3,0.478,4.1,75,29,45,0.387,140,0.536,11,0.581,4.0,118,59,58,0.5,231,0.511,14,0.544,4.0,2017-18,Regular%20Season
200826,J.J. Barea,1610612742,DAL,68,22,46,1582.0,15,4,13,0.267,112,0.134,6,0.142,16.6,186,16,168,0.086,320,0.581,25,0.631,8.4,201,20,181,0.1,427,0.471,31,0.508,9.1,2017-18,Regular%20Season
200755,JJ Redick,1610612755,PHI,63,40,23,1915.0,9,1,8,0.111,73,0.123,3,0.129,25.7,162,15,147,0.093,291,0.557,22,0.602,10.0,171,16,155,0.094,356,0.48,25,0.517,10.8,2017-18,Regular%20Season
2747,JR Smith,1610612739,CLE,72,43,29,2054.0,29,14,15,0.483,101,0.287,3,0.296,13.8,206,30,174,0.146,347,0.594,27,0.644,8.5,235,44,189,0.187,430,0.547,30,0.588,9.1,2017-18,Regular%20Season
203960,JaKarr Sampson,1610612758,SAC,19,5,14,329.0,21,12,8,0.571,55,0.382,2,0.396,5.6,57,6,51,0.105,102,0.559,9,0.613,4.5,78,18,59,0.231,153,0.51,11,0.549,4.8,2017-18,Regular%20Season
203210,JaMychal Green,1610612763,MEM,55,11,44,1542.0,147,102,43,0.694,396,0.371,4,0.375,6.0,317,66,250,0.208,456,0.695,19,0.725,4.8,464,168,293,0.362,811,0.572,23,0.589,5.2,2017-18,Regular%20Season
201580,JaVale McGee,1610612744,GSW,55,41,14,551.0,59,38,20,0.644,133,0.444,4,0.457,6.1,110,46,62,0.418,200,0.55,12,0.585,5.1,169,84,82,0.497,323,0.523,16,0.55,5.5,2017-18,Regular%20Season
1628444,Jabari Bird,1610612738,BOS,7,4,3,105.0,6,2,4,0.333,13,0.462,2,0.545,5.5,13,1,11,0.077,19,0.684,1,0.722,7.7,19,3,15,0.158,32,0.594,3,0.655,7.0,2017-18,Regular%20Season
203953,Jabari Parker,1610612749,MIL,31,16,15,743.0,42,20,22,0.476,116,0.362,1,0.365,9.4,109,17,91,0.156,197,0.553,12,0.589,6.5,151,37,113,0.245,295,0.512,13,0.535,7.3,2017-18,Regular%20Season
204022,Jack Cooley,1610612758,SAC,7,4,3,87.0,14,10,3,0.714,42,0.333,0,0.333,3.3,16,3,13,0.188,28,0.571,1,0.593,6.3,30,13,16,0.433,68,0.441,1,0.448,5.0,2017-18,Regular%20Season
1628451,Jacob Wiley,1610612751,BKN,3,0,3,27.0,2,1,1,0.5,5,0.4,0,0.4,4.0,9,0,9,0.0,13,0.692,1,0.75,3.3,11,1,10,0.091,17,0.647,1,0.688,3.4,2017-18,Regular%20Season
203109,Jae Crowder,1610612762,UTA,76,48,28,2017.0,59,29,31,0.492,178,0.331,9,0.349,9.6,216,36,179,0.167,380,0.568,24,0.607,6.6,275,65,210,0.236,540,0.509,33,0.542,7.3,2017-18,Regular%20Season
1626143,Jahlil Okafor,1610612751,BKN,24,5,19,323.0,21,14,7,0.667,69,0.304,2,0.313,4.8,64,20,43,0.313,105,0.61,7,0.653,4.5,85,34,50,0.4,165,0.515,9,0.545,4.6,2017-18,Regular%20Season
1627774,Jake Layman,1610612757,POR,10,2,8,76.0,4,1,3,0.25,12,0.333,0,0.333,5.7,12,1,11,0.083,19,0.632,2,0.706,6.6,16,2,14,0.125,28,0.571,2,0.615,6.4,2017-18,Regular%20Season
1627751,Jakob Poeltl,1610612761,TOR,80,57,23,1495.0,165,120,46,0.727,389,0.424,5,0.43,6.0,228,106,120,0.465,501,0.455,46,0.501,4.0,393,226,166,0.575,867,0.453,51,0.482,4.9,2017-18,Regular%20Season
1627883,Jalen Jones,1610612742,DAL,10,1,9,166.0,13,6,7,0.462,36,0.361,3,0.394,8.9,25,3,22,0.12,38,0.658,2,0.694,5.6,38,9,29,0.237,68,0.559,5,0.603,6.7,2017-18,Regular%20Season
2037,Jamal Crawford,1610612750,MIN,60,35,25,1273.0,20,5,15,0.25,51,0.392,2,0.408,17.9,78,2,75,0.026,134,0.582,8,0.619,11.6,98,7,90,0.071,183,0.536,10,0.566,12.9,2017-18,Regular%20Season
1627750,Jamal Murray,1610612743,DEN,77,44,33,2451.0,82,36,47,0.439,258,0.318,9,0.329,10.4,212,37,174,0.175,415,0.511,32,0.554,7.8,294,73,221,0.248,665,0.442,41,0.471,8.6,2017-18,Regular%20Season
1627866,Jameel Warney,1610612742,DAL,3,1,2,27.0,4,4,0,1.0,13,0.308,0,0.308,2.6,5,1,4,0.2,6,0.833,0,0.833,5.1,9,5,4,0.556,19,0.474,0,0.474,4.0,2017-18,Regular%20Season
2749,Jameer Nelson,1610612765,DET,42,21,21,876.0,13,3,9,0.231,55,0.236,1,0.241,16.7,91,11,80,0.121,152,0.599,13,0.655,8.2,104,14,89,0.135,203,0.512,14,0.55,9.2,2017-18,Regular%20Season
1628503,Jamel Artis,1610612753,ORL,12,3,9,221.0,4,2,2,0.5,20,0.2,1,0.211,8.6,34,8,24,0.235,58,0.586,5,0.642,6.9,38,10,26,0.263,76,0.5,6,0.543,7.1,2017-18,Regular%20Season
203516,James Ennis III,1610612765,DET,67,23,44,1524.0,73,37,37,0.507,201,0.363,4,0.371,10.9,151,31,119,0.205,279,0.541,19,0.581,5.5,224,68,156,0.304,464,0.483,23,0.508,7.3,2017-18,Regular%20Season
201935,James Harden,1610612745,HOU,71,59,12,2521.0,40,19,22,0.475,255,0.157,8,0.162,9.0,348,44,303,0.126,566,0.615,38,0.659,7.4,388,63,325,0.162,783,0.496,46,0.526,7.6,2017-18,Regular%20Season
201949,James Johnson,1610612748,MIA,71,35,36,1883.0,60,23,36,0.383,207,0.29,6,0.299,11.5,291,53,236,0.182,516,0.564,30,0.599,5.4,351,76,272,0.217,685,0.512,36,0.541,6.4,2017-18,Regular%20Season
203949,James Michael McAdoo,1610612755,PHI,1,1,0,7.0,0,0,0,0.0,1,0.0,0,0.0,0.0,2,1,1,0.5,2,1.0,0,1.0,6.8,2,1,1,0.5,3,0.667,0,0.667,6.8,2017-18,Regular%20Season
1627821,James Webb III,1610612751,BKN,7,0,7,97.0,8,3,5,0.375,16,0.5,1,0.533,7.8,16,1,15,0.063,25,0.64,3,0.727,5.0,24,4,20,0.167,40,0.6,4,0.667,5.9,2017-18,Regular%20Season
203923,James Young,1610612755,PHI,2,1,1,32.0,0,0,0,0.0,1,0.0,0,0.0,0.0,2,0,2,0.0,4,0.5,0,0.5,9.4,2,0,2,0.0,5,0.4,0,0.4,9.4,2017-18,Regular%20Season
203966,Jamil Wilson,1610612746,LAC,15,6,9,274.0,3,2,1,0.667,15,0.2,0,0.2,15.4,29,6,22,0.207,68,0.426,5,0.46,6.4,32,8,23,0.25,81,0.395,5,0.421,7.3,2017-18,Regular%20Season
201162,Jared Dudley,1610612756,PHX,38,5,33,587.0,8,5,3,0.625,42,0.19,3,0.205,7.5,86,15,69,0.174,181,0.475,12,0.509,7.1,94,20,72,0.213,216,0.435,15,0.468,7.1,2017-18,Regular%20Season
204067,Jarell Eddie,1610612741,CHI,1,0,1,4.0,0,0,0,0.0,0,0.0,0,0.0,0.0,1,1,0,1.0,1,1.0,0,1.0,2.8,1,1,0,1.0,1,1.0,0,1.0,2.8,2017-18,Regular%20Season
1626185,Jarell Martin,1610612763,MEM,68,21,47,1606.0,97,65,32,0.67,309,0.314,5,0.319,7.1,221,52,168,0.235,443,0.499,35,0.542,5.0,318,117,200,0.368,722,0.44,40,0.466,5.6,2017-18,Regular%20Season
1628386,Jarrett Allen,1610612751,BKN,70,24,46,1401.0,142,93,47,0.655,341,0.416,8,0.426,5.7,236,56,180,0.237,459,0.514,36,0.558,4.9,378,149,227,0.394,765,0.494,44,0.524,5.2,2017-18,Regular%20Season
101127,Jarrett Jack,1610612752,NYK,58,23,35,1476.0,20,2,19,0.1,65,0.308,1,0.313,15.7,163,11,152,0.067,260,0.627,14,0.663,9.9,183,13,171,0.071,322,0.568,15,0.596,10.6,2017-18,Regular%20Season
201160,Jason Smith,1610612764,WAS,23,8,15,230.0,17,4,13,0.235,43,0.395,0,0.395,8.1,35,13,22,0.371,65,0.538,5,0.583,4.9,52,17,35,0.327,100,0.52,5,0.547,6.0,2017-18,Regular%20Season
1891,Jason Terry,1610612749,MIL,34,19,15,653.0,5,0,5,0.0,20,0.25,0,0.25,19.4,43,6,37,0.14,70,0.614,3,0.642,11.0,48,6,42,0.125,90,0.533,3,0.552,11.8,2017-18,Regular%20Season
1628393,Jawun Evans,1610612746,LAC,36,18,18,684.0,9,3,8,0.333,53,0.17,2,0.176,13.2,72,16,56,0.222,151,0.477,18,0.541,7.7,81,19,64,0.235,200,0.405,20,0.45,8.5,2017-18,Regular%20Season
1627759,Jaylen Brown,1610612738,BOS,66,43,23,2018.0,60,30,33,0.5,233,0.258,6,0.264,9.0,269,52,216,0.193,435,0.618,27,0.659,6.2,329,82,249,0.249,648,0.508,33,0.535,6.7,2017-18,Regular%20Season
1628537,Jaylen Morris,1610612737,ATL,6,2,4,98.0,2,0,3,0.0,14,0.143,0,0.143,4.2,14,2,11,0.143,25,0.56,1,0.583,8.8,16,2,14,0.125,38,0.421,1,0.432,8.6,2017-18,Regular%20Season
1628369,Jayson Tatum,1610612738,BOS,77,50,27,2362.0,49,25,23,0.51,196,0.25,6,0.258,9.5,340,58,282,0.171,546,0.623,29,0.658,6.5,389,83,305,0.213,725,0.537,35,0.564,6.9,2017-18,Regular%20Season
201145,Jeff Green,1610612739,CLE,72,44,28,1708.0,60,36,24,0.6,165,0.364,5,0.375,8.4,185,62,124,0.335,351,0.527,17,0.554,6.4,245,98,148,0.4,504,0.486,22,0.508,6.9,2017-18,Regular%20Season
201952,Jeff Teague,1610612750,MIN,66,38,28,2177.0,24,3,21,0.125,135,0.178,3,0.182,16.1,185,16,168,0.086,349,0.53,21,0.564,9.7,209,19,189,0.091,480,0.435,24,0.458,10.4,2017-18,Regular%20Season
203481,Jeff Withey,1610612742,DAL,7,1,6,34.0,1,1,0,1.0,5,0.2,0,0.2,2.5,9,2,7,0.222,16,0.563,1,0.6,4.4,10,3,7,0.3,19,0.526,1,0.556,4.2,2017-18,Regular%20Season
203924,Jerami Grant,1610612760,OKC,77,46,31,1581.0,83,47,34,0.566,240,0.346,8,0.358,7.5,231,70,161,0.303,414,0.558,25,0.594,5.9,314,117,195,0.373,632,0.497,33,0.524,6.3,2017-18,Regular%20Season
202379,Jeremy Evans,1610612737,ATL,1,0,1,5.0,1,0,1,0.0,1,1.0,0,1.0,5.6,0,0,0,0.0,0,0.0,0,0.0,0.0,1,0,1,0.0,1,1.0,0,1.0,5.6,2017-18,Regular%20Season
203087,Jeremy Lamb,1610612766,CHA,77,34,43,1906.0,49,22,26,0.449,159,0.308,6,0.32,12.5,275,46,230,0.167,448,0.614,36,0.667,5.9,324,68,256,0.21,601,0.539,42,0.58,6.9,2017-18,Regular%20Season
1626170,Jerian Grant,1610612741,CHI,61,21,40,1495.0,30,11,20,0.367,134,0.224,2,0.227,14.7,140,17,126,0.121,276,0.507,24,0.556,7.5,170,28,146,0.165,403,0.422,26,0.451,8.8,2017-18,Regular%20Season
201573,Jerryd Bayless,1610612755,PHI,34,18,16,841.0,15,3,12,0.2,69,0.217,6,0.238,17.7,64,4,61,0.063,121,0.529,10,0.577,12.1,79,7,73,0.089,182,0.434,16,0.476,13.1,2017-18,Regular%20Season
202710,Jimmy Butler,1610612750,MIN,59,37,22,2164.0,79,34,45,0.43,236,0.335,12,0.353,10.1,235,56,176,0.238,401,0.586,38,0.647,7.7,314,90,221,0.287,629,0.499,50,0.542,8.3,2017-18,Regular%20Season
201149,Joakim Noah,1610612752,NYK,6,1,5,38.0,6,4,2,0.667,10,0.6,0,0.6,3.8,8,3,5,0.375,15,0.533,2,0.615,2.8,14,7,7,0.5,25,0.56,2,0.609,3.3,2017-18,Regular%20Season
201975,Jodie Meeks,1610612764,WAS,53,30,23,869.0,15,6,10,0.4,41,0.366,1,0.375,15.2,111,12,96,0.108,174,0.638,15,0.698,8.9,126,18,106,0.143,213,0.592,16,0.64,9.8,2017-18,Regular%20Season
203925,Joe Harris,1610612751,BKN,69,23,46,1786.0,50,25,27,0.5,193,0.259,7,0.269,11.8,205,44,161,0.215,390,0.526,29,0.568,7.4,255,69,188,0.271,580,0.44,36,0.469,8.3,2017-18,Regular%20Season
204060,Joe Ingles,1610612762,UTA,80,47,33,2531.0,24,7,19,0.292,95,0.253,1,0.255,12.2,320,40,278,0.125,489,0.654,26,0.691,8.2,344,47,297,0.137,573,0.6,27,0.63,8.6,2017-18,Regular%20Season
2207,Joe Johnson,1610612745,HOU,54,34,20,1191.0,14,8,6,0.571,54,0.259,0,0.259,10.0,158,22,134,0.139,271,0.583,17,0.622,6.4,172,30,140,0.174,303,0.568,17,0.601,6.7,2017-18,Regular%20Season
1626202,Joe Young,1610612754,IND,32,14,18,431.0,12,2,10,0.167,41,0.293,2,0.308,15.0,50,2,50,0.04,78,0.641,4,0.676,11.0,62,4,60,0.065,114,0.544,6,0.574,11.7,2017-18,Regular%20Season
1627762,Joel Bolomboy,1610612749,MIL,5,2,3,37.0,6,4,2,0.667,9,0.667,0,0.667,6.5,4,0,4,0.0,6,0.667,1,0.8,4.5,10,4,6,0.4,14,0.714,1,0.769,5.7,2017-18,Regular%20Season
203954,Joel Embiid,1610612755,PHI,62,41,21,1882.0,143,98,44,0.685,392,0.365,9,0.373,6.3,537,185,352,0.345,874,0.614,57,0.657,3.7,680,283,396,0.416,1215,0.56,66,0.592,4.3,2017-18,Regular%20Season
203530,Joffrey Lauvergne,1610612759,SAS,46,24,22,511.0,63,42,22,0.667,165,0.382,3,0.389,5.3,108,24,83,0.222,167,0.647,9,0.684,4.1,171,66,105,0.386,318,0.538,12,0.559,4.5,2017-18,Regular%20Season
1628381,John Collins,1610612737,ATL,73,21,52,1760.0,173,113,58,0.653,508,0.341,8,0.346,6.1,361,111,252,0.307,697,0.518,63,0.569,4.0,534,224,310,0.419,1160,0.46,71,0.49,4.7,2017-18,Regular%20Season
203089,John Henson,1610612749,MIL,75,39,36,1953.0,150,102,46,0.68,351,0.427,6,0.435,4.9,360,130,230,0.361,633,0.569,32,0.599,4.3,510,232,276,0.455,945,0.54,38,0.562,4.5,2017-18,Regular%20Season
204066,John Holland,1610612739,CLE,11,7,4,151.0,6,3,3,0.5,12,0.5,0,0.5,14.0,18,4,14,0.222,36,0.5,2,0.529,8.2,24,7,17,0.292,45,0.533,2,0.558,9.7,2017-18,Regular%20Season
202322,John Wall,1610612764,WAS,41,23,18,1410.0,22,1,20,0.045,126,0.175,9,0.188,22.8,128,9,117,0.07,243,0.527,20,0.574,9.3,150,10,137,0.067,366,0.41,29,0.445,11.3,2017-18,Regular%20Season
1628405,Johnathan Motley,1610612742,DAL,11,1,10,176.0,14,10,4,0.714,39,0.359,1,0.368,6.8,35,6,29,0.171,59,0.593,3,0.625,5.0,49,16,33,0.327,93,0.527,4,0.551,5.5,2017-18,Regular%20Season
203948,Johnny O'Bryant III,1610612766,CHA,31,12,19,352.0,29,22,8,0.759,83,0.349,1,0.354,4.9,64,15,49,0.234,126,0.508,12,0.561,5.1,93,37,57,0.398,204,0.456,13,0.487,5.0,2017-18,Regular%20Season
202720,Jon Leuer,1610612765,DET,8,5,3,136.0,7,3,4,0.429,16,0.438,0,0.438,6.6,25,8,17,0.32,59,0.424,5,0.463,4.3,32,11,21,0.344,74,0.432,5,0.464,4.8,2017-18,Regular%20Season
201973,Jonas Jerebko,1610612762,UTA,67,41,26,1078.0,53,24,28,0.453,148,0.358,5,0.371,8.9,193,33,159,0.171,355,0.544,24,0.583,4.9,246,57,187,0.232,482,0.51,29,0.543,5.8,2017-18,Regular%20Season
202685,Jonas Valanciunas,1610612761,TOR,77,56,21,1727.0,183,130,50,0.71,474,0.386,9,0.394,5.2,477,154,319,0.323,796,0.599,53,0.642,3.5,660,284,369,0.43,1227,0.538,62,0.567,3.9,2017-18,Regular%20Season
1626780,Jonathan Gibson,1610612738,BOS,2,2,0,34.0,0,0,0,0.0,0,0.0,0,0.0,0.0,3,1,2,0.333,7,0.429,0,0.429,8.8,3,1,2,0.333,7,0.429,0,0.429,8.8,2017-18,Regular%20Season
1628371,Jonathan Isaac,1610612753,ORL,26,11,15,522.0,16,11,5,0.688,57,0.281,1,0.286,5.4,83,26,56,0.313,164,0.506,12,0.546,4.3,99,37,61,0.374,213,0.465,13,0.495,4.5,2017-18,Regular%20Season
203613,Jonathon Simmons,1610612753,ORL,64,19,45,1886.0,60,37,27,0.617,186,0.323,9,0.339,9.8,174,29,142,0.167,317,0.549,15,0.576,8.2,234,66,169,0.282,499,0.469,24,0.493,8.6,2017-18,Regular%20Season
1628395,Jordan Bell,1610612744,GSW,54,40,14,797.0,60,35,25,0.583,150,0.4,3,0.408,7.2,147,39,103,0.265,260,0.565,21,0.615,5.2,207,74,128,0.357,392,0.528,24,0.563,5.8,2017-18,Regular%20Season
203903,Jordan Clarkson,1610612739,CLE,71,35,36,1675.0,57,25,33,0.439,175,0.326,7,0.339,9.1,160,24,136,0.15,310,0.516,22,0.556,8.3,217,49,169,0.226,475,0.457,29,0.487,8.6,2017-18,Regular%20Season
202348,Jordan Crawford,1610612740,NOP,3,1,2,41.0,2,1,1,0.5,2,1.0,0,1.0,17.8,2,1,1,0.5,6,0.333,1,0.4,9.3,4,2,2,0.5,8,0.5,1,0.571,13.5,2017-18,Regular%20Season
1626175,Jordan Mickey,1610612748,MIA,21,13,8,274.0,18,11,6,0.611,65,0.277,2,0.286,8.1,63,20,43,0.317,122,0.516,15,0.589,3.8,81,31,49,0.383,179,0.453,17,0.5,4.7,2017-18,Regular%20Season
101181,Jose Calderon,1610612739,CLE,37,23,14,763.0,14,6,8,0.429,40,0.35,0,0.35,13.2,70,6,64,0.086,129,0.543,13,0.603,8.8,84,12,72,0.143,168,0.5,13,0.542,9.6,2017-18,Regular%20Season
1627982,Josh Gray,1610612756,PHX,4,0,4,70.0,2,0,2,0.0,6,0.333,1,0.4,17.6,8,2,6,0.25,14,0.571,0,0.571,6.4,10,2,8,0.2,20,0.5,1,0.526,8.7,2017-18,Regular%20Season
1628404,Josh Hart,1610612747,LAL,58,24,34,1402.0,42,23,21,0.548,129,0.326,6,0.341,10.2,221,50,171,0.226,378,0.585,31,0.637,6.7,263,73,192,0.278,499,0.527,37,0.569,7.4,2017-18,Regular%20Season
203962,Josh Huestis,1610612760,OKC,57,36,21,887.0,41,15,26,0.366,98,0.418,2,0.427,9.4,119,28,92,0.235,236,0.504,17,0.543,6.2,160,43,118,0.269,324,0.494,19,0.525,7.0,2017-18,Regular%20Season
1628367,Josh Jackson,1610612756,PHX,76,19,57,1936.0,95,49,47,0.516,303,0.314,7,0.321,9.4,256,47,210,0.184,435,0.589,33,0.637,6.9,351,96,257,0.274,727,0.483,40,0.511,7.6,2017-18,Regular%20Season
203705,Josh Magette,1610612737,ATL,11,2,9,181.0,2,0,2,0.0,3,0.667,0,0.667,28.2,17,3,14,0.176,34,0.5,1,0.515,10.2,19,3,16,0.158,37,0.514,1,0.528,12.1,2017-18,Regular%20Season
1626196,Josh Richardson,1610612748,MIA,77,42,35,2551.0,68,29,37,0.426,233,0.292,8,0.302,11.6,211,25,186,0.118,421,0.501,29,0.538,9.0,279,54,223,0.194,639,0.437,37,0.463,9.6,2017-18,Regular%20Season
2746,Josh Smith,1610612740,NOP,1,1,0,7.0,3,0,3,0.0,4,0.75,0,0.75,2.7,1,1,0,1.0,2,0.5,0,0.5,2.0,4,1,3,0.25,6,0.667,0,0.667,2.5,2017-18,Regular%20Season
201950,Jrue Holiday,1610612740,NOP,79,46,33,2865.0,62,27,32,0.435,239,0.259,9,0.27,10.0,303,59,246,0.195,557,0.544,41,0.587,8.6,365,86,278,0.236,786,0.464,50,0.496,8.8,2017-18,Regular%20Season
1627823,Juancho Hernangomez,1610612743,DEN,16,8,8,233.0,17,11,5,0.647,34,0.5,0,0.5,7.9,33,12,22,0.364,65,0.508,7,0.569,4.5,50,23,27,0.46,97,0.515,7,0.556,5.6,2017-18,Regular%20Season
203944,Julius Randle,1610612747,LAL,81,35,46,2162.0,180,127,53,0.706,520,0.346,13,0.355,5.8,468,112,353,0.239,767,0.61,47,0.65,5.2,648,239,406,0.369,1223,0.53,60,0.557,5.4,2017-18,Regular%20Season
202933,Julyan Stone,1610612766,CHA,14,7,7,137.0,1,0,1,0.0,6,0.167,0,0.167,22.3,28,4,24,0.143,37,0.757,1,0.778,6.1,29,4,25,0.138,42,0.69,1,0.707,6.7,2017-18,Regular%20Season
1626147,Justin Anderson,1610612755,PHI,32,23,9,489.0,25,14,11,0.56,67,0.373,1,0.379,7.2,67,14,53,0.209,120,0.558,11,0.615,7.0,92,28,64,0.304,178,0.517,12,0.554,7.1,2017-18,Regular%20Season
203200,Justin Holiday,1610612741,CHI,71,23,48,2248.0,31,15,16,0.484,109,0.284,3,0.292,10.2,260,34,226,0.131,440,0.591,34,0.64,7.2,291,49,242,0.168,543,0.536,37,0.575,7.5,2017-18,Regular%20Season
1628382,Justin Jackson,1610612758,SAC,61,19,42,1409.0,27,12,15,0.444,101,0.267,3,0.276,8.7,160,22,136,0.138,244,0.656,10,0.684,7.3,187,34,151,0.182,331,0.565,13,0.588,7.5,2017-18,Regular%20Season
1626159,Justise Winslow,1610612748,MIA,66,32,34,1647.0,63,36,27,0.571,244,0.258,5,0.264,8.7,301,90,209,0.299,546,0.551,50,0.607,5.4,364,126,236,0.346,770,0.473,55,0.509,6.0,2017-18,Regular%20Season
203994,Jusuf Nurkic,1610612757,POR,79,48,31,2088.0,189,142,43,0.751,530,0.357,7,0.361,5.4,519,178,338,0.343,910,0.57,74,0.621,3.9,708,320,381,0.452,1409,0.502,81,0.533,4.3,2017-18,Regular%20Season
1628443,Kadeem Allen,1610612738,BOS,7,2,5,84.0,4,2,2,0.5,11,0.364,0,0.364,4.6,7,1,6,0.143,15,0.467,1,0.5,7.8,11,3,8,0.273,26,0.423,1,0.44,6.6,2017-18,Regular%20Season
1626157,Karl-Anthony Towns,1610612750,MIN,82,47,35,2918.0,238,154,84,0.647,605,0.393,15,0.403,6.2,774,272,501,0.351,1224,0.632,70,0.671,4.4,1012,426,585,0.421,1751,0.578,85,0.607,4.8,2017-18,Regular%20Season
202695,Kawhi Leonard,1610612759,SAS,9,5,4,210.0,6,5,1,0.833,22,0.273,1,0.286,2.5,36,6,30,0.167,56,0.643,2,0.667,8.2,42,11,31,0.262,72,0.583,3,0.609,7.4,2017-18,Regular%20Season
1627770,Kay Felder,1610612765,DET,11,2,9,117.0,3,1,2,0.333,12,0.25,0,0.25,10.1,15,2,13,0.133,19,0.789,0,0.789,9.9,18,3,15,0.167,31,0.581,0,0.581,9.9,2017-18,Regular%20Season
203482,Kelly Olynyk,1610612748,MIA,74,41,33,1744.0,87,58,28,0.667,270,0.322,6,0.33,6.1,339,102,237,0.301,588,0.577,36,0.614,4.9,426,160,265,0.376,815,0.523,42,0.551,5.1,2017-18,Regular%20Season
1626162,Kelly Oubre Jr.,1610612764,WAS,79,43,36,2188.0,59,33,26,0.559,272,0.217,14,0.229,8.1,304,73,227,0.24,501,0.607,28,0.643,5.3,363,106,253,0.292,740,0.491,42,0.52,5.7,2017-18,Regular%20Season
202689,Kemba Walker,1610612766,CHA,75,34,41,2584.0,31,10,23,0.323,207,0.15,12,0.159,10.5,216,23,193,0.106,456,0.474,50,0.532,9.7,247,33,216,0.134,657,0.376,62,0.415,9.8,2017-18,Regular%20Season
2570,Kendrick Perkins,1610612739,CLE,1,0,1,15.0,0,0,0,0.0,2,0.0,0,0.0,0.0,1,0,1,0.0,3,0.333,1,0.5,3.7,1,0,1,0.0,5,0.2,1,0.25,3.7,2017-18,Regular%20Season
202702,Kenneth Faried,1610612743,DEN,31,15,16,449.0,68,49,18,0.721,163,0.417,1,0.42,4.8,85,27,60,0.318,139,0.612,5,0.634,5.1,153,76,78,0.497,291,0.526,6,0.537,4.9,2017-18,Regular%20Season
203145,Kent Bazemore,1610612737,ATL,59,18,41,1656.0,25,8,18,0.32,159,0.157,2,0.159,13.2,220,39,180,0.177,397,0.554,44,0.623,6.7,245,47,198,0.192,547,0.448,46,0.489,7.4,2017-18,Regular%20Season
203484,Kentavious Caldwell-Pope,1610612747,LAL,70,29,41,2374.0,58,30,30,0.517,176,0.33,4,0.337,8.1,320,53,265,0.166,537,0.596,41,0.645,7.1,378,83,295,0.22,705,0.536,45,0.573,7.3,2017-18,Regular%20Season
201142,Kevin Durant,1610612744,GSW,68,49,19,2325.0,31,14,20,0.452,155,0.2,7,0.209,11.9,433,106,323,0.245,675,0.641,38,0.68,6.2,464,120,343,0.259,793,0.585,45,0.62,6.6,2017-18,Regular%20Season
201567,Kevin Love,1610612739,CLE,57,37,20,1643.0,101,72,26,0.713,294,0.344,7,0.352,6.2,445,130,309,0.292,665,0.669,32,0.703,4.4,546,202,335,0.37,921,0.593,39,0.619,4.7,2017-18,Regular%20Season
1626172,Kevon Looney,1610612744,GSW,58,43,15,874.0,83,58,22,0.699,188,0.441,1,0.444,6.1,132,47,83,0.356,262,0.504,16,0.537,6.0,215,105,105,0.488,433,0.497,17,0.517,6.0,2017-18,Regular%20Season
203920,Khem Birch,1610612753,ORL,32,12,20,531.0,69,46,22,0.667,145,0.476,3,0.486,5.4,109,30,79,0.275,176,0.619,8,0.649,4.7,178,76,101,0.427,308,0.578,11,0.599,5.0,2017-18,Regular%20Season
203114,Khris Middleton,1610612749,MIL,80,44,36,2914.0,44,20,27,0.455,197,0.223,6,0.23,12.1,383,76,302,0.198,635,0.603,42,0.646,6.9,427,96,329,0.225,794,0.538,48,0.572,7.4,2017-18,Regular%20Season
202691,Klay Thompson,1610612744,GSW,70,52,18,2417.0,31,18,13,0.581,109,0.284,3,0.292,10.9,246,61,187,0.248,448,0.549,34,0.594,7.8,277,79,200,0.285,552,0.502,37,0.538,8.2,2017-18,Regular%20Season
1628424,Kobi Simmons,1610612763,MEM,23,4,19,534.0,14,7,7,0.5,50,0.28,1,0.286,11.4,36,2,34,0.056,62,0.581,4,0.621,9.1,50,9,41,0.18,111,0.45,5,0.472,9.8,2017-18,Regular%20Season
201585,Kosta Koufos,1610612758,SAC,70,21,49,1381.0,149,81,65,0.544,315,0.473,3,0.478,6.3,323,95,225,0.294,489,0.661,24,0.695,4.1,472,176,290,0.373,772,0.611,27,0.634,4.8,2017-18,Regular%20Season
1627739,Kris Dunn,1610612741,CHI,50,18,32,1473.0,24,2,23,0.083,132,0.182,4,0.188,13.7,196,31,164,0.158,371,0.528,45,0.601,6.9,220,33,187,0.15,498,0.442,49,0.49,7.6,2017-18,Regular%20Season
204001,Kristaps Porzingis,1610612752,NYK,47,21,26,1551.0,62,37,24,0.597,180,0.344,3,0.35,9.2,254,69,187,0.272,447,0.568,24,0.6,4.9,316,106,211,0.335,604,0.523,27,0.548,5.7,2017-18,Regular%20Season
203937,Kyle Anderson,1610612759,SAS,72,40,32,1937.0,84,53,29,0.631,223,0.377,7,0.389,6.5,312,58,253,0.186,457,0.683,27,0.726,6.3,396,111,282,0.28,650,0.609,34,0.643,6.3,2017-18,Regular%20Season
1627858,Kyle Collinsworth,1610612742,DAL,28,7,21,457.0,32,18,13,0.563,87,0.368,5,0.39,6.4,75,12,63,0.16,128,0.586,4,0.605,5.5,107,30,76,0.28,210,0.51,9,0.532,5.7,2017-18,Regular%20Season
2594,Kyle Korver,1610612739,CLE,65,39,26,1422.0,9,2,7,0.222,42,0.214,3,0.231,17.8,156,36,119,0.231,300,0.52,23,0.563,7.7,165,38,126,0.23,338,0.488,26,0.529,8.3,2017-18,Regular%20Season
1628398,Kyle Kuzma,1610612747,LAL,75,33,42,2351.0,86,53,33,0.616,283,0.304,8,0.313,8.2,391,82,307,0.21,672,0.582,54,0.633,5.2,477,135,340,0.283,912,0.523,62,0.561,5.8,2017-18,Regular%20Season
200768,Kyle Lowry,1610612761,TOR,78,57,21,2510.0,66,34,32,0.515,279,0.237,14,0.249,11.7,368,54,316,0.147,657,0.56,57,0.613,7.7,434,88,348,0.203,927,0.468,71,0.507,8.3,2017-18,Regular%20Season
203124,Kyle O'Quinn,1610612752,NYK,75,27,48,1354.0,120,79,39,0.658,331,0.363,6,0.369,5.6,343,115,227,0.335,579,0.592,34,0.629,4.1,463,194,266,0.419,864,0.536,40,0.562,4.5,2017-18,Regular%20Season
202713,Kyle Singler,1610612760,OKC,6,2,4,22.0,1,1,0,1.0,5,0.2,1,0.25,7.1,6,0,6,0.0,8,0.75,0,0.75,6.9,7,1,6,0.143,13,0.538,1,0.583,7.0,2017-18,Regular%20Season
202681,Kyrie Irving,1610612738,BOS,52,34,18,1725.0,32,15,18,0.469,135,0.237,6,0.248,9.1,182,27,154,0.148,369,0.493,32,0.54,8.9,214,42,172,0.196,502,0.426,38,0.461,8.9,2017-18,Regular%20Season
200746,LaMarcus Aldridge,1610612759,SAS,75,45,30,2509.0,246,167,75,0.679,538,0.457,7,0.463,5.3,389,114,274,0.293,654,0.595,49,0.643,6.3,635,281,349,0.443,1162,0.546,56,0.574,5.9,2017-18,Regular%20Season
202362,Lance Stephenson,1610612754,IND,82,48,34,1850.0,62,33,28,0.532,256,0.242,8,0.25,8.7,362,51,307,0.141,532,0.68,25,0.714,5.5,424,84,335,0.198,749,0.566,33,0.592,6.0,2017-18,Regular%20Season
202498,Lance Thomas,1610612752,NYK,62,20,42,1213.0,44,23,20,0.523,133,0.331,3,0.338,7.2,129,25,104,0.194,234,0.551,16,0.592,8.7,173,48,124,0.277,354,0.489,19,0.516,8.3,2017-18,Regular%20Season
204038,Langston Galloway,1610612765,DET,45,21,24,713.0,13,2,12,0.154,51,0.255,1,0.26,14.0,79,7,72,0.089,141,0.56,10,0.603,9.5,92,9,84,0.098,189,0.487,11,0.517,10.3,2017-18,Regular%20Season
203580,Larry Drew II,1610612740,NOP,3,2,1,35.0,3,1,2,0.333,6,0.5,1,0.6,9.2,0,0,0,0.0,2,0.0,0,0.0,0.0,3,1,2,0.333,8,0.375,1,0.429,9.2,2017-18,Regular%20Season
1626204,Larry Nance Jr.,1610612739,CLE,66,32,34,1421.0,161,101,57,0.627,350,0.46,11,0.475,6.0,291,79,212,0.271,486,0.599,28,0.635,5.5,452,180,269,0.398,809,0.559,39,0.587,5.7,2017-18,Regular%20Season
1628374,Lauri Markkanen,1610612741,CHI,68,23,45,2020.0,79,43,33,0.544,221,0.357,5,0.366,5.7,429,88,341,0.205,634,0.677,32,0.713,5.4,508,131,374,0.258,817,0.622,37,0.651,5.4,2017-18,Regular%20Season
2544,LeBron James,1610612739,CLE,82,50,32,3026.0,97,46,53,0.474,335,0.29,13,0.301,7.9,612,114,495,0.186,902,0.678,34,0.705,5.7,709,160,548,0.226,1185,0.598,47,0.623,6.0,2017-18,Regular%20Season
1628506,London Perrantes,1610612739,CLE,3,2,1,42.0,1,1,0,1.0,5,0.2,1,0.25,5.6,3,1,2,0.333,5,0.6,1,0.75,9.6,4,2,2,0.5,10,0.4,2,0.5,8.6,2017-18,Regular%20Season
1628366,Lonzo Ball,1610612747,LAL,51,24,27,1742.0,66,35,31,0.53,230,0.287,8,0.297,8.1,286,52,236,0.182,445,0.643,24,0.679,6.9,352,87,267,0.247,661,0.533,32,0.56,7.1,2017-18,Regular%20Season
203485,Lorenzo Brown,1610612761,TOR,6,5,1,77.0,1,0,1,0.0,3,0.333,0,0.333,10.1,13,5,8,0.385,17,0.765,1,0.813,6.5,14,5,9,0.357,20,0.7,1,0.737,6.7,2017-18,Regular%20Season
101150,Lou Williams,1610612746,LAC,74,39,35,2437.0,40,18,24,0.45,193,0.207,6,0.214,10.7,155,21,132,0.135,281,0.552,15,0.583,11.3,195,39,156,0.2,469,0.416,21,0.435,11.2,2017-18,Regular%20Season
201601,Luc Mbah a Moute,1610612745,HOU,60,51,9,1549.0,22,3,19,0.136,117,0.188,7,0.2,13.5,164,60,103,0.366,325,0.505,45,0.586,7.2,186,63,122,0.339,435,0.428,52,0.486,7.9,2017-18,Regular%20Season
203512,Lucas Nogueira,1610612761,TOR,34,27,7,344.0,18,15,4,0.833,44,0.409,1,0.419,4.2,69,20,49,0.29,123,0.561,8,0.6,5.1,87,35,53,0.402,164,0.53,9,0.561,4.9,2017-18,Regular%20Season
1626242,Luis Montero,1610612765,DET,2,1,1,8.0,0,0,0,0.0,2,0.0,0,0.0,0.0,2,2,0,1.0,3,0.667,1,1.0,3.3,2,2,0,1.0,5,0.4,1,0.5,3.3,2017-18,Regular%20Season
202337,Luke Babbitt,1610612748,MIA,36,11,25,605.0,7,0,7,0.0,32,0.219,1,0.226,18.5,87,15,71,0.172,173,0.503,12,0.54,6.1,94,15,78,0.16,194,0.485,13,0.519,7.0,2017-18,Regular%20Season
1628379,Luke Kennard,1610612765,DET,64,31,33,1351.0,21,8,11,0.381,70,0.3,1,0.304,12.8,155,23,133,0.148,276,0.562,22,0.61,8.6,176,31,144,0.176,341,0.516,23,0.553,9.1,2017-18,Regular%20Season
1628436,Luke Kornet,1610612752,NYK,19,6,13,322.0,11,8,3,0.727,40,0.275,0,0.275,3.5,53,20,33,0.377,120,0.442,9,0.477,5.5,64,28,36,0.438,154,0.416,9,0.441,5.2,2017-18,Regular%20Season
1627781,Malachi Richardson,1610612761,TOR,18,6,12,261.0,5,2,3,0.4,20,0.25,0,0.25,17.8,29,7,22,0.241,42,0.69,4,0.763,5.1,34,9,25,0.265,60,0.567,4,0.607,7.0,2017-18,Regular%20Season
1627763,Malcolm Brogdon,1610612749,MIL,45,25,20,1358.0,23,8,16,0.348,97,0.237,4,0.247,12.3,127,24,104,0.189,243,0.523,19,0.567,7.5,150,32,120,0.213,334,0.449,23,0.482,8.4,2017-18,Regular%20Season
1627098,Malcolm Delaney,1610612737,ATL,45,15,30,882.0,9,4,5,0.444,55,0.164,6,0.184,11.8,90,14,75,0.156,168,0.536,11,0.573,8.7,99,18,80,0.182,220,0.45,17,0.488,9.0,2017-18,Regular%20Season
1626259,Malcolm Miller,1610612761,TOR,7,7,0,84.0,4,2,2,0.5,15,0.267,2,0.308,12.9,11,2,9,0.182,18,0.611,0,0.611,8.5,15,4,11,0.267,32,0.469,2,0.5,9.7,2017-18,Regular%20Season
1627736,Malik Beasley,1610612743,DEN,30,12,18,429.0,14,6,8,0.429,31,0.452,0,0.452,12.7,57,11,46,0.193,91,0.626,4,0.655,7.8,71,17,54,0.239,122,0.582,4,0.602,8.8,2017-18,Regular%20Season
1628370,Malik Monk,1610612766,CHA,31,12,19,573.0,8,2,6,0.25,32,0.25,0,0.25,13.0,58,7,51,0.121,98,0.592,4,0.617,9.5,66,9,57,0.136,129,0.512,4,0.528,9.9,2017-18,Regular%20Season
1628493,Mangok Mathiang,1610612766,CHA,4,3,1,20.0,3,2,1,0.667,11,0.273,0,0.273,12.9,7,2,5,0.286,10,0.7,2,0.875,4.6,10,4,6,0.4,19,0.526,2,0.588,7.1,2017-18,Regular%20Season
1938,Manu Ginobili,1610612759,SAS,59,38,21,1231.0,19,8,11,0.421,98,0.194,5,0.204,8.5,122,27,95,0.221,236,0.517,16,0.555,7.3,141,35,106,0.248,326,0.433,21,0.462,7.4,2017-18,Regular%20Season
202705,MarShon Brooks,1610612763,MEM,7,2,5,193.0,8,2,6,0.25,28,0.286,2,0.308,20.0,13,0,13,0.0,24,0.542,2,0.591,7.7,21,2,19,0.095,51,0.412,4,0.447,12.4,2017-18,Regular%20Season
201188,Marc Gasol,1610612763,MEM,73,21,52,2408.0,78,41,37,0.526,257,0.304,8,0.313,10.0,514,156,354,0.304,837,0.614,50,0.653,4.5,592,197,391,0.333,1039,0.57,58,0.603,5.2,2017-18,Regular%20Season
101162,Marcin Gortat,1610612764,WAS,82,43,39,2074.0,181,107,73,0.591,496,0.365,14,0.376,6.6,442,89,347,0.201,791,0.559,75,0.617,4.2,623,196,420,0.315,1238,0.503,89,0.542,4.9,2017-18,Regular%20Season
201158,Marco Belinelli,1610612755,PHI,66,34,32,1633.0,20,3,16,0.15,129,0.155,3,0.159,18.4,127,17,109,0.134,243,0.523,14,0.555,8.1,147,20,125,0.136,363,0.405,17,0.425,9.5,2017-18,Regular%20Season
1627875,Marcus Georges-Hunt,1610612750,MIN,10,7,3,112.0,7,2,5,0.286,12,0.583,0,0.583,11.5,9,2,7,0.222,13,0.692,2,0.818,8.6,16,4,12,0.25,25,0.64,2,0.696,9.9,2017-18,Regular%20Season
202694,Marcus Morris Sr.,1610612738,BOS,52,32,20,1394.0,38,24,15,0.632,151,0.252,6,0.262,9.3,239,49,188,0.205,408,0.586,23,0.621,5.5,277,73,203,0.264,536,0.517,29,0.546,6.1,2017-18,Regular%20Season
1627779,Marcus Paige,1610612766,CHA,3,2,1,18.0,0,0,0,0.0,0,0.0,0,0.0,0.0,4,0,4,0.0,4,1.0,0,1.0,9.6,4,0,4,0.0,4,1.0,0,1.0,9.6,2017-18,Regular%20Season
203935,Marcus Smart,1610612738,BOS,50,35,15,1517.0,42,21,21,0.5,163,0.258,5,0.266,10.1,140,32,109,0.229,271,0.517,20,0.558,7.9,182,53,130,0.291,425,0.428,25,0.455,8.4,2017-18,Regular%20Season
201596,Mario Chalmers,1610612763,MEM,59,20,39,1317.0,13,5,8,0.385,118,0.11,2,0.112,15.0,144,13,131,0.09,265,0.543,21,0.59,9.2,157,18,139,0.115,375,0.419,23,0.446,9.7,2017-18,Regular%20Season
1626209,Mario Hezonja,1610612753,ORL,69,18,51,1619.0,41,17,25,0.415,164,0.25,6,0.259,13.0,240,45,190,0.188,383,0.627,19,0.659,5.7,281,62,215,0.221,524,0.536,25,0.563,6.8,2017-18,Regular%20Season
203900,Markel Brown,1610612745,HOU,3,3,0,30.0,1,0,1,0.0,5,0.2,0,0.2,21.1,4,1,3,0.25,8,0.5,0,0.5,5.5,5,1,4,0.2,13,0.385,0,0.385,8.6,2017-18,Regular%20Season
1628365,Markelle Fultz,1610612755,PHI,14,11,3,253.0,11,5,6,0.455,40,0.275,1,0.282,7.5,32,5,27,0.156,60,0.533,3,0.561,7.8,43,10,33,0.233,98,0.439,4,0.457,7.7,2017-18,Regular%20Season
202693,Markieff Morris,1610612764,WAS,73,37,36,1968.0,75,46,30,0.613,239,0.314,9,0.326,6.8,334,84,249,0.251,538,0.621,27,0.654,5.8,409,130,279,0.318,753,0.543,36,0.57,6.0,2017-18,Regular%20Season
1627737,Marquese Chriss,1610612756,PHX,71,18,53,1517.0,76,47,29,0.618,244,0.311,3,0.315,6.2,319,85,232,0.266,539,0.592,37,0.635,4.4,395,132,261,0.334,732,0.54,40,0.571,4.8,2017-18,Regular%20Season
203104,Marquis Teague,1610612763,MEM,3,0,3,74.0,1,0,1,0.0,3,0.333,0,0.333,25.2,5,0,5,0.0,11,0.455,0,0.455,10.7,6,0,6,0.0,13,0.462,0,0.462,13.1,2017-18,Regular%20Season
201578,Marreese Speights,1610612753,ORL,44,13,31,628.0,21,14,7,0.667,73,0.288,0,0.288,7.0,112,35,75,0.313,217,0.516,17,0.56,4.9,133,49,82,0.368,282,0.472,17,0.502,5.3,2017-18,Regular%20Season
1627850,Marshall Plumlee,1610612749,MIL,6,4,2,51.0,4,3,1,0.75,17,0.235,2,0.267,5.2,13,5,8,0.385,19,0.684,0,0.684,4.4,17,8,9,0.471,35,0.486,2,0.515,4.5,2017-18,Regular%20Season
101107,Marvin Williams,1610612766,CHA,77,33,44,1978.0,74,50,24,0.676,183,0.404,11,0.43,8.3,296,54,238,0.182,488,0.607,32,0.649,7.0,370,104,262,0.281,657,0.563,43,0.603,7.3,2017-18,Regular%20Season
203486,Mason Plumlee,1610612743,DEN,71,39,32,1402.0,129,87,40,0.674,368,0.351,9,0.359,5.4,265,76,187,0.287,448,0.592,28,0.631,4.6,394,163,227,0.414,799,0.493,37,0.517,4.9,2017-18,Regular%20Season
1627856,Matt Costello,1610612759,SAS,3,1,2,28.0,1,1,0,1.0,4,0.25,0,0.25,2.1,8,4,3,0.5,12,0.667,1,0.727,5.0,9,5,3,0.556,15,0.6,1,0.643,4.7,2017-18,Regular%20Season
1628475,Matt Williams Jr.,1610612748,MIA,1,0,1,3.0,0,0,0,0.0,0,0.0,0,0.0,0.0,1,0,1,0.0,2,0.5,0,0.5,3.7,1,0,1,0.0,2,0.5,0,0.5,3.7,2017-18,Regular%20Season
203521,Matthew Dellavedova,1610612749,MIL,30,16,14,590.0,14,2,13,0.143,43,0.326,3,0.35,14.8,48,9,38,0.188,103,0.466,11,0.522,8.8,62,11,51,0.177,145,0.428,14,0.473,10.3,2017-18,Regular%20Season
203090,Maurice Harkless,1610612757,POR,49,33,16,1149.0,46,29,17,0.63,152,0.303,4,0.311,6.4,116,28,89,0.241,213,0.545,15,0.586,6.4,162,57,106,0.352,350,0.463,19,0.489,6.4,2017-18,Regular%20Season
1628467,Maxi Kleber,1610612742,DAL,63,19,44,1159.0,70,37,32,0.529,178,0.393,4,0.402,7.8,163,51,113,0.313,293,0.556,22,0.601,5.2,233,88,145,0.378,452,0.515,26,0.547,6.0,2017-18,Regular%20Season
203086,Meyers Leonard,1610612757,POR,29,15,14,243.0,12,10,1,0.833,32,0.375,1,0.387,6.3,58,14,44,0.241,82,0.707,6,0.763,4.7,70,24,45,0.343,107,0.654,7,0.7,4.9,2017-18,Regular%20Season
201563,Michael Beasley,1610612752,NYK,70,21,49,1608.0,97,59,35,0.608,233,0.416,9,0.433,6.1,312,82,226,0.263,500,0.624,25,0.657,4.5,409,141,261,0.345,703,0.582,34,0.611,4.8,2017-18,Regular%20Season
203487,Michael Carter-Williams,1610612766,CHA,49,21,28,791.0,37,15,23,0.405,111,0.333,2,0.339,11.1,101,14,87,0.139,186,0.543,14,0.587,7.5,138,29,110,0.21,292,0.473,16,0.5,8.4,2017-18,Regular%20Season
203077,Michael Kidd-Gilchrist,1610612766,CHA,71,32,39,1814.0,84,45,38,0.536,244,0.344,9,0.357,8.0,218,45,173,0.206,403,0.541,35,0.592,8.3,302,90,211,0.298,640,0.472,44,0.507,8.2,2017-18,Regular%20Season
201144,Mike Conley,1610612763,MEM,9,6,3,282.0,0,0,0,0.0,13,0.0,1,0.0,0.0,27,1,26,0.037,51,0.529,5,0.587,10.8,27,1,26,0.037,63,0.429,6,0.474,10.8,2017-18,Regular%20Season
1628455,Mike James,1610612740,NOP,31,11,20,635.0,13,4,9,0.308,58,0.224,2,0.232,8.9,77,7,70,0.091,156,0.494,14,0.542,9.8,90,11,79,0.122,212,0.425,16,0.459,9.7,2017-18,Regular%20Season
203488,Mike Muscala,1610612737,ATL,51,13,38,1044.0,56,33,22,0.589,139,0.403,1,0.406,7.1,174,64,108,0.368,314,0.554,19,0.59,5.2,230,97,130,0.422,439,0.524,20,0.549,5.6,2017-18,Regular%20Season
203118,Mike Scott,1610612764,WAS,72,37,35,1347.0,50,22,26,0.44,154,0.325,6,0.338,5.9,197,43,152,0.218,323,0.61,16,0.642,6.1,247,65,178,0.263,455,0.543,22,0.57,6.1,2017-18,Regular%20Season
203101,Miles Plumlee,1610612737,ATL,51,18,33,881.0,77,44,32,0.571,211,0.365,9,0.381,7.2,151,47,104,0.311,309,0.489,43,0.568,4.9,228,91,136,0.399,508,0.449,52,0.5,5.7,2017-18,Regular%20Season
1628462,Milos Teodosic,1610612746,LAC,41,27,14,1067.0,16,4,11,0.25,71,0.225,3,0.235,14.1,106,14,92,0.132,231,0.459,19,0.5,8.6,122,18,103,0.148,302,0.404,22,0.436,9.3,2017-18,Regular%20Season
1628495,Milton Doyle,1610612751,BKN,8,2,6,117.0,3,1,2,0.333,12,0.25,0,0.25,18.5,15,1,14,0.067,28,0.536,4,0.625,6.8,18,2,16,0.111,40,0.45,4,0.5,8.7,2017-18,Regular%20Season
203141,Mirza Teletovic,1610612749,MIL,8,4,4,134.0,3,1,2,0.333,7,0.429,0,0.429,8.1,17,1,16,0.059,35,0.486,1,0.5,4.8,20,2,18,0.1,42,0.476,1,0.488,5.3,2017-18,Regular%20Season
1628420,Monte Morris,1610612743,DEN,1,0,1,22.0,0,0,0,0.0,2,0.0,1,0.0,0.0,2,0,2,0.0,2,1.0,0,1.0,16.7,2,0,2,0.0,4,0.5,1,0.667,16.7,2017-18,Regular%20Season
1626149,Montrezl Harrell,1610612746,LAC,70,36,34,1241.0,103,73,30,0.709,254,0.406,6,0.415,6.3,202,63,138,0.312,364,0.555,24,0.594,5.8,305,136,168,0.446,592,0.515,30,0.543,6.0,2017-18,Regular%20Season
1627988,Myke Henry,1610612763,MEM,17,2,15,328.0,10,4,6,0.4,38,0.263,1,0.27,15.4,28,5,23,0.179,62,0.452,11,0.549,7.1,38,9,29,0.237,96,0.396,12,0.452,9.3,2017-18,Regular%20Season
1626167,Myles Turner,1610612754,IND,64,39,25,1816.0,93,62,32,0.667,242,0.384,9,0.399,6.2,324,119,203,0.367,645,0.502,47,0.542,4.4,417,181,235,0.434,858,0.486,56,0.52,4.8,2017-18,Regular%20Season
203489,Nate Wolters,1610612762,UTA,1,1,0,3.0,1,0,1,0.0,1,1.0,0,1.0,13.4,0,0,0,0.0,1,0.0,0,0.0,0.0,1,0,1,0.0,2,0.5,0,0.5,13.4,2017-18,Regular%20Season
202357,Nemanja Bjelica,1610612750,MIN,62,36,26,1319.0,53,34,18,0.642,141,0.376,2,0.381,6.2,221,63,157,0.285,361,0.612,25,0.658,5.8,274,97,175,0.354,486,0.564,27,0.597,5.9,2017-18,Regular%20Season
2403,Nene,1610612745,HOU,51,41,10,753.0,54,36,18,0.667,158,0.342,2,0.346,5.8,122,31,90,0.254,219,0.557,19,0.61,4.7,176,67,108,0.381,367,0.48,21,0.509,5.1,2017-18,Regular%20Season
203457,Nerlens Noel,1610612742,DAL,27,5,22,466.0,48,38,9,0.792,127,0.378,3,0.387,4.9,120,37,82,0.308,191,0.628,19,0.698,3.9,168,75,91,0.446,307,0.547,22,0.589,4.2,2017-18,Regular%20Season
2555,Nick Collison,1610612760,OKC,9,6,3,48.0,5,3,2,0.6,16,0.313,1,0.333,4.1,10,0,10,0.0,19,0.526,1,0.556,4.6,15,3,12,0.2,33,0.455,2,0.484,4.4,2017-18,Regular%20Season
201156,Nick Young,1610612744,GSW,55,35,20,1092.0,20,5,16,0.25,58,0.345,2,0.357,14.5,105,20,85,0.19,192,0.547,13,0.587,9.0,125,25,101,0.2,247,0.506,15,0.539,10.1,2017-18,Regular%20Season
201587,Nicolas Batum,1610612766,CHA,63,27,36,1950.0,57,29,28,0.509,162,0.352,4,0.361,8.6,249,38,212,0.153,385,0.647,30,0.701,6.8,306,67,240,0.219,533,0.574,34,0.613,7.1,2017-18,Regular%20Season
1627852,Nicolas Brussino,1610612737,ATL,3,0,3,10.0,0,0,0,0.0,0,0.0,0,0.0,0.0,3,0,3,0.0,3,1.0,0,1.0,7.0,3,0,3,0.0,3,1.0,0,1.0,7.0,2017-18,Regular%20Season
1628502,Nigel Hayes,1610612758,SAC,5,3,2,105.0,4,2,2,0.5,14,0.286,0,0.286,11.1,18,5,13,0.278,24,0.75,0,0.75,7.0,22,7,15,0.318,34,0.647,0,0.647,7.7,2017-18,Regular%20Season
203917,Nik Stauskas,1610612751,BKN,25,8,17,408.0,4,1,3,0.25,24,0.167,0,0.167,8.9,60,6,54,0.1,94,0.638,7,0.69,7.0,64,7,57,0.109,116,0.552,7,0.587,7.1,2017-18,Regular%20Season
203999,Nikola Jokic,1610612743,DEN,74,42,32,2410.0,192,145,42,0.755,438,0.438,8,0.447,5.5,605,188,417,0.311,938,0.645,47,0.679,4.2,797,333,459,0.418,1312,0.607,55,0.634,4.5,2017-18,Regular%20Season
202703,Nikola Mirotic,1610612740,NOP,55,34,21,1494.0,59,37,20,0.627,177,0.333,6,0.345,6.2,346,74,268,0.214,531,0.652,29,0.689,5.2,405,111,288,0.274,661,0.613,35,0.647,5.4,2017-18,Regular%20Season
202696,Nikola Vucevic,1610612753,ORL,56,17,39,1678.0,101,64,34,0.634,244,0.414,2,0.417,7.1,422,148,271,0.351,620,0.681,36,0.723,3.9,523,212,305,0.405,830,0.63,38,0.66,4.5,2017-18,Regular%20Season
203943,Noah Vonleh,1610612741,CHI,50,22,28,831.0,67,48,19,0.716,175,0.383,3,0.39,6.1,237,76,160,0.321,360,0.658,15,0.687,3.9,304,124,179,0.408,522,0.582,18,0.603,4.4,2017-18,Regular%20Season
1626181,Norman Powell,1610612761,TOR,55,42,13,935.0,13,6,7,0.462,66,0.197,6,0.217,16.2,105,18,85,0.171,173,0.607,14,0.66,6.3,118,24,92,0.203,230,0.513,20,0.562,7.4,2017-18,Regular%20Season
1628384,OG Anunoby,1610612761,TOR,65,45,20,1304.0,44,21,23,0.477,121,0.364,3,0.373,9.1,140,30,107,0.214,219,0.639,17,0.693,6.3,184,51,130,0.277,330,0.558,20,0.594,7.0,2017-18,Regular%20Season
1627855,Okaro White,1610612739,CLE,5,2,3,79.0,3,2,1,0.667,9,0.333,1,0.375,6.8,8,3,5,0.375,17,0.471,1,0.5,5.7,11,5,6,0.455,26,0.423,2,0.458,6.0,2017-18,Regular%20Season
204179,Omari Johnson,1610612763,MEM,4,1,3,75.0,4,3,1,0.75,8,0.5,1,0.571,6.0,7,1,6,0.143,20,0.35,2,0.389,8.3,11,4,7,0.364,28,0.393,3,0.44,7.5,2017-18,Regular%20Season
201600,Omer Asik,1610612741,CHI,16,5,11,177.0,9,5,4,0.556,19,0.474,0,0.474,5.8,38,10,28,0.263,68,0.559,9,0.644,4.5,47,15,32,0.319,84,0.56,9,0.627,4.8,2017-18,Regular%20Season
201956,Omri Casspi,1610612744,GSW,49,37,12,727.0,30,21,10,0.7,106,0.283,4,0.294,3.8,170,26,143,0.153,285,0.596,22,0.646,4.6,200,47,153,0.235,374,0.535,26,0.575,4.5,2017-18,Regular%20Season
203490,Otto Porter Jr.,1610612764,WAS,77,42,35,2432.0,103,61,41,0.592,323,0.319,15,0.334,8.8,389,88,298,0.226,638,0.61,34,0.644,6.6,492,149,339,0.303,932,0.528,49,0.557,7.0,2017-18,Regular%20Season
200782,P.J. Tucker,1610612745,HOU,81,64,17,2261.0,93,53,39,0.57,276,0.337,4,0.342,8.4,364,83,280,0.228,613,0.594,42,0.637,6.1,457,136,319,0.298,848,0.539,46,0.57,6.5,2017-18,Regular%20Season
1628408,PJ Dozier,1610612760,OKC,1,0,1,2.0,0,0,0,0.0,0,0.0,0,0.0,0.0,1,0,1,0.0,1,1.0,0,1.0,6.6,1,0,1,0.0,1,1.0,0,1.0,6.6,2017-18,Regular%20Season
1627783,Pascal Siakam,1610612761,TOR,80,58,22,1674.0,79,39,40,0.494,234,0.338,8,0.35,8.3,285,77,208,0.27,500,0.57,27,0.603,5.7,364,116,248,0.319,693,0.525,35,0.553,6.3,2017-18,Regular%20Season
1626192,Pat Connaughton,1610612757,POR,66,38,28,1256.0,36,15,21,0.417,107,0.336,6,0.356,12.8,125,19,106,0.152,218,0.573,22,0.638,8.1,161,34,127,0.211,317,0.508,28,0.557,9.2,2017-18,Regular%20Season
201976,Patrick Beverley,1610612746,LAC,11,5,6,334.0,16,4,12,0.25,48,0.333,3,0.356,11.6,29,6,22,0.207,51,0.569,1,0.58,7.6,45,10,34,0.222,98,0.459,4,0.479,9.1,2017-18,Regular%20Season
1627775,Patrick McCaw,1610612744,GSW,39,28,11,763.0,16,3,14,0.188,63,0.254,2,0.262,13.2,66,12,54,0.182,122,0.541,6,0.569,7.9,82,15,68,0.183,182,0.451,8,0.471,9.0,2017-18,Regular%20Season
202335,Patrick Patterson,1610612760,OKC,70,47,23,1117.0,31,17,15,0.548,91,0.341,3,0.352,9.7,155,47,108,0.303,288,0.538,17,0.572,5.8,186,64,123,0.344,372,0.5,20,0.528,6.4,2017-18,Regular%20Season
201988,Patty Mills,1610612759,SAS,69,38,31,1805.0,26,7,19,0.269,104,0.25,4,0.26,15.8,128,11,117,0.086,227,0.564,17,0.61,11.6,154,18,136,0.117,329,0.468,21,0.5,12.3,2017-18,Regular%20Season
2200,Pau Gasol,1610612759,SAS,77,45,32,1812.0,129,86,42,0.667,343,0.376,8,0.385,6.3,490,150,341,0.306,757,0.647,44,0.687,4.0,619,236,383,0.381,1057,0.586,52,0.616,4.5,2017-18,Regular%20Season
202331,Paul George,1610612760,OKC,78,47,31,2854.0,68,23,46,0.338,283,0.24,8,0.247,14.6,370,71,299,0.192,654,0.566,54,0.617,6.9,438,94,345,0.215,916,0.478,62,0.513,8.1,2017-18,Regular%20Season
200794,Paul Millsap,1610612743,DEN,36,21,15,1097.0,65,38,25,0.585,145,0.448,2,0.455,7.6,174,58,115,0.333,336,0.518,28,0.565,5.6,239,96,140,0.402,470,0.509,30,0.543,6.1,2017-18,Regular%20Season
1627835,Paul Zipser,1610612741,CHI,46,13,33,774.0,13,7,6,0.538,71,0.183,2,0.188,9.4,118,26,91,0.22,203,0.581,18,0.638,5.0,131,33,97,0.252,262,0.5,20,0.541,5.4,2017-18,Regular%20Season
203112,Quincy Acy,1610612751,BKN,62,23,39,1274.0,39,9,30,0.231,123,0.317,3,0.325,11.2,214,38,174,0.178,400,0.535,29,0.577,5.1,253,47,204,0.186,497,0.509,32,0.544,6.0,2017-18,Regular%20Season
202347,Quincy Pondexter,1610612741,CHI,17,3,14,168.0,8,6,2,0.75,21,0.381,0,0.381,7.2,19,2,17,0.105,38,0.5,6,0.594,7.9,27,8,19,0.296,57,0.474,6,0.529,7.7,2017-18,Regular%20Season
1626188,Quinn Cook,1610612744,GSW,27,17,10,716.0,10,2,8,0.2,56,0.179,1,0.182,25.1,72,9,63,0.125,150,0.48,13,0.526,8.0,82,11,71,0.134,203,0.404,14,0.434,10.1,2017-18,Regular%20Season
1626154,RJ Hunter,1610612745,HOU,2,0,2,31.0,0,0,0,0.0,1,0.0,0,0.0,0.0,5,2,3,0.4,6,0.833,1,1.0,7.8,5,2,3,0.4,7,0.714,1,0.833,7.8,2017-18,Regular%20Season
200765,Rajon Rondo,1610612740,NOP,63,39,24,1685.0,31,12,19,0.387,166,0.187,5,0.193,11.0,231,25,206,0.108,412,0.561,24,0.595,8.4,262,37,225,0.141,569,0.46,29,0.485,8.7,2017-18,Regular%20Season
201196,Ramon Sessions,1610612764,WAS,19,5,14,332.0,6,1,5,0.167,16,0.375,0,0.375,14.8,32,0,32,0.0,57,0.561,2,0.582,9.3,38,1,37,0.026,72,0.528,2,0.543,10.2,2017-18,Regular%20Season
1626173,Rashad Vaughn,1610612753,ORL,10,5,5,133.0,3,1,2,0.333,5,0.6,0,0.6,18.4,18,4,14,0.222,36,0.5,3,0.545,8.3,21,5,16,0.238,41,0.512,3,0.553,9.8,2017-18,Regular%20Season
203526,Raul Neto,1610612762,UTA,27,19,8,366.0,7,1,6,0.143,38,0.184,0,0.184,14.4,42,2,40,0.048,84,0.5,8,0.553,9.9,49,3,46,0.061,122,0.402,8,0.43,10.6,2017-18,Regular%20Season
101109,Raymond Felton,1610612760,OKC,65,37,28,1106.0,23,7,14,0.304,95,0.242,5,0.256,11.5,128,21,106,0.164,222,0.577,19,0.631,9.0,151,28,120,0.185,313,0.482,24,0.522,9.3,2017-18,Regular%20Season
203493,Reggie Bullock Jr.,1610612765,DET,51,27,24,1465.0,27,14,14,0.519,94,0.287,3,0.297,11.1,127,29,98,0.228,225,0.564,18,0.614,8.8,154,43,112,0.279,313,0.492,21,0.527,9.2,2017-18,Regular%20Season
202704,Reggie Jackson,1610612765,DET,39,22,17,1040.0,29,11,18,0.379,114,0.254,6,0.269,12.9,96,11,85,0.115,186,0.516,20,0.578,8.7,125,22,103,0.176,299,0.418,26,0.458,9.7,2017-18,Regular%20Season
2210,Richard Jefferson,1610612743,DEN,10,5,5,119.0,2,1,1,0.5,14,0.143,0,0.143,2.1,15,2,13,0.133,29,0.517,3,0.577,6.9,17,3,14,0.176,39,0.436,3,0.472,6.4,2017-18,Regular%20Season
1626158,Richaun Holmes,1610612755,PHI,46,29,17,727.0,57,35,22,0.614,170,0.335,5,0.345,8.7,150,50,99,0.333,268,0.56,17,0.598,4.5,207,85,121,0.411,421,0.492,22,0.519,5.7,2017-18,Regular%20Season
201937,Ricky Rubio,1610612762,UTA,72,43,29,2124.0,44,11,33,0.25,208,0.212,2,0.214,14.3,307,41,264,0.134,502,0.612,38,0.662,8.6,351,52,297,0.148,702,0.5,40,0.53,9.3,2017-18,Regular%20Season
203496,Robert Covington,1610612755,PHI,79,51,28,2501.0,54,20,34,0.37,195,0.277,10,0.292,11.2,376,95,280,0.253,699,0.538,60,0.588,6.9,430,115,314,0.267,875,0.491,70,0.534,7.4,2017-18,Regular%20Season
201577,Robin Lopez,1610612741,CHI,63,23,40,1678.0,131,93,34,0.71,351,0.373,6,0.38,5.1,156,58,98,0.372,343,0.455,56,0.544,5.8,287,151,132,0.526,681,0.421,62,0.464,5.5,2017-18,Regular%20Season
203918,Rodney Hood,1610612739,CLE,57,28,29,1552.0,22,5,17,0.227,91,0.242,2,0.247,13.7,143,14,128,0.098,256,0.559,20,0.606,8.6,165,19,145,0.115,334,0.494,22,0.529,9.3,2017-18,Regular%20Season
203585,Rodney McGruder,1610612748,MIA,13,7,6,258.0,11,4,7,0.364,34,0.324,1,0.333,7.4,22,1,20,0.045,47,0.468,3,0.5,6.2,33,5,27,0.152,81,0.407,4,0.429,6.6,2017-18,Regular%20Season
1628681,Rodney Purvis,1610612753,ORL,11,4,7,227.0,1,0,1,0.0,11,0.091,0,0.091,12.4,25,3,22,0.12,45,0.556,0,0.556,6.8,26,3,23,0.115,56,0.464,0,0.464,7.0,2017-18,Regular%20Season
1627758,Ron Baker,1610612752,NYK,17,8,9,243.0,5,1,4,0.2,16,0.313,1,0.333,16.9,24,4,20,0.167,49,0.49,2,0.511,9.9,29,5,24,0.172,64,0.453,3,0.475,11.1,2017-18,Regular%20Season
1626178,Rondae Hollis-Jefferson,1610612751,BKN,65,24,41,1842.0,99,63,36,0.636,321,0.308,9,0.317,6.2,348,94,251,0.27,618,0.563,52,0.615,4.9,447,157,287,0.351,891,0.502,61,0.539,5.2,2017-18,Regular%20Season
1626220,Royce O'Neale,1610612762,UTA,64,40,24,1126.0,25,10,16,0.4,82,0.305,2,0.313,8.4,211,62,146,0.294,328,0.643,25,0.696,5.3,236,72,162,0.305,399,0.591,27,0.634,5.7,2017-18,Regular%20Season
200752,Rudy Gay,1610612759,SAS,57,36,21,1231.0,76,42,30,0.553,186,0.409,5,0.42,7.3,215,52,163,0.242,397,0.542,33,0.591,5.1,291,94,193,0.323,562,0.518,38,0.555,5.7,2017-18,Regular%20Season
203497,Rudy Gobert,1610612762,UTA,56,37,19,1816.0,165,106,58,0.642,452,0.365,8,0.372,5.1,436,116,315,0.266,772,0.565,61,0.613,3.8,601,222,373,0.369,1187,0.506,69,0.538,4.1,2017-18,Regular%20Season
201566,Russell Westbrook,1610612760,OKC,78,47,31,2843.0,150,68,83,0.453,544,0.276,25,0.289,10.0,639,96,546,0.15,911,0.701,36,0.73,6.6,789,164,629,0.208,1373,0.575,61,0.601,7.3,2017-18,Regular%20Season
201583,Ryan Anderson,1610612745,HOU,65,51,14,1709.0,94,62,32,0.66,232,0.405,7,0.418,7.1,237,74,163,0.312,409,0.579,27,0.62,5.6,331,136,195,0.411,623,0.531,34,0.562,6.1,2017-18,Regular%20Season
1627853,Ryan Arcidiacono,1610612741,CHI,14,2,12,204.0,1,0,1,0.0,12,0.083,0,0.083,10.6,24,2,22,0.083,35,0.686,0,0.686,8.3,25,2,23,0.08,45,0.556,0,0.556,8.4,2017-18,Regular%20Season
1626257,Salah Mejri,1610612742,DAL,56,21,35,714.0,85,60,25,0.706,208,0.409,3,0.415,6.8,161,56,104,0.348,287,0.561,23,0.61,4.1,246,116,129,0.472,476,0.517,26,0.547,5.1,2017-18,Regular%20Season
1626155,Sam Dekker,1610612746,LAC,61,32,29,827.0,44,26,18,0.591,132,0.333,4,0.344,7.6,129,28,103,0.217,235,0.549,20,0.6,5.8,173,54,121,0.312,352,0.491,24,0.527,6.3,2017-18,Regular%20Season
203930,Sean Kilpatrick,1610612741,CHI,31,12,19,512.0,5,1,4,0.2,41,0.122,4,0.135,13.6,82,9,73,0.11,123,0.667,10,0.726,7.6,87,10,77,0.115,161,0.54,14,0.592,8.0,2017-18,Regular%20Season
1628400,Semi Ojeleye,1610612738,BOS,59,41,18,1064.0,36,12,24,0.333,97,0.371,2,0.379,12.4,124,39,85,0.315,225,0.551,17,0.596,7.7,160,51,109,0.319,304,0.526,19,0.561,8.7,2017-18,Regular%20Season
201586,Serge Ibaka,1610612761,TOR,76,53,23,2093.0,78,50,29,0.641,252,0.31,6,0.317,6.1,400,97,300,0.243,689,0.581,54,0.63,4.2,478,147,329,0.308,902,0.53,60,0.568,4.6,2017-18,Regular%20Season
203498,Shabazz Muhammad,1610612749,MIL,33,19,14,360.0,23,19,4,0.826,72,0.319,1,0.324,5.5,53,13,40,0.245,79,0.671,4,0.707,4.4,76,32,44,0.421,144,0.528,5,0.547,4.7,2017-18,Regular%20Season
203894,Shabazz Napier,1610612757,POR,65,42,23,1401.0,26,7,19,0.269,121,0.215,1,0.217,14.3,144,12,131,0.083,287,0.502,33,0.567,8.5,170,19,150,0.112,404,0.421,34,0.459,9.4,2017-18,Regular%20Season
203499,Shane Larkin,1610612738,BOS,38,24,14,620.0,15,5,10,0.333,52,0.288,3,0.306,11.3,75,11,64,0.147,126,0.595,7,0.63,8.4,90,16,74,0.178,177,0.508,10,0.539,8.9,2017-18,Regular%20Season
1627885,Shaquille Harrison,1610612756,PHX,20,2,18,353.0,9,3,6,0.333,53,0.17,1,0.173,9.1,52,10,42,0.192,86,0.605,3,0.627,8.9,61,13,48,0.213,139,0.439,4,0.452,9.0,2017-18,Regular%20Season
2733,Shaun Livingston,1610612744,GSW,61,41,20,991.0,32,11,21,0.344,80,0.4,5,0.427,10.1,99,21,78,0.212,189,0.524,15,0.569,8.6,131,32,99,0.244,266,0.492,20,0.533,9.1,2017-18,Regular%20Season
202714,Shelvin Mack,1610612753,ORL,60,20,40,1245.0,23,3,23,0.13,86,0.267,5,0.284,12.5,141,14,126,0.099,253,0.557,19,0.603,9.4,164,17,149,0.104,329,0.498,24,0.538,9.9,2017-18,Regular%20Season
1628414,Sindarius Thornwell,1610612746,LAC,54,23,31,962.0,31,8,22,0.258,105,0.295,2,0.301,11.4,105,32,74,0.305,199,0.528,22,0.593,7.5,136,40,96,0.294,300,0.453,24,0.493,8.4,2017-18,Regular%20Season
1627746,Skal Labissiere,1610612758,SAC,58,18,40,1227.0,98,68,29,0.694,244,0.402,6,0.412,5.9,189,52,133,0.275,355,0.532,32,0.585,5.4,287,120,162,0.418,584,0.491,38,0.526,5.6,2017-18,Regular%20Season
203524,Solomon Hill,1610612740,NOP,10,6,4,166.0,9,4,5,0.444,22,0.409,2,0.45,5.3,27,4,23,0.148,45,0.6,2,0.628,8.4,36,8,28,0.222,65,0.554,4,0.59,7.6,2017-18,Regular%20Season
203915,Spencer Dinwiddie,1610612751,BKN,72,26,46,2102.0,39,12,27,0.308,144,0.271,3,0.277,14.5,213,25,187,0.117,354,0.602,20,0.638,8.3,252,37,214,0.147,484,0.521,23,0.547,9.3,2017-18,Regular%20Season
1626169,Stanley Johnson,1610612765,DET,67,33,34,1864.0,33,21,13,0.636,132,0.25,3,0.256,9.6,219,39,179,0.178,392,0.559,33,0.61,7.4,252,60,192,0.238,515,0.489,36,0.526,7.7,2017-18,Regular%20Season
201939,Stephen Curry,1610612744,GSW,49,39,10,1599.0,36,11,25,0.306,148,0.243,4,0.25,13.2,225,38,187,0.169,406,0.554,33,0.603,8.5,261,49,212,0.188,550,0.475,37,0.509,9.1,2017-18,Regular%20Season
1628425,Sterling Brown,1610612749,MIL,43,22,21,683.0,27,10,17,0.37,62,0.435,1,0.443,13.2,116,22,91,0.19,192,0.604,17,0.663,5.9,143,32,108,0.224,251,0.57,18,0.614,7.3,2017-18,Regular%20Season
203500,Steven Adams,1610612760,OKC,75,43,32,2457.0,375,250,116,0.667,799,0.469,19,0.481,5.3,296,108,188,0.365,596,0.497,49,0.541,5.4,671,358,304,0.534,1375,0.488,68,0.513,5.4,2017-18,Regular%20Season
1628388,T.J. Leaf,1610612754,IND,41,22,19,399.0,29,16,13,0.552,73,0.397,2,0.408,7.5,51,12,37,0.235,97,0.526,10,0.586,5.7,80,28,50,0.35,167,0.479,12,0.516,6.4,2017-18,Regular%20Season
204456,T.J. McConnell,1610612755,PHI,64,42,22,1501.0,37,13,26,0.351,131,0.282,3,0.289,14.4,185,20,162,0.108,306,0.605,16,0.638,9.1,222,33,188,0.149,425,0.522,19,0.547,10.0,2017-18,Regular%20Season
203933,T.J. Warren,1610612756,PHX,64,17,47,2112.0,125,81,45,0.648,321,0.389,8,0.399,6.3,208,58,147,0.279,362,0.575,21,0.61,8.3,333,139,192,0.417,659,0.505,29,0.529,7.6,2017-18,Regular%20Season
201959,Taj Gibson,1610612750,MIN,82,47,35,2726.0,194,128,66,0.66,511,0.38,17,0.393,6.6,390,90,299,0.231,717,0.544,44,0.579,5.6,584,218,365,0.373,1187,0.492,61,0.519,5.9,2017-18,Regular%20Season
204028,Tarik Black,1610612745,HOU,45,34,11,517.0,63,44,18,0.698,152,0.414,2,0.42,5.4,100,25,74,0.25,171,0.585,13,0.633,5.1,163,69,92,0.423,306,0.533,15,0.56,5.2,2017-18,Regular%20Season
1627752,Taurean Prince,1610612737,ATL,80,23,57,2409.0,49,15,35,0.306,181,0.271,6,0.28,13.1,335,67,267,0.2,567,0.591,49,0.647,6.4,384,82,302,0.214,734,0.523,55,0.566,7.3,2017-18,Regular%20Season
1628390,Terrance Ferguson,1610612760,OKC,28,17,11,502.0,19,8,12,0.421,33,0.576,3,0.633,14.6,27,8,19,0.296,63,0.429,4,0.458,9.9,46,16,31,0.348,96,0.479,7,0.517,12.3,2017-18,Regular%20Season
203082,Terrence Ross,1610612753,ORL,21,10,11,542.0,10,2,8,0.2,40,0.25,1,0.256,16.4,63,9,52,0.143,107,0.589,7,0.63,8.0,73,11,60,0.151,143,0.51,8,0.541,9.2,2017-18,Regular%20Season
1626179,Terry Rozier,1610612738,BOS,76,51,25,1981.0,61,30,32,0.492,185,0.33,7,0.343,10.5,299,55,244,0.184,524,0.571,46,0.626,7.2,360,85,276,0.236,703,0.512,53,0.554,7.7,2017-18,Regular%20Season
200757,Thabo Sefolosha,1610612762,UTA,35,15,20,767.0,29,10,18,0.345,90,0.322,4,0.337,10.8,132,35,97,0.265,216,0.611,15,0.657,5.9,161,45,115,0.28,294,0.548,19,0.585,6.7,2017-18,Regular%20Season
201152,Thaddeus Young,1610612754,IND,80,47,33,2571.0,184,119,65,0.647,447,0.412,5,0.416,5.3,328,80,249,0.244,587,0.559,43,0.603,6.6,512,199,314,0.389,1008,0.508,48,0.533,6.2,2017-18,Regular%20Season
1628418,Thomas Bryant,1610612747,LAL,7,3,4,54.0,3,1,2,0.333,9,0.333,1,0.375,10.4,14,5,9,0.357,20,0.7,1,0.737,4.5,17,6,11,0.353,26,0.654,2,0.708,5.5,2017-18,Regular%20Season
1627748,Thon Maker,1610612749,MIL,70,38,32,1205.0,74,40,33,0.541,195,0.379,3,0.385,7.3,148,45,103,0.304,336,0.44,35,0.492,6.2,222,85,136,0.383,509,0.436,38,0.471,6.6,2017-18,Regular%20Season
204025,Tim Frazier,1610612764,WAS,42,18,24,682.0,18,6,12,0.333,69,0.261,1,0.265,13.2,95,10,86,0.105,178,0.534,19,0.597,8.8,113,16,98,0.142,240,0.471,20,0.514,9.5,2017-18,Regular%20Season
203501,Tim Hardaway Jr.,1610612752,NYK,55,18,37,1827.0,32,13,20,0.406,180,0.178,5,0.183,13.1,192,20,168,0.104,340,0.565,26,0.611,8.3,224,33,188,0.147,505,0.444,31,0.473,9.0,2017-18,Regular%20Season
1627817,Tim Quarterman,1610612745,HOU,3,2,1,13.0,0,0,0,0.0,1,0.0,0,0.0,0.0,3,2,1,0.667,3,1.0,0,1.0,6.1,3,2,1,0.667,4,0.75,0,0.75,6.1,2017-18,Regular%20Season
202389,Timofey Mozgov,1610612751,BKN,24,8,16,313.0,31,20,11,0.645,71,0.437,1,0.443,5.2,63,22,42,0.349,110,0.573,11,0.636,4.2,94,42,53,0.447,178,0.528,12,0.566,4.5,2017-18,Regular%20Season
1627789,Timothe Luwawu-Cabarrot,1610612755,PHI,36,19,17,660.0,14,7,8,0.5,72,0.194,3,0.203,9.1,58,9,50,0.155,129,0.45,9,0.483,8.5,72,16,58,0.222,198,0.364,12,0.387,8.6,2017-18,Regular%20Season
202699,Tobias Harris,1610612746,LAC,79,38,41,2631.0,58,32,24,0.552,239,0.243,7,0.25,8.0,376,86,290,0.229,689,0.546,54,0.592,5.9,434,118,314,0.272,902,0.481,61,0.516,6.2,2017-18,Regular%20Season
203107,Tomas Satoransky,1610612764,WAS,65,34,31,1571.0,72,39,33,0.542,202,0.356,8,0.371,9.9,161,26,131,0.161,286,0.563,19,0.603,9.1,233,65,164,0.279,480,0.485,27,0.514,9.4,2017-18,Regular%20Season
2754,Tony Allen,1610612740,NOP,17,7,10,230.0,20,10,9,0.5,55,0.364,0,0.364,5.9,27,4,23,0.148,41,0.659,0,0.659,6.2,47,14,32,0.298,92,0.511,0,0.511,6.1,2017-18,Regular%20Season
1628396,Tony Bradley,1610612762,UTA,7,4,3,26.0,4,3,1,0.75,6,0.667,0,0.667,3.2,7,3,4,0.429,13,0.538,2,0.636,3.4,11,6,5,0.545,18,0.611,2,0.688,3.4,2017-18,Regular%20Season
2225,Tony Parker,1610612759,SAS,40,22,18,778.0,6,2,4,0.333,53,0.113,2,0.118,14.7,88,9,79,0.102,138,0.638,11,0.693,10.0,94,11,83,0.117,189,0.497,13,0.534,10.3,2017-18,Regular%20Season
203503,Tony Snell,1610612749,MIL,61,37,24,1744.0,9,1,9,0.111,49,0.184,1,0.188,15.9,131,17,114,0.13,268,0.489,22,0.533,8.9,140,18,123,0.129,312,0.449,23,0.484,9.4,2017-18,Regular%20Season
1628470,Torrey Craig,1610612743,DEN,36,22,14,609.0,40,24,14,0.6,109,0.367,2,0.374,8.3,87,20,67,0.23,157,0.554,14,0.608,6.1,127,44,81,0.346,253,0.502,16,0.536,6.8,2017-18,Regular%20Season
204037,Travis Wear,1610612747,LAL,14,6,8,209.0,0,0,0,0.0,12,0.0,1,0.0,0.0,36,13,23,0.361,61,0.59,7,0.667,6.6,36,13,23,0.361,69,0.522,8,0.59,6.6,2017-18,Regular%20Season
1626203,Treveon Graham,1610612766,CHA,54,25,29,950.0,42,30,12,0.714,110,0.382,3,0.393,5.5,79,18,61,0.228,177,0.446,16,0.491,8.6,121,48,73,0.397,282,0.429,19,0.46,7.5,2017-18,Regular%20Season
2772,Trevor Ariza,1610612745,HOU,66,50,16,2269.0,33,17,16,0.515,173,0.191,7,0.199,11.1,261,47,213,0.18,419,0.623,32,0.674,7.2,294,64,229,0.218,570,0.516,39,0.554,7.6,2017-18,Regular%20Season
202344,Trevor Booker,1610612754,IND,65,34,31,1132.0,117,74,39,0.632,289,0.405,8,0.416,5.3,200,56,141,0.28,370,0.541,30,0.588,5.2,317,130,180,0.41,645,0.491,38,0.522,5.2,2017-18,Regular%20Season
203504,Trey Burke,1610612752,NYK,30,9,21,694.0,13,3,10,0.231,37,0.351,2,0.371,14.1,58,6,51,0.103,111,0.523,8,0.563,9.9,71,9,61,0.127,145,0.49,10,0.526,10.7,2017-18,Regular%20Season
1626168,Trey Lyles,1610612743,DEN,65,36,29,1335.0,55,42,12,0.764,177,0.311,2,0.314,6.4,290,73,217,0.252,468,0.62,28,0.659,4.6,345,115,229,0.333,617,0.559,30,0.588,4.9,2017-18,Regular%20Season
202684,Tristan Thompson,1610612739,CLE,49,24,25,1021.0,126,91,31,0.722,289,0.436,8,0.448,5.0,225,33,190,0.147,374,0.602,26,0.647,5.4,351,124,221,0.353,651,0.539,34,0.569,5.3,2017-18,Regular%20Season
203584,Troy Daniels,1610612756,PHX,58,15,43,1263.0,12,6,6,0.5,62,0.194,3,0.203,16.8,115,21,93,0.183,213,0.54,19,0.593,7.3,127,27,99,0.213,270,0.47,22,0.512,8.2,2017-18,Regular%20Season
1627786,Troy Williams,1610612752,NYK,18,4,14,287.0,22,10,12,0.455,56,0.393,1,0.4,6.8,41,8,32,0.195,61,0.672,2,0.695,5.6,63,18,44,0.286,113,0.558,3,0.573,6.0,2017-18,Regular%20Season
1628463,Tyler Cavanaugh,1610612737,ATL,34,11,23,478.0,44,30,13,0.682,114,0.386,2,0.393,4.9,80,19,61,0.238,143,0.559,8,0.593,4.9,124,49,74,0.395,246,0.504,10,0.525,4.9,2017-18,Regular%20Season
1628416,Tyler Dorsey,1610612737,ATL,47,13,34,888.0,17,4,13,0.235,92,0.185,6,0.198,13.3,113,13,99,0.115,202,0.559,16,0.608,7.2,130,17,112,0.131,290,0.448,22,0.485,8.0,2017-18,Regular%20Season
203898,Tyler Ennis,1610612747,LAL,43,17,26,633.0,18,5,13,0.278,68,0.265,3,0.277,8.2,76,10,66,0.132,123,0.618,5,0.644,7.9,94,15,79,0.16,186,0.505,8,0.528,7.9,2017-18,Regular%20Season
204020,Tyler Johnson,1610612748,MIA,69,37,32,1979.0,34,15,19,0.441,129,0.264,5,0.274,12.2,210,43,167,0.205,408,0.515,37,0.566,7.4,244,58,186,0.238,532,0.459,42,0.498,8.1,2017-18,Regular%20Season
1627755,Tyler Ulis,1610612756,PHX,52,16,36,1327.0,24,2,22,0.083,112,0.214,1,0.216,17.6,104,11,94,0.106,190,0.547,14,0.591,11.3,128,13,116,0.102,299,0.428,15,0.451,12.5,2017-18,Regular%20Season
203092,Tyler Zeller,1610612749,MIL,63,25,38,1060.0,107,61,42,0.57,252,0.425,4,0.431,6.5,183,48,133,0.262,334,0.548,29,0.6,4.9,290,109,175,0.376,575,0.504,33,0.535,5.5,2017-18,Regular%20Season
201936,Tyreke Evans,1610612763,MEM,52,19,33,1607.0,44,29,15,0.659,213,0.207,10,0.217,6.8,221,42,177,0.19,380,0.582,23,0.619,7.6,265,71,192,0.268,578,0.458,33,0.486,7.5,2017-18,Regular%20Season
1627820,Tyrone Wallace,1610612746,LAC,28,16,12,814.0,21,9,11,0.429,92,0.228,4,0.239,12.3,84,13,72,0.155,140,0.6,11,0.651,8.6,105,22,83,0.21,221,0.475,15,0.51,9.3,2017-18,Regular%20Season
2199,Tyson Chandler,1610612756,PHX,45,15,30,1141.0,134,87,46,0.649,268,0.5,7,0.513,4.9,284,81,205,0.285,471,0.603,32,0.647,4.2,418,168,251,0.402,719,0.581,39,0.615,4.4,2017-18,Regular%20Season
1626145,Tyus Jones,1610612750,MIN,61,38,23,1164.0,16,3,13,0.188,63,0.254,1,0.258,17.4,116,13,102,0.112,206,0.563,19,0.62,9.6,132,16,115,0.121,267,0.494,20,0.534,10.5,2017-18,Regular%20Season
2617,Udonis Haslem,1610612748,MIA,9,6,3,56.0,3,1,1,0.333,4,0.75,0,0.75,8.4,7,0,7,0.0,15,0.467,1,0.5,5.0,10,1,8,0.1,18,0.556,1,0.588,5.8,2017-18,Regular%20Season
203505,Vander Blue,1610612747,LAL,1,0,1,14.0,0,0,0,0.0,1,0.0,0,0.0,0.0,1,0,1,0.0,1,1.0,0,1.0,7.2,1,0,1,0.0,2,0.5,0,0.5,7.2,2017-18,Regular%20Season
203506,Victor Oladipo,1610612754,IND,75,48,27,2552.0,47,25,22,0.532,234,0.201,11,0.211,11.1,343,74,272,0.216,624,0.55,48,0.595,6.7,390,99,294,0.254,850,0.459,59,0.493,7.2,2017-18,Regular%20Season
1713,Vince Carter,1610612758,SAC,52,20,32,969.0,18,12,6,0.667,83,0.217,2,0.222,6.0,130,30,99,0.231,253,0.514,18,0.553,5.4,148,42,105,0.284,319,0.464,20,0.495,5.5,2017-18,Regular%20Season
1626205,Vincent Hunter,1610612763,MEM,2,0,2,5.0,2,2,0,1.0,2,1.0,0,1.0,2.9,1,1,0,1.0,2,0.5,0,0.5,5.7,3,3,0,1.0,4,0.75,0,0.75,3.9,2017-18,Regular%20Season
1627735,Wade Baldwin IV,1610612757,POR,4,2,2,68.0,1,0,1,0.0,3,0.333,0,0.333,28.9,7,0,7,0.0,11,0.636,1,0.7,7.6,8,0,8,0.0,14,0.571,1,0.615,10.3,2017-18,Regular%20Season
1627215,Walt Lemon Jr.,1610612740,NOP,1,1,0,9.0,0,0,0,0.0,1,0.0,0,0.0,0.0,1,0,1,0.0,1,1.0,0,1.0,13.5,1,0,1,0.0,2,0.5,0,0.5,13.5,2017-18,Regular%20Season
201961,Wayne Ellington,1610612748,MIA,70,40,30,1914.0,22,4,18,0.182,72,0.306,2,0.314,14.6,193,21,171,0.109,329,0.587,24,0.633,8.4,215,25,189,0.116,396,0.543,26,0.581,9.0,2017-18,Regular%20Season
1627782,Wayne Selden,1610612763,MEM,27,8,19,577.0,16,2,14,0.125,53,0.302,4,0.327,17.5,40,11,29,0.275,65,0.615,2,0.635,10.8,56,13,43,0.232,117,0.479,6,0.505,12.7,2017-18,Regular%20Season
1628411,Wes Iwundu,1610612753,ORL,49,15,34,893.0,36,17,19,0.472,90,0.4,1,0.404,10.5,99,26,74,0.263,201,0.493,31,0.582,4.7,135,43,93,0.319,290,0.466,32,0.523,6.3,2017-18,Regular%20Season
202325,Wesley Johnson,1610612746,LAC,64,34,30,1394.0,29,7,21,0.241,77,0.377,4,0.397,14.3,187,38,148,0.203,346,0.54,22,0.577,7.2,216,45,169,0.208,407,0.531,26,0.567,8.1,2017-18,Regular%20Season
202083,Wesley Matthews,1610612742,DAL,62,19,43,2100.0,28,15,15,0.536,107,0.262,4,0.272,13.8,170,25,145,0.147,289,0.588,22,0.637,9.0,198,40,160,0.202,387,0.512,26,0.548,9.7,2017-18,Regular%20Season
203115,Will Barton,1610612743,DEN,79,45,34,2625.0,69,22,48,0.319,293,0.235,8,0.242,9.8,335,51,286,0.152,583,0.575,49,0.627,5.8,404,73,334,0.181,840,0.481,57,0.516,6.4,2017-18,Regular%20Season
1626161,Willie Cauley-Stein,1610612758,SAC,72,23,49,2035.0,131,81,51,0.618,355,0.369,6,0.375,6.6,379,90,289,0.237,645,0.588,34,0.62,4.7,510,171,340,0.335,954,0.535,40,0.558,5.2,2017-18,Regular%20Season
203186,Willie Reed,1610612765,DET,34,18,16,401.0,35,24,10,0.686,118,0.297,2,0.302,5.4,86,21,65,0.244,167,0.515,12,0.555,4.8,121,45,75,0.372,274,0.442,14,0.465,5.0,2017-18,Regular%20Season
1626195,Willy Hernangomez,1610612766,CHA,38,15,23,463.0,61,43,18,0.705,151,0.404,1,0.407,6.4,122,33,86,0.27,194,0.629,19,0.697,4.1,183,76,104,0.415,325,0.563,20,0.6,4.9,2017-18,Regular%20Season
201163,Wilson Chandler,1610612743,DEN,72,40,32,2305.0,102,62,40,0.608,276,0.37,4,0.375,7.4,296,62,233,0.209,460,0.643,28,0.685,7.1,398,124,273,0.312,706,0.564,32,0.591,7.2,2017-18,Regular%20Season
204098,Xavier Munford,1610612749,MIL,1,0,1,2.0,1,0,1,0.0,1,1.0,0,1.0,21.5,0,0,0,0.0,0,0.0,0,0.0,0.0,1,0,1,0.0,1,1.0,0,1.0,21.5,2017-18,Regular%20Season
1628504,Xavier Rathan-Mayes,1610612763,MEM,4,0,4,92.0,0,0,0,0.0,2,0.0,0,0.0,0.0,5,0,5,0.0,10,0.5,0,0.5,10.0,5,0,5,0.0,12,0.417,0,0.417,10.0,2017-18,Regular%20Season
202918,Xavier Silas,1610612738,BOS,1,0,1,7.0,1,0,1,0.0,2,0.5,0,0.5,6.2,1,0,1,0.0,2,0.5,0,0.5,5.9,2,0,2,0.0,3,0.667,0,0.667,6.1,2017-18,Regular%20Season
1627812,Yogi Ferrell,1610612742,DAL,78,24,54,2190.0,26,5,22,0.192,141,0.184,5,0.191,14.7,223,37,184,0.166,438,0.509,38,0.558,8.1,249,42,206,0.169,566,0.44,43,0.476,8.8,2017-18,Regular%20Season
1628380,Zach Collins,1610612757,POR,62,39,23,1032.0,45,26,17,0.578,129,0.349,6,0.366,6.5,176,51,125,0.29,309,0.57,18,0.605,5.1,221,77,142,0.348,421,0.525,24,0.557,5.4,2017-18,Regular%20Season
203897,Zach LaVine,1610612741,CHI,20,8,12,561.0,8,4,4,0.5,57,0.14,1,0.143,6.2,80,13,68,0.163,119,0.672,4,0.696,7.1,88,17,72,0.193,171,0.515,5,0.53,7.0,2017-18,Regular%20Season
2216,Zach Randolph,1610612758,SAC,59,18,41,1508.0,97,74,20,0.763,261,0.372,3,0.376,5.4,300,76,223,0.253,474,0.633,35,0.683,4.3,397,150,243,0.378,720,0.551,38,0.582,4.6,2017-18,Regular%20Season
2585,Zaza Pachulia,1610612744,GSW,65,44,21,947.0,88,55,32,0.625,229,0.384,7,0.396,6.8,232,63,170,0.272,406,0.571,28,0.614,4.3,320,118,202,0.369,622,0.514,35,0.545,5.0,2017-18,Regular%20Season
1627753,Zhou Qi,1610612745,HOU,14,11,3,112.0,6,3,2,0.5,21,0.286,0,0.286,6.6,16,7,9,0.438,33,0.485,2,0.516,4.7,22,10,11,0.455,51,0.431,2,0.449,5.1,2017-18,Regular%20Season
1628935,Aaron Jackson,1610612745,HOU,3,2,1,10.0,2,0,2,0.0,3,0.667,0,0.667,10.5,2,0,2,0.0,3,0.667,0,0.667,5.7,4,0,4,0.0,6,0.667,0,0.667,8.1,2017-18,Playoffs
1627846,Abdel Nader,1610612738,BOS,2,0,2,19.0,1,0,1,0.0,3,0.333,0,0.333,8.8,2,0,2,0.0,4,0.5,0,0.5,10.2,3,0,3,0.0,6,0.5,0,0.5,9.7,2017-18,Playoffs
201143,Al Horford,1610612738,BOS,19,11,8,679.0,32,24,8,0.75,86,0.372,2,0.381,7.4,125,31,94,0.248,194,0.644,10,0.679,6.3,157,55,102,0.35,268,0.586,12,0.613,6.5,2017-18,Playoffs
202329,Al-Farouq Aminu,1610612757,POR,4,0,4,131.0,12,6,6,0.5,19,0.632,0,0.632,9.3,24,2,22,0.083,38,0.632,6,0.75,4.8,36,8,28,0.222,56,0.643,6,0.72,6.3,2017-18,Playoffs
202692,Alec Burks,1610612762,UTA,7,2,5,117.0,2,2,0,1.0,17,0.118,0,0.118,4.6,22,2,20,0.091,42,0.524,4,0.579,5.9,24,4,20,0.167,58,0.414,4,0.444,5.8,2017-18,Playoffs
203518,Alex Abrines,1610612760,OKC,4,2,2,82.0,3,1,2,0.333,9,0.333,0,0.333,19.9,13,1,11,0.077,17,0.765,3,0.929,10.8,16,2,13,0.125,24,0.667,3,0.762,12.6,2017-18,Playoffs
101161,Amir Johnson,1610612755,PHI,7,4,3,89.0,14,10,4,0.714,34,0.412,2,0.438,3.3,9,6,4,0.667,19,0.474,3,0.563,5.4,23,16,8,0.696,52,0.442,5,0.489,4.3,2017-18,Playoffs
2738,Andre Iguodala,1610612744,GSW,15,12,3,401.0,11,5,6,0.455,35,0.314,1,0.324,11.4,57,13,44,0.228,100,0.57,4,0.594,7.3,68,18,50,0.265,129,0.527,5,0.548,8.0,2017-18,Playoffs
203952,Andrew Wiggins,1610612750,MIN,5,1,4,164.0,5,2,3,0.4,20,0.25,1,0.263,12.1,21,5,16,0.238,43,0.488,6,0.568,5.1,26,7,19,0.269,63,0.413,7,0.464,6.5,2017-18,Playoffs
1627790,Ante Zizic,1610612739,CLE,4,2,2,13.0,1,1,0,1.0,3,0.333,0,0.333,2.1,5,2,3,0.4,6,0.833,0,0.833,3.2,6,3,3,0.5,9,0.667,0,0.667,3.0,2017-18,Playoffs
203076,Anthony Davis,1610612740,NOP,9,5,4,358.0,24,23,3,0.958,60,0.4,2,0.414,3.3,97,30,67,0.309,148,0.655,11,0.708,4.8,121,53,70,0.438,208,0.582,13,0.621,4.5,2017-18,Playoffs
203382,Aron Baynes,1610612738,BOS,19,11,8,389.0,45,31,14,0.689,97,0.464,0,0.464,5.7,73,25,50,0.342,138,0.529,11,0.575,5.5,118,56,64,0.475,232,0.509,11,0.534,5.6,2017-18,Playoffs
1628389,Bam Adebayo,1610612748,MIA,5,1,4,77.0,9,7,2,0.778,21,0.429,0,0.429,5.8,11,1,10,0.091,25,0.44,2,0.478,5.6,20,8,12,0.4,41,0.488,2,0.513,5.7,2017-18,Playoffs
1627732,Ben Simmons,1610612755,PHI,10,5,5,369.0,16,5,11,0.313,60,0.267,1,0.271,6.8,78,12,66,0.154,104,0.75,0,0.75,7.2,94,17,77,0.181,153,0.614,1,0.618,7.1,2017-18,Playoffs
202711,Bojan Bogdanovic,1610612754,IND,6,3,3,201.0,1,1,0,1.0,19,0.053,0,0.053,10.0,23,6,17,0.261,30,0.767,2,0.821,5.8,24,7,17,0.292,46,0.522,2,0.545,5.9,2017-18,Playoffs
203078,Bradley Beal,1610612764,WAS,6,2,4,216.0,2,1,1,0.5,19,0.105,0,0.105,9.4,18,5,12,0.278,36,0.5,2,0.529,5.4,20,6,13,0.3,54,0.37,2,0.385,5.8,2017-18,Playoffs
203464,Brandon Paul,1610612759,SAS,1,0,1,3.0,0,0,0,0.0,0,0.0,0,0.0,0.0,1,0,1,0.0,1,1.0,0,1.0,10.6,1,0,1,0.0,1,1.0,0,1.0,10.6,2017-18,Playoffs
1627854,Bryn Forbes,1610612759,SAS,1,0,1,25.0,1,0,1,0.0,1,1.0,0,1.0,10.9,2,1,1,0.5,2,1.0,0,1.0,15.6,3,1,2,0.333,3,1.0,0,1.0,14.0,2017-18,Playoffs
203468,CJ McCollum,1610612757,POR,4,0,4,155.0,0,0,0,0.0,9,0.0,2,0.0,0.0,8,0,8,0.0,18,0.444,3,0.533,10.3,8,0,8,0.0,26,0.308,5,0.381,10.3,2017-18,Playoffs
101139,CJ Miles,1610612761,TOR,8,3,5,188.0,6,3,3,0.5,13,0.462,2,0.545,6.1,18,2,16,0.111,30,0.6,2,0.643,7.3,24,5,19,0.208,43,0.558,4,0.615,7.0,2017-18,Playoffs
1628403,Caleb Swanigan,1610612757,POR,1,0,1,8.0,0,0,0,0.0,0,0.0,0,0.0,0.0,2,1,1,0.5,3,0.667,0,0.667,4.8,2,1,1,0.5,3,0.667,0,0.667,4.8,2017-18,Playoffs
2546,Carmelo Anthony,1610612760,OKC,6,2,4,194.0,3,0,2,0.0,22,0.136,0,0.136,15.9,31,12,20,0.387,61,0.508,2,0.525,6.1,34,12,22,0.353,77,0.442,2,0.453,6.6,2017-18,Playoffs
1626224,Cedi Osman,1610612739,CLE,5,2,3,35.0,1,0,1,0.0,6,0.167,0,0.167,10.6,6,0,6,0.0,9,0.667,0,0.667,10.4,7,0,7,0.0,12,0.583,0,0.583,10.4,2017-18,Playoffs
1627767,Cheick Diallo,1610612740,NOP,5,3,2,41.0,4,1,3,0.25,12,0.333,0,0.333,10.5,5,1,4,0.2,15,0.333,1,0.357,4.8,9,2,7,0.222,26,0.346,1,0.36,7.3,2017-18,Playoffs
1627778,Chinanu Onuaku,1610612745,HOU,1,1,0,3.0,1,1,0,1.0,2,0.5,0,0.5,1.2,0,0,0,0.0,1,0.0,1,0.0,0.0,1,1,0,1.0,3,0.333,1,0.5,1.2,2017-18,Playoffs
101108,Chris Paul,1610612745,HOU,15,11,4,517.0,9,5,4,0.556,52,0.173,0,0.173,13.5,80,10,70,0.125,135,0.593,12,0.65,7.2,89,15,74,0.169,186,0.478,12,0.511,7.8,2017-18,Playoffs
203991,Clint Capela,1610612745,HOU,17,11,6,520.0,61,44,16,0.721,145,0.421,4,0.433,5.3,136,28,108,0.206,205,0.663,16,0.72,4.3,197,72,124,0.365,340,0.579,20,0.616,4.6,2017-18,Playoffs
201147,Corey Brewer,1610612760,OKC,4,2,2,114.0,4,1,3,0.25,13,0.308,0,0.308,12.0,9,1,8,0.111,19,0.474,3,0.563,11.0,13,2,11,0.154,31,0.419,3,0.464,11.3,2017-18,Playoffs
202709,Cory Joseph,1610612754,IND,6,2,4,124.0,2,0,2,0.0,5,0.4,0,0.4,20.4,15,1,14,0.067,18,0.833,2,0.938,8.7,17,1,16,0.059,23,0.739,2,0.81,10.1,2017-18,Playoffs
1627745,Damian Jones,1610612744,GSW,2,2,0,7.0,1,1,0,1.0,1,1.0,0,1.0,4.3,2,0,2,0.0,2,1.0,0,1.0,9.4,3,1,2,0.333,3,1.0,0,1.0,7.7,2017-18,Playoffs
203081,Damian Lillard,1610612757,POR,4,0,4,162.0,3,0,3,0.0,18,0.167,1,0.176,19.3,15,3,12,0.2,25,0.6,1,0.625,9.3,18,3,15,0.167,43,0.419,2,0.439,10.9,2017-18,Playoffs
201980,Danny Green,1610612759,SAS,5,1,4,103.0,4,0,4,0.0,14,0.286,1,0.308,17.8,7,0,7,0.0,12,0.583,1,0.636,5.5,11,0,11,0.0,26,0.423,2,0.458,10.0,2017-18,Playoffs
203957,Dante Exum,1610612762,UTA,7,4,3,98.0,4,1,3,0.25,13,0.308,0,0.308,11.6,10,2,8,0.2,21,0.476,5,0.625,10.2,14,3,11,0.214,33,0.424,5,0.5,10.6,2017-18,Playoffs
203967,Dario Saric,1610612755,PHI,10,5,5,328.0,32,19,12,0.594,77,0.416,6,0.451,10.3,41,15,26,0.366,88,0.466,12,0.539,5.2,73,34,38,0.466,161,0.453,18,0.51,7.4,2017-18,Playoffs
203121,Darius Miller,1610612740,NOP,8,5,3,145.0,2,0,2,0.0,7,0.286,0,0.286,11.4,18,5,12,0.278,27,0.667,1,0.692,6.1,20,5,14,0.25,33,0.606,1,0.625,6.6,2017-18,Playoffs
201954,Darren Collison,1610612754,IND,7,3,4,214.0,1,0,1,0.0,9,0.111,0,0.111,7.6,20,4,16,0.2,34,0.588,2,0.625,12.2,21,4,17,0.19,41,0.512,2,0.538,12.0,2017-18,Playoffs
204065,David Stockton,1610612762,UTA,1,0,1,4.0,0,0,0,0.0,0,0.0,0,0.0,0.0,1,1,0,1.0,2,0.5,0,0.5,8.7,1,1,0,1.0,2,0.5,0,0.5,8.7,2017-18,Playoffs
2561,David West,1610612744,GSW,13,11,2,145.0,11,8,3,0.727,29,0.379,1,0.393,7.0,26,9,16,0.346,41,0.634,5,0.722,4.9,37,17,19,0.459,70,0.529,6,0.578,5.6,2017-18,Playoffs
202722,Davis Bertans,1610612759,SAS,4,0,4,80.0,1,0,1,0.0,4,0.25,0,0.25,24.5,10,5,5,0.5,14,0.714,1,0.769,5.0,11,5,6,0.455,18,0.611,1,0.647,6.8,2017-18,Playoffs
202732,DeAndre Liggins,1610612740,NOP,1,0,1,4.0,0,0,0,0.0,0,0.0,0,0.0,0.0,1,0,1,0.0,2,0.5,0,0.5,5.5,1,0,1,0.0,2,0.5,0,0.5,5.5,2017-18,Playoffs
201942,DeMar DeRozan,1610612761,TOR,9,4,5,319.0,6,3,3,0.5,26,0.231,3,0.261,10.1,30,4,26,0.133,61,0.492,5,0.536,7.6,36,7,29,0.194,86,0.419,8,0.462,8.0,2017-18,Playoffs
1627749,Dejounte Murray,1610612759,SAS,5,1,4,96.0,4,2,2,0.5,12,0.333,1,0.364,8.3,17,2,15,0.118,33,0.515,3,0.567,3.8,21,4,17,0.19,44,0.477,4,0.525,4.6,2017-18,Playoffs
1626153,Delon Wright,1610612761,TOR,9,4,5,199.0,3,1,2,0.333,22,0.136,0,0.136,6.1,19,1,18,0.053,39,0.487,1,0.5,8.0,22,2,20,0.091,61,0.361,1,0.367,7.7,2017-18,Playoffs
202324,Derrick Favors,1610612762,UTA,11,5,6,286.0,20,17,3,0.85,50,0.4,3,0.426,4.9,37,12,25,0.324,85,0.435,2,0.446,5.6,57,29,28,0.509,133,0.429,5,0.445,5.4,2017-18,Playoffs
201565,Derrick Rose,1610612750,MIN,3,0,3,74.0,1,1,0,1.0,5,0.2,0,0.2,12.5,8,1,7,0.125,14,0.571,1,0.615,9.9,9,2,7,0.222,19,0.474,1,0.5,10.2,2017-18,Playoffs
1627734,Domantas Sabonis,1610612754,IND,7,3,4,166.0,14,10,4,0.714,41,0.341,1,0.35,4.4,18,3,15,0.167,35,0.514,1,0.529,4.2,32,13,19,0.406,73,0.438,2,0.451,4.3,2017-18,Playoffs
1628378,Donovan Mitchell,1610612762,UTA,11,5,6,411.0,9,8,1,0.889,59,0.153,2,0.158,3.7,56,9,46,0.161,99,0.566,4,0.589,7.7,65,17,47,0.262,157,0.414,6,0.43,7.1,2017-18,Playoffs
203110,Draymond Green,1610612744,GSW,21,16,5,819.0,42,24,17,0.571,102,0.412,3,0.424,6.1,180,68,111,0.378,329,0.547,20,0.583,4.9,222,92,128,0.414,412,0.539,23,0.571,5.1,2017-18,Playoffs
2548,Dwyane Wade,1610612748,MIA,5,1,4,127.0,3,2,1,0.667,17,0.176,2,0.2,3.8,18,5,13,0.278,33,0.545,5,0.643,6.6,21,7,14,0.333,50,0.42,7,0.488,6.2,2017-18,Playoffs
202734,E'Twaun Moore,1610612740,NOP,9,5,4,284.0,6,2,3,0.333,21,0.286,1,0.3,12.1,17,3,14,0.176,33,0.515,4,0.586,10.5,23,5,17,0.217,52,0.442,5,0.489,10.9,2017-18,Playoffs
202334,Ed Davis,1610612757,POR,4,0,4,71.0,5,4,1,0.8,26,0.192,0,0.192,3.9,27,7,20,0.259,34,0.794,0,0.794,3.1,32,11,21,0.344,58,0.552,0,0.552,3.2,2017-18,Playoffs
202327,Ekpe Udoh,1610612762,UTA,2,0,2,14.0,1,0,1,0.0,2,0.5,0,0.5,4.1,2,0,2,0.0,4,0.5,0,0.5,5.0,3,0,3,0.0,6,0.5,0,0.5,4.7,2017-18,Playoffs
202339,Eric Bledsoe,1610612749,MIL,6,2,4,193.0,3,1,2,0.333,15,0.2,0,0.2,14.4,22,6,15,0.273,37,0.595,3,0.647,9.1,25,7,17,0.28,51,0.49,3,0.521,9.8,2017-18,Playoffs
201569,Eric Gordon,1610612745,HOU,17,11,6,549.0,9,4,5,0.444,37,0.243,0,0.243,12.6,36,2,34,0.056,70,0.514,4,0.545,8.8,45,6,39,0.133,103,0.437,4,0.455,9.6,2017-18,Playoffs
101141,Ersan Ilyasova,1610612755,PHI,10,5,5,233.0,26,16,10,0.615,60,0.433,3,0.456,6.0,50,13,37,0.26,86,0.581,2,0.595,5.4,76,29,47,0.382,138,0.551,5,0.571,5.6,2017-18,Playoffs
202323,Evan Turner,1610612757,POR,3,0,3,87.0,5,2,3,0.4,14,0.357,0,0.357,8.5,7,3,4,0.429,14,0.5,1,0.538,5.5,12,5,7,0.417,28,0.429,1,0.444,6.8,2017-18,Playoffs
1627832,Fred VanVleet,1610612761,TOR,4,1,3,88.0,0,0,0,0.0,4,0.0,0,0.0,0.0,10,0,10,0.0,15,0.667,1,0.714,10.3,10,0,10,0.0,18,0.556,1,0.588,10.3,2017-18,Playoffs
201588,George Hill,1610612739,CLE,16,8,8,480.0,13,6,5,0.462,41,0.317,4,0.351,7.3,28,7,21,0.25,67,0.418,6,0.459,6.8,41,13,26,0.317,108,0.38,10,0.418,6.9,2017-18,Playoffs
101123,Gerald Green,1610612745,HOU,15,11,4,236.0,6,2,4,0.333,23,0.261,1,0.273,18.9,44,5,39,0.114,65,0.677,3,0.71,6.9,50,7,43,0.14,84,0.595,4,0.625,8.3,2017-18,Playoffs
203507,Giannis Antetokounmpo,1610612749,MIL,7,3,4,280.0,8,3,5,0.375,30,0.267,0,0.267,7.9,59,12,47,0.203,90,0.656,2,0.67,5.4,67,15,52,0.224,112,0.598,2,0.609,5.7,2017-18,Playoffs
203922,Glenn Robinson III,1610612754,IND,1,1,0,4.0,0,0,0,0.0,0,0.0,0,0.0,0.0,1,1,0,1.0,2,0.5,0,0.5,4.0,1,1,0,1.0,2,0.5,0,0.5,4.0,2017-18,Playoffs
201609,Goran Dragic,1610612748,MIA,5,1,4,156.0,3,0,3,0.0,16,0.188,2,0.214,14.9,10,1,9,0.1,29,0.345,4,0.4,11.1,13,1,12,0.077,44,0.295,6,0.342,12.0,2017-18,Playoffs
203476,Gorgui Dieng,1610612750,MIN,4,0,4,61.0,3,1,2,0.333,14,0.214,1,0.231,4.9,15,3,12,0.2,30,0.5,2,0.536,5.7,18,4,14,0.222,40,0.45,3,0.486,5.6,2017-18,Playoffs
202328,Greg Monroe,1610612738,BOS,11,5,6,105.0,14,12,2,0.857,46,0.304,1,0.311,3.7,21,3,19,0.143,33,0.636,2,0.677,7.2,35,15,21,0.429,70,0.5,3,0.522,5.9,2017-18,Playoffs
1627824,Guerschon Yabusele,1610612738,BOS,5,1,4,30.0,3,1,2,0.333,8,0.375,0,0.375,9.9,8,0,8,0.0,14,0.571,2,0.667,9.5,11,1,10,0.091,19,0.579,2,0.647,9.6,2017-18,Playoffs
202355,Hassan Whiteside,1610612748,MIA,5,1,4,77.0,10,10,1,1.0,24,0.417,0,0.417,4.0,20,7,12,0.35,35,0.571,4,0.645,5.1,30,17,13,0.567,56,0.536,4,0.577,4.7,2017-18,Playoffs
203546,Ian Clark,1610612740,NOP,6,4,2,129.0,2,0,2,0.0,8,0.25,1,0.286,10.9,8,1,7,0.125,14,0.571,1,0.615,12.0,10,1,9,0.1,21,0.476,2,0.526,11.8,2017-18,Playoffs
101133,Ian Mahinmi,1610612764,WAS,4,2,2,41.0,4,0,4,0.0,6,0.667,0,0.667,9.2,7,4,3,0.571,14,0.5,0,0.5,5.2,11,4,7,0.364,20,0.55,0,0.55,6.6,2017-18,Playoffs
200755,JJ Redick,1610612755,PHI,8,3,5,282.0,3,2,1,0.667,15,0.2,1,0.214,5.3,12,1,11,0.083,29,0.414,2,0.444,7.3,15,3,12,0.2,42,0.357,3,0.385,6.9,2017-18,Playoffs
2747,JR Smith,1610612739,CLE,20,11,9,645.0,10,2,7,0.2,35,0.286,1,0.294,11.9,50,3,46,0.06,94,0.532,7,0.575,9.0,60,5,53,0.083,123,0.488,8,0.522,9.5,2017-18,Playoffs
201580,JaVale McGee,1610612744,GSW,13,11,2,158.0,16,9,7,0.563,32,0.5,0,0.5,5.0,26,10,16,0.385,38,0.684,2,0.722,4.0,42,19,23,0.452,70,0.6,2,0.618,4.4,2017-18,Playoffs
203953,Jabari Parker,1610612749,MIL,7,3,4,167.0,8,5,3,0.625,28,0.286,3,0.32,6.9,35,7,28,0.2,54,0.648,7,0.745,4.8,43,12,31,0.279,79,0.544,10,0.623,5.2,2017-18,Playoffs
203109,Jae Crowder,1610612762,UTA,11,5,6,323.0,4,1,3,0.25,30,0.133,1,0.138,9.3,52,7,45,0.135,93,0.559,6,0.598,6.0,56,8,48,0.143,118,0.475,7,0.505,6.2,2017-18,Playoffs
1627774,Jake Layman,1610612757,POR,1,0,1,8.0,0,0,0,0.0,0,0.0,0,0.0,0.0,1,0,1,0.0,1,1.0,0,1.0,25.5,1,0,1,0.0,1,1.0,0,1.0,25.5,2017-18,Playoffs
1627751,Jakob Poeltl,1610612761,TOR,9,4,5,140.0,15,14,1,0.933,37,0.405,1,0.417,3.7,21,8,13,0.381,46,0.457,7,0.538,4.7,36,22,14,0.611,80,0.45,8,0.5,4.3,2017-18,Playoffs
2037,Jamal Crawford,1610612750,MIN,5,1,4,123.0,1,0,1,0.0,6,0.167,0,0.167,12.4,12,1,11,0.083,14,0.857,0,0.857,14.2,13,1,12,0.077,17,0.765,0,0.765,14.0,2017-18,Playoffs
201935,James Harden,1610612745,HOU,17,11,6,621.0,14,12,3,0.857,76,0.184,2,0.189,5.5,75,13,62,0.173,134,0.56,12,0.615,7.0,89,25,65,0.281,202,0.441,14,0.473,6.8,2017-18,Playoffs
201949,James Johnson,1610612748,MIA,5,1,4,160.0,3,0,3,0.0,14,0.214,0,0.214,20.1,27,8,19,0.296,42,0.643,1,0.659,4.7,30,8,22,0.267,56,0.536,1,0.545,6.2,2017-18,Playoffs
1891,Jason Terry,1610612749,MIL,2,0,2,26.0,1,0,1,0.0,3,0.333,0,0.333,10.3,1,0,2,0.0,2,0.5,0,0.5,16.8,2,0,3,0.0,3,0.667,0,0.667,14.6,2017-18,Playoffs
1627759,Jaylen Brown,1610612738,BOS,18,10,8,583.0,16,9,6,0.563,76,0.211,1,0.213,6.6,71,10,62,0.141,108,0.657,5,0.689,6.0,87,19,68,0.218,175,0.497,6,0.515,6.1,2017-18,Playoffs
1628369,Jayson Tatum,1610612738,BOS,19,11,8,683.0,10,3,7,0.3,73,0.137,4,0.145,12.4,73,11,62,0.151,117,0.624,7,0.664,6.3,83,14,69,0.169,187,0.444,11,0.472,7.0,2017-18,Playoffs
201145,Jeff Green,1610612739,CLE,18,11,7,447.0,7,3,4,0.429,37,0.189,0,0.189,7.6,46,10,35,0.217,92,0.5,9,0.554,8.2,53,13,39,0.245,125,0.424,9,0.457,8.1,2017-18,Playoffs
201952,Jeff Teague,1610612750,MIN,5,1,4,153.0,3,2,1,0.667,11,0.273,0,0.273,10.3,15,3,12,0.2,27,0.556,0,0.556,7.2,18,5,13,0.278,38,0.474,0,0.474,7.7,2017-18,Playoffs
203924,Jerami Grant,1610612760,OKC,6,2,4,133.0,8,5,3,0.625,26,0.308,1,0.32,7.5,12,4,9,0.333,30,0.4,4,0.462,7.2,20,9,12,0.45,56,0.357,5,0.392,7.3,2017-18,Playoffs
202710,Jimmy Butler,1610612750,MIN,5,1,4,170.0,3,2,0,0.667,25,0.12,0,0.12,4.9,27,5,23,0.185,40,0.675,2,0.711,6.2,30,7,23,0.233,63,0.476,2,0.492,6.1,2017-18,Playoffs
204060,Joe Ingles,1610612762,UTA,11,5,6,382.0,5,1,4,0.2,16,0.313,0,0.313,16.9,43,1,42,0.023,66,0.652,4,0.694,9.0,48,2,46,0.042,80,0.6,4,0.632,9.8,2017-18,Playoffs
2207,Joe Johnson,1610612745,HOU,5,3,2,40.0,0,0,0,0.0,1,0.0,1,0.0,0.0,10,2,8,0.2,14,0.714,1,0.769,5.1,10,2,8,0.2,15,0.667,2,0.769,5.1,2017-18,Playoffs
203954,Joel Embiid,1610612755,PHI,8,4,4,278.0,23,16,9,0.696,65,0.354,2,0.365,6.6,78,17,61,0.218,116,0.672,8,0.722,4.5,101,33,70,0.327,171,0.591,10,0.627,5.0,2017-18,Playoffs
203530,Joffrey Lauvergne,1610612759,SAS,1,0,1,6.0,0,0,0,0.0,0,0.0,0,0.0,0.0,1,1,0,1.0,1,1.0,0,1.0,10.9,1,1,0,1.0,1,1.0,0,1.0,10.9,2017-18,Playoffs
203089,John Henson,1610612749,MIL,2,0,2,74.0,4,3,1,0.75,6,0.667,0,0.667,6.5,8,2,6,0.25,15,0.533,0,0.533,4.8,12,5,7,0.417,21,0.571,0,0.571,5.4,2017-18,Playoffs
202322,John Wall,1610612764,WAS,6,2,4,234.0,3,1,1,0.333,22,0.136,2,0.15,16.1,31,3,28,0.097,43,0.721,1,0.738,10.7,34,4,29,0.118,64,0.531,3,0.557,11.0,2017-18,Playoffs
201973,Jonas Jerebko,1610612762,UTA,8,4,4,70.0,4,2,2,0.5,8,0.5,1,0.571,4.4,12,3,9,0.25,16,0.75,1,0.8,5.1,16,5,11,0.313,23,0.696,2,0.762,4.9,2017-18,Playoffs
202685,Jonas Valanciunas,1610612761,TOR,10,4,6,244.0,30,25,5,0.833,73,0.411,2,0.423,5.5,75,22,53,0.293,115,0.652,7,0.694,3.7,105,47,58,0.448,181,0.58,9,0.61,4.2,2017-18,Playoffs
1628395,Jordan Bell,1610612744,GSW,14,11,3,164.0,15,8,7,0.533,48,0.313,0,0.313,2.9,32,9,23,0.281,51,0.627,2,0.653,5.3,47,17,30,0.362,97,0.485,2,0.495,4.6,2017-18,Playoffs
203903,Jordan Clarkson,1610612739,CLE,16,9,7,258.0,9,1,8,0.111,22,0.409,1,0.429,12.2,23,4,20,0.174,42,0.548,6,0.639,11.2,32,5,28,0.156,62,0.516,7,0.582,11.5,2017-18,Playoffs
202348,Jordan Crawford,1610612740,NOP,2,1,1,15.0,0,0,0,0.0,0,0.0,0,0.0,0.0,4,0,4,0.0,5,0.8,0,0.8,9.4,4,0,4,0.0,5,0.8,0,0.8,9.4,2017-18,Playoffs
101181,Jose Calderon,1610612739,CLE,7,3,4,71.0,2,1,0,0.5,4,0.5,0,0.5,1.2,9,0,9,0.0,21,0.429,1,0.45,9.3,11,1,9,0.091,25,0.44,1,0.458,8.5,2017-18,Playoffs
203962,Josh Huestis,1610612760,OKC,2,0,2,14.0,0,0,0,0.0,1,0.0,0,0.0,0.0,3,1,1,0.333,4,0.75,0,0.75,6.5,3,1,1,0.333,5,0.6,0,0.6,6.5,2017-18,Playoffs
1626196,Josh Richardson,1610612748,MIA,4,1,3,122.0,4,0,4,0.0,8,0.5,0,0.5,16.5,11,1,10,0.091,28,0.393,2,0.423,8.7,15,1,14,0.067,36,0.417,2,0.441,10.8,2017-18,Playoffs
201950,Jrue Holiday,1610612740,NOP,9,5,4,348.0,9,5,4,0.556,40,0.225,2,0.237,11.2,42,7,34,0.167,65,0.646,8,0.737,7.7,51,12,38,0.235,103,0.495,10,0.548,8.3,2017-18,Playoffs
1626147,Justin Anderson,1610612755,PHI,4,3,1,27.0,1,0,1,0.0,5,0.2,0,0.2,16.5,8,2,6,0.25,12,0.667,0,0.667,5.0,9,2,7,0.222,16,0.563,0,0.563,6.3,2017-18,Playoffs
1626159,Justise Winslow,1610612748,MIA,5,1,4,125.0,7,5,2,0.714,21,0.333,0,0.333,4.9,26,4,22,0.154,48,0.542,5,0.605,5.2,33,9,24,0.273,61,0.541,5,0.589,5.1,2017-18,Playoffs
203994,Jusuf Nurkic,1610612757,POR,4,0,4,93.0,12,9,3,0.75,34,0.353,1,0.364,4.7,20,4,16,0.2,34,0.588,2,0.625,4.2,32,13,19,0.406,65,0.492,3,0.516,4.4,2017-18,Playoffs
1626157,Karl-Anthony Towns,1610612750,MIN,5,1,4,170.0,15,10,5,0.667,39,0.385,0,0.385,5.3,52,18,34,0.346,83,0.627,10,0.712,4.4,67,28,39,0.418,115,0.583,10,0.638,4.6,2017-18,Playoffs
203482,Kelly Olynyk,1610612748,MIA,4,1,3,137.0,7,4,3,0.571,21,0.333,0,0.333,2.9,16,7,9,0.438,41,0.39,8,0.485,4.4,23,11,12,0.478,60,0.383,8,0.442,3.9,2017-18,Playoffs
1626162,Kelly Oubre Jr.,1610612764,WAS,6,2,4,148.0,1,0,1,0.0,18,0.056,0,0.056,25.7,22,5,17,0.227,32,0.688,1,0.71,6.0,23,5,18,0.217,46,0.5,1,0.511,6.9,2017-18,Playoffs
201142,Kevin Durant,1610612744,GSW,21,16,5,807.0,13,7,5,0.538,60,0.217,3,0.228,11.0,150,31,117,0.207,212,0.708,3,0.718,6.9,163,38,122,0.233,260,0.627,6,0.642,7.2,2017-18,Playoffs
201567,Kevin Love,1610612739,CLE,21,11,10,660.0,49,37,11,0.755,120,0.408,1,0.412,5.1,166,51,115,0.307,252,0.659,16,0.703,4.1,215,88,126,0.409,361,0.596,17,0.625,4.3,2017-18,Playoffs
1626172,Kevon Looney,1610612744,GSW,20,15,5,387.0,42,25,15,0.595,82,0.512,4,0.538,5.4,47,19,29,0.404,88,0.534,4,0.56,6.6,89,44,44,0.494,167,0.533,8,0.56,6.0,2017-18,Playoffs
203114,Khris Middleton,1610612749,MIL,7,3,4,275.0,1,0,1,0.0,17,0.059,2,0.067,6.5,35,7,28,0.2,66,0.53,6,0.583,6.1,36,7,29,0.194,77,0.468,8,0.522,6.1,2017-18,Playoffs
202691,Klay Thompson,1610612744,GSW,20,15,5,754.0,11,2,9,0.182,35,0.314,1,0.324,20.1,75,16,59,0.213,148,0.507,14,0.56,7.7,86,18,68,0.209,180,0.478,15,0.521,9.4,2017-18,Playoffs
203937,Kyle Anderson,1610612759,SAS,5,1,4,73.0,5,1,4,0.2,13,0.385,0,0.385,5.4,8,0,8,0.0,10,0.8,0,0.8,7.7,13,1,12,0.077,23,0.565,0,0.565,6.8,2017-18,Playoffs
2594,Kyle Korver,1610612739,CLE,20,12,8,482.0,6,0,5,0.0,21,0.286,2,0.316,18.2,46,15,32,0.326,87,0.529,6,0.568,7.8,52,15,37,0.288,104,0.5,8,0.542,8.9,2017-18,Playoffs
200768,Kyle Lowry,1610612761,TOR,10,4,6,361.0,2,1,1,0.5,33,0.061,0,0.061,17.8,41,12,30,0.293,92,0.446,9,0.494,6.6,43,13,31,0.302,125,0.344,9,0.371,7.1,2017-18,Playoffs
200746,LaMarcus Aldridge,1610612759,SAS,5,1,4,176.0,13,12,1,0.923,34,0.382,0,0.382,5.2,33,11,22,0.333,49,0.673,4,0.733,6.6,46,23,23,0.5,82,0.561,4,0.59,6.2,2017-18,Playoffs
202362,Lance Stephenson,1610612754,IND,6,3,3,126.0,3,1,2,0.333,12,0.25,0,0.25,10.8,16,2,14,0.125,24,0.667,3,0.762,7.3,19,3,16,0.158,35,0.543,3,0.594,7.8,2017-18,Playoffs
1626204,Larry Nance Jr.,1610612739,CLE,19,10,9,303.0,35,20,15,0.571,65,0.538,1,0.547,6.0,55,12,41,0.218,94,0.585,7,0.632,5.1,90,32,56,0.356,152,0.592,8,0.625,5.5,2017-18,Playoffs
2544,LeBron James,1610612739,CLE,22,12,10,922.0,31,20,12,0.645,100,0.31,1,0.313,6.6,169,36,132,0.213,253,0.668,15,0.71,5.8,200,56,144,0.28,340,0.588,16,0.617,5.9,2017-18,Playoffs
203485,Lorenzo Brown,1610612761,TOR,2,0,2,20.0,1,0,1,0.0,4,0.25,0,0.25,16.8,5,1,4,0.2,11,0.455,0,0.455,9.4,6,1,5,0.167,14,0.429,0,0.429,10.6,2017-18,Playoffs
201601,Luc Mbah a Moute,1610612745,HOU,9,5,4,149.0,3,3,0,1.0,18,0.167,0,0.167,8.3,19,5,14,0.263,33,0.576,3,0.633,8.0,22,8,14,0.364,51,0.431,3,0.458,8.1,2017-18,Playoffs
203512,Lucas Nogueira,1610612761,TOR,1,1,0,9.0,0,0,0,0.0,2,0.0,0,0.0,0.0,1,0,1,0.0,1,1.0,0,1.0,18.8,1,0,1,0.0,3,0.333,0,0.333,18.8,2017-18,Playoffs
1627763,Malcolm Brogdon,1610612749,MIL,7,3,4,186.0,3,1,2,0.333,7,0.429,0,0.429,11.7,21,5,16,0.238,34,0.618,1,0.636,8.6,24,6,18,0.25,41,0.585,1,0.6,9.0,2017-18,Playoffs
1938,Manu Ginobili,1610612759,SAS,5,1,4,107.0,1,0,1,0.0,11,0.091,1,0.1,28.8,14,4,10,0.286,27,0.519,4,0.609,5.4,15,4,11,0.267,38,0.395,5,0.455,6.9,2017-18,Playoffs
101162,Marcin Gortat,1610612764,WAS,6,2,4,160.0,13,5,9,0.385,39,0.333,1,0.342,7.2,25,12,13,0.48,50,0.5,2,0.521,3.7,38,17,22,0.447,88,0.432,3,0.447,5.0,2017-18,Playoffs
201158,Marco Belinelli,1610612755,PHI,9,4,5,249.0,1,0,1,0.0,13,0.077,1,0.083,12.5,19,1,18,0.053,31,0.613,1,0.633,8.6,20,1,19,0.05,44,0.455,2,0.476,8.8,2017-18,Playoffs
1627875,Marcus Georges-Hunt,1610612750,MIN,1,0,1,2.0,1,0,1,0.0,1,1.0,0,1.0,6.0,0,0,0,0.0,0,0.0,0,0.0,0.0,1,0,1,0.0,1,1.0,0,1.0,6.0,2017-18,Playoffs
202694,Marcus Morris Sr.,1610612738,BOS,19,11,8,562.0,20,8,10,0.4,61,0.328,1,0.333,8.1,83,14,68,0.169,139,0.597,11,0.648,6.2,103,22,78,0.214,189,0.545,12,0.582,6.6,2017-18,Playoffs
203935,Marcus Smart,1610612738,BOS,14,9,5,423.0,14,8,6,0.571,48,0.292,2,0.304,8.1,42,11,31,0.262,86,0.488,11,0.56,8.2,56,19,37,0.339,128,0.438,13,0.487,8.2,2017-18,Playoffs
1628365,Markelle Fultz,1610612755,PHI,2,2,0,18.0,0,0,0,0.0,3,0.0,2,0.0,0.0,3,1,2,0.333,5,0.6,1,0.75,5.2,3,1,2,0.333,8,0.375,3,0.6,5.2,2017-18,Playoffs
202693,Markieff Morris,1610612764,WAS,6,2,4,181.0,14,8,6,0.571,22,0.636,0,0.636,8.6,31,8,23,0.258,50,0.62,6,0.705,6.1,45,16,29,0.356,68,0.662,6,0.726,6.9,2017-18,Playoffs
203521,Matthew Dellavedova,1610612749,MIL,3,2,1,49.0,1,0,1,0.0,2,0.5,0,0.5,17.7,4,2,2,0.5,7,0.571,1,0.667,6.4,5,2,3,0.4,9,0.556,1,0.625,8.6,2017-18,Playoffs
203090,Maurice Harkless,1610612757,POR,2,0,2,53.0,3,1,1,0.333,7,0.429,0,0.429,5.5,5,1,5,0.2,8,0.625,1,0.714,4.2,8,2,6,0.25,15,0.533,1,0.571,4.8,2017-18,Playoffs
203086,Meyers Leonard,1610612757,POR,1,0,1,8.0,0,0,0,0.0,1,0.0,0,0.0,0.0,4,0,4,0.0,5,0.8,0,0.8,6.3,4,0,4,0.0,6,0.667,0,0.667,6.3,2017-18,Playoffs
203118,Mike Scott,1610612764,WAS,6,2,4,126.0,6,4,2,0.667,18,0.333,0,0.333,5.8,15,5,10,0.333,39,0.385,7,0.469,6.4,21,9,12,0.429,56,0.375,7,0.429,6.3,2017-18,Playoffs
1626167,Myles Turner,1610612754,IND,7,3,4,196.0,6,3,4,0.5,19,0.316,0,0.316,5.2,30,11,19,0.367,58,0.517,7,0.588,5.4,36,14,23,0.389,74,0.486,7,0.537,5.4,2017-18,Playoffs
202357,Nemanja Bjelica,1610612750,MIN,5,1,4,47.0,4,1,2,0.25,5,0.8,0,0.8,15.7,11,1,9,0.091,14,0.786,0,0.786,6.4,15,2,11,0.133,19,0.789,0,0.789,8.5,2017-18,Playoffs
2403,Nene,1610612745,HOU,11,8,3,107.0,6,4,2,0.667,21,0.286,1,0.3,5.9,22,7,15,0.318,40,0.55,7,0.667,4.7,28,11,17,0.393,59,0.475,8,0.549,5.0,2017-18,Playoffs
201156,Nick Young,1610612744,GSW,9,7,2,127.0,1,0,1,0.0,4,0.25,0,0.25,2.8,11,4,7,0.364,18,0.611,0,0.611,9.5,12,4,8,0.333,22,0.545,0,0.545,9.0,2017-18,Playoffs
202703,Nikola Mirotic,1610612740,NOP,9,5,4,320.0,9,5,4,0.556,31,0.29,1,0.3,8.1,77,22,54,0.286,116,0.664,2,0.675,4.8,86,27,58,0.314,144,0.597,3,0.61,5.2,2017-18,Playoffs
1626181,Norman Powell,1610612761,TOR,2,0,2,16.0,0,0,0,0.0,2,0.0,0,0.0,0.0,2,0,2,0.0,3,0.667,0,0.667,12.2,2,0,2,0.0,5,0.4,0,0.4,12.2,2017-18,Playoffs
1628384,OG Anunoby,1610612761,TOR,9,4,5,215.0,9,7,2,0.778,18,0.5,0,0.5,4.5,12,3,9,0.25,38,0.316,3,0.343,6.2,21,10,11,0.476,55,0.382,3,0.404,5.5,2017-18,Playoffs
203490,Otto Porter Jr.,1610612764,WAS,5,2,3,158.0,1,0,1,0.0,16,0.063,0,0.063,7.8,24,4,19,0.167,38,0.632,2,0.667,8.0,25,4,20,0.16,51,0.49,2,0.51,8.0,2017-18,Playoffs
200782,P.J. Tucker,1610612745,HOU,16,10,6,539.0,23,11,12,0.478,71,0.324,1,0.329,9.2,88,26,59,0.295,145,0.607,12,0.662,6.6,111,37,71,0.333,208,0.534,13,0.569,7.2,2017-18,Playoffs
1627783,Pascal Siakam,1610612761,TOR,10,4,6,179.0,9,3,5,0.333,18,0.5,0,0.5,7.0,27,7,21,0.259,53,0.509,3,0.54,4.9,36,10,26,0.278,70,0.514,3,0.537,5.4,2017-18,Playoffs
1626192,Pat Connaughton,1610612757,POR,3,0,3,49.0,2,0,2,0.0,5,0.4,0,0.4,18.8,2,0,2,0.0,7,0.286,0,0.286,4.3,4,0,4,0.0,12,0.333,0,0.333,11.6,2017-18,Playoffs
1627775,Patrick McCaw,1610612744,GSW,2,2,0,7.0,1,1,0,1.0,1,1.0,0,1.0,4.9,2,0,2,0.0,2,1.0,0,1.0,5.8,3,1,2,0.333,3,1.0,0,1.0,5.5,2017-18,Playoffs
202335,Patrick Patterson,1610612760,OKC,4,1,3,50.0,1,1,0,1.0,6,0.167,0,0.167,3.9,10,2,8,0.2,16,0.625,1,0.667,5.1,11,3,8,0.273,20,0.55,1,0.579,5.0,2017-18,Playoffs
201988,Patty Mills,1610612759,SAS,3,0,3,102.0,2,0,2,0.0,5,0.4,0,0.4,14.3,8,1,7,0.125,14,0.571,0,0.571,12.5,10,1,9,0.1,19,0.526,0,0.526,12.9,2017-18,Playoffs
2200,Pau Gasol,1610612759,SAS,5,1,4,90.0,2,1,1,0.5,16,0.125,0,0.125,10.0,22,3,19,0.136,37,0.595,1,0.611,4.5,24,4,20,0.167,53,0.453,1,0.462,4.9,2017-18,Playoffs
202331,Paul George,1610612760,OKC,6,2,4,251.0,4,2,2,0.5,25,0.16,2,0.174,14.1,32,10,22,0.313,54,0.593,2,0.615,6.6,36,12,24,0.333,78,0.462,4,0.486,7.5,2017-18,Playoffs
1626188,Quinn Cook,1610612744,GSW,10,7,3,149.0,2,2,1,1.0,11,0.182,1,0.2,3.5,21,4,17,0.19,38,0.553,3,0.6,7.2,23,6,18,0.261,49,0.469,4,0.511,6.7,2017-18,Playoffs
200765,Rajon Rondo,1610612740,NOP,9,5,4,302.0,9,4,5,0.444,38,0.237,1,0.243,9.9,59,7,52,0.119,81,0.728,2,0.747,8.1,68,11,57,0.162,114,0.596,3,0.613,8.3,2017-18,Playoffs
203526,Raul Neto,1610612762,UTA,6,1,5,69.0,2,0,2,0.0,11,0.182,0,0.182,23.5,8,4,4,0.5,12,0.667,0,0.667,9.0,10,4,6,0.4,23,0.435,0,0.435,11.9,2017-18,Playoffs
101109,Raymond Felton,1610612760,OKC,6,2,4,79.0,2,1,1,0.5,7,0.286,0,0.286,20.3,11,3,8,0.273,19,0.579,3,0.688,7.4,13,4,9,0.308,26,0.5,3,0.565,9.4,2017-18,Playoffs
1626158,Richaun Holmes,1610612755,PHI,1,0,1,3.0,0,0,0,0.0,0,0.0,0,0.0,0.0,1,1,0,1.0,1,1.0,0,1.0,6.1,1,1,0,1.0,1,1.0,0,1.0,6.1,2017-18,Playoffs
201937,Ricky Rubio,1610612762,UTA,6,4,2,181.0,5,0,5,0.0,17,0.294,0,0.294,27.1,39,8,31,0.205,61,0.639,5,0.696,7.2,44,8,36,0.182,78,0.564,5,0.603,9.4,2017-18,Playoffs
203496,Robert Covington,1610612755,PHI,10,5,5,281.0,12,5,7,0.417,40,0.3,3,0.324,5.9,41,15,26,0.366,77,0.532,9,0.603,5.9,53,20,33,0.377,113,0.469,12,0.525,5.9,2017-18,Playoffs
203918,Rodney Hood,1610612739,CLE,11,5,6,180.0,7,1,5,0.143,16,0.438,1,0.467,21.1,24,6,19,0.25,39,0.615,0,0.615,8.3,31,7,24,0.226,53,0.585,1,0.596,11.0,2017-18,Playoffs
203585,Rodney McGruder,1610612748,MIA,2,0,2,8.0,0,0,0,0.0,1,0.0,0,0.0,0.0,4,1,3,0.25,4,1.0,0,1.0,6.8,4,1,3,0.25,5,0.8,0,0.8,6.8,2017-18,Playoffs
1626220,Royce O'Neale,1610612762,UTA,11,5,6,259.0,3,1,3,0.333,14,0.214,0,0.214,20.4,35,9,26,0.257,56,0.625,5,0.686,5.9,38,10,29,0.263,69,0.551,5,0.594,7.2,2017-18,Playoffs
200752,Rudy Gay,1610612759,SAS,5,1,4,160.0,9,4,5,0.444,21,0.429,0,0.429,5.1,19,2,17,0.105,37,0.514,6,0.613,7.0,28,6,22,0.214,54,0.519,6,0.583,6.4,2017-18,Playoffs
203497,Rudy Gobert,1610612762,UTA,11,5,6,383.0,43,27,15,0.628,102,0.422,1,0.426,4.1,75,23,53,0.307,167,0.449,21,0.514,3.8,118,50,68,0.424,258,0.457,22,0.5,3.9,2017-18,Playoffs
201566,Russell Westbrook,1610612760,OKC,6,2,4,235.0,11,6,5,0.545,58,0.19,1,0.193,8.1,61,3,57,0.049,79,0.772,3,0.803,8.1,72,9,62,0.125,126,0.571,4,0.59,8.1,2017-18,Playoffs
201583,Ryan Anderson,1610612745,HOU,7,3,4,75.0,3,1,2,0.333,7,0.429,0,0.429,12.1,9,4,5,0.444,12,0.75,0,0.75,7.7,12,5,7,0.417,17,0.706,0,0.706,8.8,2017-18,Playoffs
1628400,Semi Ojeleye,1610612738,BOS,11,6,5,183.0,4,1,3,0.25,12,0.333,1,0.364,8.1,24,6,18,0.25,41,0.585,1,0.6,6.8,28,7,21,0.25,50,0.56,2,0.583,7.0,2017-18,Playoffs
201586,Serge Ibaka,1610612761,TOR,10,4,6,260.0,13,9,4,0.692,37,0.351,0,0.351,5.8,46,10,36,0.217,70,0.657,5,0.708,6.0,59,19,40,0.322,103,0.573,5,0.602,5.9,2017-18,Playoffs
203498,Shabazz Muhammad,1610612749,MIL,2,0,2,13.0,0,0,0,0.0,5,0.0,0,0.0,0.0,4,0,4,0.0,4,1.0,0,1.0,3.5,4,0,4,0.0,7,0.571,0,0.571,3.5,2017-18,Playoffs
203894,Shabazz Napier,1610612757,POR,1,0,1,21.0,0,0,0,0.0,1,0.0,0,0.0,0.0,1,0,1,0.0,3,0.333,1,0.5,10.5,1,0,1,0.0,4,0.25,1,0.333,10.5,2017-18,Playoffs
203499,Shane Larkin,1610612738,BOS,6,5,1,87.0,1,1,0,1.0,7,0.143,0,0.143,24.6,10,2,8,0.2,18,0.556,0,0.556,9.2,11,3,8,0.273,25,0.44,0,0.44,10.6,2017-18,Playoffs
2733,Shaun Livingston,1610612744,GSW,18,14,4,313.0,11,8,4,0.727,33,0.333,2,0.355,8.4,36,12,24,0.333,62,0.581,2,0.6,8.8,47,20,28,0.426,92,0.511,4,0.534,8.7,2017-18,Playoffs
203524,Solomon Hill,1610612740,NOP,7,4,3,106.0,6,5,1,0.833,16,0.375,1,0.4,5.0,11,4,7,0.364,20,0.55,1,0.579,3.7,17,9,8,0.529,34,0.5,2,0.531,4.1,2017-18,Playoffs
201939,Stephen Curry,1610612744,GSW,15,11,4,555.0,9,3,5,0.333,46,0.196,1,0.2,9.9,82,12,70,0.146,162,0.506,13,0.55,7.5,91,15,75,0.165,205,0.444,14,0.476,7.7,2017-18,Playoffs
1628425,Sterling Brown,1610612749,MIL,2,1,1,12.0,1,1,0,1.0,1,1.0,0,1.0,9.3,1,0,1,0.0,2,0.5,0,0.5,2.3,2,1,1,0.5,3,0.667,0,0.667,5.8,2017-18,Playoffs
203500,Steven Adams,1610612760,OKC,6,2,4,200.0,19,13,6,0.684,63,0.302,0,0.302,5.9,26,8,18,0.308,54,0.481,10,0.591,8.4,45,21,24,0.467,117,0.385,10,0.421,7.3,2017-18,Playoffs
204456,T.J. McConnell,1610612755,PHI,9,4,5,150.0,6,2,3,0.333,17,0.353,1,0.375,6.3,20,2,18,0.1,38,0.526,1,0.541,8.3,26,4,21,0.154,53,0.491,2,0.51,7.9,2017-18,Playoffs
201959,Taj Gibson,1610612750,MIN,5,1,4,123.0,7,7,0,1.0,18,0.389,0,0.389,5.5,13,2,11,0.154,30,0.433,0,0.433,7.6,20,9,11,0.45,45,0.444,0,0.444,6.9,2017-18,Playoffs
204028,Tarik Black,1610612745,HOU,5,3,2,17.0,2,1,1,0.5,9,0.222,0,0.222,5.9,4,1,3,0.25,8,0.5,0,0.5,6.6,6,2,4,0.333,15,0.4,0,0.4,6.4,2017-18,Playoffs
1628390,Terrance Ferguson,1610612760,OKC,1,0,1,2.0,1,1,0,1.0,1,1.0,0,1.0,7.8,0,0,0,0.0,0,0.0,0,0.0,0.0,1,1,0,1.0,1,1.0,0,1.0,7.8,2017-18,Playoffs
1626179,Terry Rozier,1610612738,BOS,19,11,8,696.0,8,1,7,0.125,35,0.229,2,0.242,14.3,92,5,86,0.054,152,0.605,16,0.676,6.5,100,6,93,0.06,184,0.543,18,0.602,7.1,2017-18,Playoffs
201152,Thaddeus Young,1610612754,IND,7,3,4,237.0,22,15,6,0.682,57,0.386,0,0.386,4.0,32,9,23,0.281,61,0.525,8,0.604,4.6,54,24,29,0.444,112,0.482,8,0.519,4.4,2017-18,Playoffs
1627748,Thon Maker,1610612749,MIL,6,3,3,130.0,6,2,4,0.333,10,0.6,0,0.6,7.4,17,6,11,0.353,52,0.327,4,0.354,6.5,23,8,15,0.348,61,0.377,4,0.404,6.8,2017-18,Playoffs
204025,Tim Frazier,1610612764,WAS,1,1,0,2.0,0,0,0,0.0,0,0.0,0,0.0,0.0,1,0,1,0.0,1,1.0,0,1.0,4.1,1,0,1,0.0,1,1.0,0,1.0,4.1,2017-18,Playoffs
203107,Tomas Satoransky,1610612764,WAS,5,2,3,48.0,5,3,2,0.6,12,0.417,0,0.417,5.8,4,1,3,0.25,6,0.667,0,0.667,9.8,9,4,5,0.444,18,0.5,0,0.5,7.6,2017-18,Playoffs
1628396,Tony Bradley,1610612762,UTA,1,0,1,2.0,1,0,1,0.0,2,0.5,0,0.5,1.4,0,0,0,0.0,0,0.0,0,0.0,0.0,1,0,1,0.0,2,0.5,0,0.5,1.4,2017-18,Playoffs
2225,Tony Parker,1610612759,SAS,4,0,4,51.0,0,0,0,0.0,6,0.0,0,0.0,0.0,4,1,3,0.25,11,0.364,0,0.364,18.4,4,1,3,0.25,17,0.235,0,0.235,18.4,2017-18,Playoffs
203503,Tony Snell,1610612749,MIL,6,3,3,130.0,1,0,1,0.0,4,0.25,1,0.333,24.3,12,3,9,0.25,22,0.545,0,0.545,7.4,13,3,10,0.231,26,0.5,1,0.52,8.7,2017-18,Playoffs
2772,Trevor Ariza,1610612745,HOU,17,11,6,582.0,9,5,4,0.556,47,0.191,1,0.196,12.9,56,7,49,0.125,90,0.622,7,0.675,8.3,65,12,53,0.185,132,0.492,8,0.524,8.9,2017-18,Playoffs
202344,Trevor Booker,1610612754,IND,7,3,4,64.0,5,2,3,0.4,11,0.455,0,0.455,3.5,13,2,11,0.154,26,0.5,2,0.542,5.0,18,4,14,0.222,33,0.545,2,0.581,4.6,2017-18,Playoffs
202684,Tristan Thompson,1610612739,CLE,19,10,9,416.0,44,34,9,0.773,129,0.341,6,0.358,5.7,68,14,55,0.206,136,0.5,10,0.54,6.0,112,48,64,0.429,259,0.432,16,0.461,5.9,2017-18,Playoffs
201951,Ty Lawson,1610612764,WAS,5,2,3,96.0,2,0,2,0.0,10,0.2,1,0.222,9.0,11,2,9,0.182,18,0.611,0,0.611,14.1,13,2,11,0.154,26,0.5,1,0.52,13.4,2017-18,Playoffs
204020,Tyler Johnson,1610612748,MIA,3,1,2,51.0,1,1,0,1.0,4,0.25,0,0.25,3.6,7,0,7,0.0,14,0.5,0,0.5,12.2,8,1,7,0.125,18,0.444,0,0.444,11.1,2017-18,Playoffs
203092,Tyler Zeller,1610612749,MIL,5,3,2,57.0,2,1,1,0.5,10,0.2,1,0.222,9.5,12,2,10,0.167,24,0.5,1,0.522,4.9,14,3,11,0.214,32,0.438,2,0.467,5.5,2017-18,Playoffs
1626145,Tyus Jones,1610612750,MIN,3,1,2,47.0,0,0,0,0.0,3,0.0,0,0.0,0.0,9,0,9,0.0,15,0.6,1,0.643,8.1,9,0,9,0.0,18,0.5,1,0.529,8.1,2017-18,Playoffs
203506,Victor Oladipo,1610612754,IND,7,3,4,261.0,3,2,1,0.667,20,0.15,2,0.167,3.3,55,16,39,0.291,81,0.679,7,0.743,8.5,58,18,40,0.31,100,0.58,9,0.637,8.3,2017-18,Playoffs
1627735,Wade Baldwin IV,1610612757,POR,2,0,2,16.0,0,0,0,0.0,2,0.0,0,0.0,0.0,3,0,3,0.0,3,1.0,0,1.0,9.4,3,0,3,0.0,5,0.6,0,0.6,9.4,2017-18,Playoffs
201961,Wayne Ellington,1610612748,MIA,5,1,4,101.0,1,1,0,1.0,2,0.5,0,0.5,2.0,7,0,7,0.0,12,0.583,0,0.583,9.3,8,1,7,0.125,14,0.571,0,0.571,8.4,2017-18,Playoffs
1628380,Zach Collins,1610612757,POR,4,0,4,70.0,3,3,0,1.0,11,0.273,1,0.3,8.6,9,2,7,0.222,17,0.529,3,0.643,4.4,12,5,7,0.417,26,0.462,4,0.545,5.4,2017-18,Playoffs
2585,Zaza Pachulia,1610612744,GSW,6,4,2,23.0,6,3,3,0.5,13,0.462,1,0.5,6.4,6,0,6,0.0,11,0.545,1,0.6,3.8,12,3,9,0.25,22,0.545,2,0.6,5.1,2017-18,Playoffs
1627753,Zhou Qi,1610612745,HOU,1,1,0,3.0,0,0,0,0.0,2,0.0,0,0.0,0.0,1,0,1,0.0,1,1.0,0,1.0,5.5,1,0,1,0.0,2,0.5,0,0.5,5.5,2017-18,Playoffs
203932,Aaron Gordon,1610612753,ORL,76,38,38,2567.0,128,75,51,0.586,269,0.476,11,0.496,7.2,439,101,330,0.23,620,0.708,42,0.76,6.3,567,176,381,0.31,860,0.659,53,0.703,6.5,2018-19,Regular%20Season
1628988,Aaron Holiday,1610612754,IND,28,18,10,483.0,5,2,3,0.4,18,0.278,0,0.278,16.0,62,4,58,0.065,98,0.633,8,0.689,9.0,67,6,61,0.09,115,0.583,8,0.626,9.5,2018-19,Regular%20Season
1627846,Abdel Nader,1610612760,OKC,45,27,18,615.0,14,2,12,0.143,44,0.318,0,0.318,16.8,100,20,80,0.2,158,0.633,9,0.671,7.3,114,22,92,0.193,191,0.597,9,0.626,8.5,2018-19,Regular%20Season
201143,Al Horford,1610612738,BOS,68,41,27,1973.0,120,58,61,0.483,264,0.455,4,0.462,8.2,338,111,225,0.328,607,0.557,55,0.612,5.8,458,169,286,0.369,853,0.537,59,0.577,6.4,2018-19,Regular%20Season
202329,Al-Farouq Aminu,1610612757,POR,81,52,29,2292.0,112,65,45,0.58,291,0.385,11,0.4,7.0,498,122,372,0.245,764,0.652,55,0.702,5.2,610,187,417,0.307,1011,0.603,66,0.646,5.6,2018-19,Regular%20Season
1626210,Alan Williams,1610612751,BKN,4,1,3,24.0,4,2,2,0.5,10,0.4,0,0.4,10.4,15,7,8,0.467,21,0.714,0,0.714,4.9,19,9,10,0.474,29,0.655,0,0.655,6.0,2018-19,Regular%20Season
202692,Alec Burks,1610612758,SAC,53,16,37,1228.0,30,16,14,0.533,101,0.297,2,0.303,9.0,205,42,163,0.205,322,0.637,33,0.709,5.2,235,58,177,0.247,405,0.58,35,0.635,5.6,2018-19,Regular%20Season
203518,Alex Abrines,1610612760,OKC,25,16,9,504.0,5,1,4,0.2,17,0.294,1,0.313,16.4,43,6,37,0.14,82,0.524,7,0.573,10.1,48,7,41,0.146,99,0.485,8,0.527,10.8,2018-19,Regular%20Season
1627936,Alex Caruso,1610612747,LAL,17,5,12,455.0,20,9,11,0.45,42,0.476,3,0.513,12.3,47,8,39,0.17,71,0.662,5,0.712,9.2,67,17,50,0.254,111,0.604,8,0.65,10.2,2018-19,Regular%20Season
203458,Alex Len,1610612737,ATL,74,28,46,1523.0,158,118,39,0.747,385,0.41,7,0.418,4.7,266,79,186,0.297,508,0.524,61,0.595,5.0,424,197,225,0.465,865,0.49,68,0.532,4.8,2018-19,Regular%20Season
1627816,Alex Poythress,1610612737,ATL,19,7,12,299.0,29,16,13,0.552,64,0.453,1,0.46,6.5,47,8,39,0.17,72,0.653,4,0.691,4.7,76,24,52,0.316,127,0.598,5,0.623,5.4,2018-19,Regular%20Season
1628035,Alfonzo McKinnie,1610612744,GSW,62,46,16,949.0,81,56,27,0.691,177,0.458,4,0.468,5.6,166,37,126,0.223,253,0.656,20,0.712,4.8,247,93,153,0.377,411,0.601,24,0.638,5.1,2018-19,Regular%20Season
1628993,Alize Johnson,1610612754,IND,5,3,2,41.0,4,2,1,0.5,14,0.286,0,0.286,2.8,15,4,11,0.267,24,0.625,3,0.714,3.5,19,6,12,0.316,34,0.559,3,0.613,3.4,2018-19,Regular%20Season
203459,Allen Crabbe,1610612751,BKN,40,18,22,1071.0,16,5,12,0.313,48,0.333,2,0.348,11.6,132,28,103,0.212,207,0.638,16,0.691,7.1,148,33,115,0.223,249,0.594,18,0.641,7.7,2018-19,Regular%20Season
1629019,Allonzo Trier,1610612752,NYK,60,13,47,1389.0,31,10,20,0.323,109,0.284,4,0.295,13.1,164,16,146,0.098,276,0.594,26,0.656,8.1,195,26,166,0.133,374,0.521,30,0.567,8.9,2018-19,Regular%20Season
1628518,Amile Jefferson,1610612753,ORL,10,7,3,60.0,6,5,1,0.833,16,0.375,0,0.375,5.9,15,7,8,0.467,22,0.682,2,0.75,5.6,21,12,9,0.571,37,0.568,2,0.6,5.7,2018-19,Regular%20Season
101161,Amir Johnson,1610612755,PHI,40,24,16,480.0,47,34,11,0.723,116,0.405,5,0.423,4.9,100,47,53,0.47,176,0.568,20,0.641,4.0,147,81,64,0.551,281,0.523,25,0.574,4.2,2018-19,Regular%20Season
203083,Andre Drummond,1610612765,DET,79,40,39,2647.0,423,315,105,0.745,819,0.516,15,0.526,4.2,809,255,553,0.315,1175,0.689,70,0.732,3.8,1232,570,658,0.463,1921,0.641,85,0.671,4.0,2018-19,Regular%20Season
2738,Andre Iguodala,1610612744,GSW,67,46,21,1558.0,48,18,30,0.375,97,0.495,1,0.5,12.0,204,50,154,0.245,346,0.59,33,0.652,8.5,252,68,184,0.27,431,0.585,34,0.635,9.1,2018-19,Regular%20Season
201281,Andre Ingram,1610612747,LAL,1,0,1,5.0,1,1,0,1.0,1,1.0,0,1.0,2.6,1,0,1,0.0,2,0.5,0,0.5,7.8,2,1,1,0.5,3,0.667,0,0.667,5.2,2018-19,Regular%20Season
101106,Andrew Bogut,1610612744,GSW,10,7,3,113.0,10,6,0,0.6,20,0.5,0,0.5,2.5,38,7,31,0.184,58,0.655,6,0.731,4.0,48,13,31,0.271,76,0.632,6,0.686,3.8,2018-19,Regular%20Season
1626150,Andrew Harrison,1610612740,NOP,9,2,7,118.0,6,0,6,0.0,10,0.6,1,0.667,17.6,14,3,11,0.214,26,0.538,1,0.56,6.5,20,3,17,0.15,36,0.556,2,0.588,9.8,2018-19,Regular%20Season
203952,Andrew Wiggins,1610612750,MIN,72,30,42,2535.0,83,52,30,0.627,240,0.346,13,0.366,9.5,269,58,212,0.216,484,0.556,51,0.621,7.1,352,110,242,0.313,711,0.495,64,0.544,7.7,2018-19,Regular%20Season
1629014,Anfernee Simons,1610612757,POR,4,3,1,77.0,3,1,2,0.333,5,0.6,0,0.6,4.6,10,2,8,0.2,18,0.556,3,0.667,8.4,13,3,10,0.231,23,0.565,3,0.65,7.5,2018-19,Regular%20Season
1629116,Angel Delgado,1610612746,LAC,1,0,1,14.0,2,2,0,1.0,3,0.667,1,1.0,1.2,2,0,2,0.0,3,0.667,0,0.667,1.5,4,2,2,0.5,6,0.667,1,0.8,1.3,2018-19,Regular%20Season
1627790,Ante Zizic,1610612739,CLE,58,12,46,1081.0,108,65,40,0.602,283,0.382,9,0.394,3.8,212,73,137,0.344,382,0.555,40,0.62,5.0,320,138,177,0.431,652,0.491,49,0.531,4.6,2018-19,Regular%20Season
203076,Anthony Davis,1610612740,NOP,56,25,31,1850.0,174,124,50,0.713,337,0.516,6,0.526,5.4,498,177,319,0.355,731,0.681,44,0.725,4.7,672,301,369,0.448,1055,0.637,50,0.669,4.9,2018-19,Regular%20Season
201229,Anthony Tolliver,1610612750,MIN,57,27,30,1021.0,15,6,9,0.4,65,0.231,6,0.254,12.7,161,31,130,0.193,275,0.585,29,0.654,6.5,176,37,139,0.21,328,0.537,35,0.601,7.1,2018-19,Regular%20Season
1628469,Antonio Blakeney,1610612741,CHI,44,10,34,743.0,7,5,2,0.714,38,0.184,1,0.189,5.6,99,13,86,0.131,144,0.688,10,0.739,7.3,106,18,88,0.17,177,0.599,11,0.639,7.2,2018-19,Regular%20Season
203382,Aron Baynes,1610612738,BOS,49,30,19,810.0,88,67,21,0.761,200,0.44,5,0.451,4.5,152,49,102,0.322,298,0.51,34,0.576,4.8,240,116,123,0.483,489,0.491,39,0.533,4.7,2018-19,Regular%20Season
203085,Austin Rivers,1610612745,HOU,66,39,27,1805.0,25,12,14,0.48,66,0.379,2,0.391,9.9,137,27,109,0.197,300,0.457,34,0.515,7.7,162,39,123,0.241,364,0.445,36,0.494,8.1,2018-19,Regular%20Season
202340,Avery Bradley,1610612763,MEM,59,30,29,1813.0,43,20,23,0.465,121,0.355,8,0.381,11.5,132,17,114,0.129,265,0.498,32,0.567,9.2,175,37,137,0.211,383,0.457,40,0.51,9.8,2018-19,Regular%20Season
1629168,BJ Johnson,1610612758,SAC,3,1,2,38.0,2,2,0,1.0,3,0.667,0,0.667,4.1,6,0,6,0.0,10,0.6,0,0.6,5.0,8,2,6,0.25,13,0.615,0,0.615,4.8,2018-19,Regular%20Season
1628389,Bam Adebayo,1610612748,MIA,82,39,43,1913.0,165,110,55,0.667,397,0.416,7,0.423,6.3,432,124,307,0.287,709,0.609,53,0.659,5.5,597,234,362,0.392,1063,0.562,60,0.595,5.7,2018-19,Regular%20Season
203463,Ben McLemore,1610612758,SAC,10,3,7,111.0,3,2,1,0.667,12,0.25,2,0.3,11.0,14,1,13,0.071,23,0.609,3,0.7,8.8,17,3,14,0.176,35,0.486,5,0.567,9.2,2018-19,Regular%20Season
1627732,Ben Simmons,1610612755,PHI,77,49,28,2656.0,167,96,71,0.575,396,0.422,11,0.434,8.0,516,90,425,0.174,712,0.725,31,0.758,7.3,683,186,496,0.272,1062,0.643,42,0.67,7.4,2018-19,Regular%20Season
1628656,Billy Garrett,1610612752,NYK,2,1,1,38.0,0,0,0,0.0,2,0.0,0,0.0,0.0,3,0,3,0.0,5,0.6,1,0.75,6.4,3,0,3,0.0,6,0.5,1,0.6,6.4,2018-19,Regular%20Season
202687,Bismack Biyombo,1610612766,CHA,49,21,28,756.0,81,58,24,0.716,207,0.391,4,0.399,6.5,166,50,116,0.301,279,0.595,30,0.667,4.8,247,108,140,0.437,471,0.524,34,0.565,5.3,2018-19,Regular%20Season
201933,Blake Griffin,1610612765,DET,74,39,35,2585.0,100,63,35,0.63,283,0.353,9,0.365,7.8,465,129,338,0.277,714,0.651,59,0.71,5.1,565,192,373,0.34,949,0.595,68,0.641,5.6,2018-19,Regular%20Season
1626246,Boban Marjanovic,1610612755,PHI,49,29,20,659.0,87,71,14,0.816,181,0.481,7,0.5,3.7,178,74,105,0.416,297,0.599,26,0.657,4.1,265,145,119,0.547,468,0.566,33,0.609,4.0,2018-19,Regular%20Season
1626171,Bobby Portis,1610612764,WAS,49,14,35,1276.0,109,74,31,0.679,237,0.46,2,0.464,5.6,287,78,198,0.272,418,0.687,17,0.716,5.5,396,152,229,0.384,627,0.632,19,0.651,5.5,2018-19,Regular%20Season
203992,Bogdan Bogdanovic,1610612758,SAC,67,31,36,1882.0,40,24,17,0.6,117,0.342,7,0.364,8.6,203,38,166,0.187,350,0.58,34,0.642,8.1,243,62,183,0.255,455,0.534,41,0.587,8.2,2018-19,Regular%20Season
202711,Bojan Bogdanovic,1610612754,IND,81,47,34,2573.0,33,17,15,0.515,191,0.173,7,0.179,8.6,300,41,259,0.137,463,0.648,35,0.701,7.2,333,58,274,0.174,617,0.54,42,0.579,7.3,2018-19,Regular%20Season
1629045,Bonzie Colson,1610612749,MIL,5,3,2,93.0,8,7,1,0.875,20,0.4,1,0.421,6.3,22,3,19,0.136,32,0.688,1,0.71,4.9,30,10,20,0.333,49,0.612,2,0.638,5.3,2018-19,Regular%20Season
202954,Brad Wanamaker,1610612738,BOS,24,20,4,286.0,3,1,2,0.333,11,0.273,2,0.333,10.2,38,8,30,0.211,56,0.679,4,0.731,8.3,41,9,32,0.22,67,0.612,6,0.672,8.4,2018-19,Regular%20Season
203078,Bradley Beal,1610612764,WAS,80,31,49,2968.0,85,38,44,0.447,211,0.403,12,0.427,12.2,317,70,245,0.221,539,0.588,40,0.635,7.6,402,108,289,0.269,736,0.546,52,0.588,8.6,2018-19,Regular%20Season
1629164,Brandon Goodwin,1610612743,DEN,2,1,1,7.0,1,0,1,0.0,1,1.0,0,1.0,8.2,2,1,1,0.5,2,1.0,0,1.0,8.3,3,1,2,0.333,3,1.0,0,1.0,8.3,2018-19,Regular%20Season
1627742,Brandon Ingram,1610612747,LAL,51,24,27,1755.0,41,14,27,0.341,125,0.328,7,0.347,9.0,226,59,168,0.261,362,0.624,17,0.655,6.9,267,73,195,0.273,478,0.559,24,0.588,7.3,2018-19,Regular%20Season
202688,Brandon Knight,1610612739,CLE,29,12,17,612.0,10,6,4,0.6,33,0.303,4,0.345,9.9,49,9,39,0.184,83,0.59,9,0.662,7.7,59,15,43,0.254,116,0.509,13,0.573,8.1,2018-19,Regular%20Season
1629102,Brandon Sampson,1610612741,CHI,10,2,8,186.0,3,2,1,0.667,7,0.429,0,0.429,11.3,13,0,13,0.0,22,0.591,0,0.591,8.7,16,2,14,0.125,29,0.552,0,0.552,9.2,2018-19,Regular%20Season
201572,Brook Lopez,1610612749,MIL,81,60,21,2322.0,33,19,14,0.576,84,0.393,4,0.413,9.7,363,140,222,0.386,627,0.579,62,0.642,6.8,396,159,236,0.402,696,0.569,66,0.629,7.0,2018-19,Regular%20Season
1628971,Bruce Brown,1610612765,DET,71,33,38,1402.0,48,23,25,0.479,155,0.31,12,0.336,8.0,137,19,118,0.139,247,0.555,22,0.609,6.3,185,42,143,0.227,395,0.468,34,0.512,6.7,2018-19,Regular%20Season
203998,Bruno Caboclo,1610612763,MEM,34,14,20,800.0,42,19,23,0.452,114,0.368,3,0.378,8.3,116,32,84,0.276,187,0.62,12,0.663,6.0,158,51,107,0.323,292,0.541,15,0.57,6.6,2018-19,Regular%20Season
1627854,Bryn Forbes,1610612759,SAS,76,45,31,2155.0,18,4,14,0.222,75,0.24,6,0.261,18.4,221,31,189,0.14,396,0.558,36,0.614,7.7,239,35,203,0.146,465,0.514,42,0.565,8.5,2018-19,Regular%20Season
1627741,Buddy Hield,1610612758,SAC,82,39,43,2615.0,106,55,51,0.519,261,0.406,15,0.431,8.3,306,30,275,0.098,533,0.574,38,0.618,8.5,412,85,326,0.206,791,0.521,53,0.558,8.4,2018-19,Regular%20Season
203710,C.J. Williams,1610612750,MIN,7,1,6,101.0,1,0,1,0.0,3,0.333,0,0.333,23.0,7,0,7,0.0,14,0.5,0,0.5,7.2,8,0,8,0.0,17,0.471,0,0.471,9.2,2018-19,Regular%20Season
203468,CJ McCollum,1610612757,POR,70,43,27,2375.0,62,23,38,0.371,164,0.378,11,0.405,13.6,220,22,197,0.1,380,0.579,27,0.623,8.3,282,45,235,0.16,535,0.527,38,0.567,9.5,2018-19,Regular%20Season
101139,CJ Miles,1610612763,MEM,42,27,15,735.0,13,7,6,0.538,34,0.382,0,0.382,15.4,81,18,62,0.222,129,0.628,10,0.681,8.3,94,25,68,0.266,160,0.588,10,0.627,9.3,2018-19,Regular%20Season
1628403,Caleb Swanigan,1610612758,SAC,17,9,8,162.0,17,11,6,0.647,52,0.327,2,0.34,6.4,47,18,28,0.383,69,0.681,5,0.734,4.3,64,29,34,0.453,117,0.547,7,0.582,4.8,2018-19,Regular%20Season
1629244,Cam Reynolds,1610612750,MIN,15,4,11,230.0,4,2,2,0.5,13,0.308,0,0.308,15.1,27,4,23,0.148,41,0.659,2,0.692,8.8,31,6,25,0.194,53,0.585,2,0.608,9.6,2018-19,Regular%20Season
1626166,Cameron Payne,1610612739,CLE,30,7,23,593.0,13,4,8,0.308,29,0.448,0,0.448,13.6,59,1,58,0.017,100,0.59,8,0.641,9.1,72,5,66,0.069,129,0.558,8,0.595,9.8,2018-19,Regular%20Season
1627747,Caris LeVert,1610612751,BKN,38,19,19,1020.0,35,16,18,0.457,91,0.385,7,0.417,9.4,116,22,94,0.19,190,0.611,17,0.671,7.8,151,38,112,0.252,280,0.539,24,0.59,8.2,2018-19,Regular%20Season
2546,Carmelo Anthony,1610612745,HOU,10,4,6,294.0,9,6,3,0.667,23,0.391,0,0.391,8.9,45,14,31,0.311,76,0.592,7,0.652,5.0,54,20,34,0.37,94,0.574,7,0.621,5.6,2018-19,Regular%20Season
1626224,Cedi Osman,1610612739,CLE,74,17,57,2379.0,45,10,34,0.222,153,0.294,6,0.306,13.4,312,42,265,0.135,491,0.635,47,0.703,6.7,357,52,299,0.146,615,0.58,53,0.635,7.5,2018-19,Regular%20Season
1628990,Chandler Hutchison,1610612741,CHI,41,9,32,873.0,31,13,18,0.419,69,0.449,3,0.47,10.3,154,29,125,0.188,257,0.599,15,0.636,5.8,185,42,143,0.227,313,0.591,18,0.627,6.6,2018-19,Regular%20Season
202718,Chandler Parsons,1610612763,MEM,24,10,14,488.0,4,2,2,0.5,22,0.182,1,0.19,8.0,66,3,62,0.045,107,0.617,6,0.653,7.5,70,5,64,0.071,125,0.56,7,0.593,7.5,2018-19,Regular%20Season
101112,Channing Frye,1610612739,CLE,24,3,21,277.0,4,1,3,0.25,13,0.308,0,0.308,17.2,48,13,34,0.271,70,0.686,3,0.716,6.0,52,14,37,0.269,80,0.65,3,0.675,6.9,2018-19,Regular%20Season
1626184,Chasson Randle,1610612764,WAS,32,12,20,533.0,10,4,6,0.4,23,0.435,0,0.435,11.0,44,5,39,0.114,79,0.557,6,0.603,9.5,54,9,45,0.167,102,0.529,6,0.563,9.8,2018-19,Regular%20Season
1627767,Cheick Diallo,1610612740,NOP,57,24,33,871.0,75,41,35,0.547,187,0.401,8,0.419,6.3,257,77,178,0.3,401,0.641,34,0.7,4.5,332,118,213,0.355,564,0.589,42,0.636,4.9,2018-19,Regular%20Season
1629002,Chimezie Metu,1610612759,SAS,16,6,10,115.0,9,6,3,0.667,15,0.6,1,0.643,5.4,27,5,22,0.185,39,0.692,3,0.75,5.6,36,11,25,0.306,53,0.679,4,0.735,5.6,2018-19,Regular%20Season
1628449,Chris Boucher,1610612761,TOR,23,18,5,148.0,16,9,7,0.563,44,0.364,1,0.372,5.4,40,13,27,0.325,59,0.678,2,0.702,5.0,56,22,34,0.393,95,0.589,3,0.609,5.1,2018-19,Regular%20Season
1629185,Chris Chiozza,1610612745,HOU,3,3,0,13.0,1,0,1,0.0,3,0.333,0,0.333,20.4,3,0,3,0.0,5,0.6,0,0.6,8.2,4,0,4,0.0,8,0.5,0,0.5,11.2,2018-19,Regular%20Season
101108,Chris Paul,1610612745,HOU,58,39,19,1857.0,36,17,19,0.472,91,0.396,3,0.409,14.0,229,37,192,0.162,427,0.536,43,0.596,7.9,265,54,211,0.204,517,0.513,46,0.563,8.8,2018-19,Regular%20Season
1626174,Christian Wood,1610612740,NOP,18,10,8,243.0,17,14,3,0.824,45,0.378,1,0.386,4.7,66,19,47,0.288,102,0.647,3,0.667,4.0,83,33,50,0.398,141,0.589,4,0.606,4.1,2018-19,Regular%20Season
203991,Clint Capela,1610612745,HOU,67,44,23,2249.0,298,200,95,0.671,581,0.513,8,0.52,6.2,550,165,380,0.3,836,0.658,64,0.712,4.7,848,365,475,0.43,1390,0.61,72,0.643,5.3,2018-19,Regular%20Season
203469,Cody Zeller,1610612766,CHA,49,22,27,1243.0,110,81,29,0.736,328,0.335,11,0.347,4.4,223,59,160,0.265,422,0.528,49,0.598,5.8,333,140,189,0.42,742,0.449,60,0.488,5.3,2018-19,Regular%20Season
1629012,Collin Sexton,1610612739,CLE,78,19,59,2473.0,57,25,33,0.439,200,0.285,15,0.308,10.2,178,30,148,0.169,334,0.533,48,0.622,10.1,235,55,181,0.234,534,0.44,63,0.499,10.1,2018-19,Regular%20Season
201147,Corey Brewer,1610612758,SAC,27,11,16,427.0,26,13,13,0.5,51,0.51,0,0.51,7.2,50,8,42,0.16,80,0.625,9,0.704,7.7,76,21,55,0.276,126,0.603,9,0.65,7.5,2018-19,Regular%20Season
202709,Cory Joseph,1610612754,IND,77,46,31,1962.0,39,12,26,0.308,114,0.342,6,0.361,11.2,240,32,209,0.133,410,0.585,37,0.643,8.7,279,44,235,0.158,513,0.544,43,0.594,9.1,2018-19,Regular%20Season
201584,Courtney Lee,1610612742,DAL,24,5,19,359.0,9,4,5,0.444,20,0.45,0,0.45,15.3,45,6,39,0.133,68,0.662,2,0.682,8.1,54,10,44,0.185,87,0.621,2,0.635,9.3,2018-19,Regular%20Season
1626245,Cristiano Felicio,1610612741,CHI,50,15,35,706.0,79,52,27,0.658,181,0.436,7,0.454,4.7,139,40,99,0.288,230,0.604,20,0.662,3.9,218,92,126,0.422,401,0.544,27,0.583,4.2,2018-19,Regular%20Season
1626156,D'Angelo Russell,1610612751,BKN,78,41,37,2365.0,53,20,33,0.377,149,0.356,10,0.381,12.7,262,33,229,0.126,427,0.614,30,0.66,7.7,315,53,262,0.168,574,0.549,40,0.59,8.6,2018-19,Regular%20Season
201571,D.J. Augustin,1610612753,ORL,70,36,34,1957.0,41,13,28,0.317,114,0.36,7,0.383,12.2,153,12,141,0.078,232,0.659,20,0.722,11.1,194,25,169,0.129,343,0.566,27,0.614,11.4,2018-19,Regular%20Season
1628391,D.J. Wilson,1610612749,MIL,46,35,11,875.0,45,24,20,0.533,127,0.354,5,0.369,4.5,177,39,137,0.22,290,0.61,36,0.697,5.3,222,63,157,0.284,401,0.554,41,0.617,5.1,2018-19,Regular%20Season
1629541,Dairis Bertans,1610612740,NOP,7,2,5,94.0,2,0,2,0.0,3,0.667,0,0.667,35.8,7,2,5,0.286,13,0.538,2,0.636,11.8,9,2,7,0.222,16,0.563,2,0.643,17.2,2018-19,Regular%20Season
1627745,Damian Jones,1610612744,GSW,21,14,7,363.0,31,14,16,0.452,72,0.431,1,0.437,6.5,44,10,34,0.227,100,0.44,12,0.5,6.2,75,24,50,0.32,172,0.436,13,0.472,6.4,2018-19,Regular%20Season
203081,Damian Lillard,1610612757,POR,79,51,28,2802.0,68,25,42,0.368,218,0.312,19,0.342,13.4,303,41,260,0.135,475,0.638,35,0.689,8.4,371,66,302,0.178,687,0.54,54,0.586,9.3,2018-19,Regular%20Season
1627814,Damion Lee,1610612744,GSW,23,13,10,348.0,8,3,5,0.375,27,0.296,3,0.333,12.8,56,6,50,0.107,87,0.644,6,0.691,7.1,64,9,55,0.141,111,0.577,9,0.627,7.8,2018-19,Regular%20Season
1628422,Damyean Dotson,1610612752,NYK,68,12,56,1911.0,34,10,22,0.294,82,0.415,1,0.42,12.9,225,30,196,0.133,350,0.643,29,0.701,8.4,259,40,218,0.154,419,0.618,30,0.666,9.0,2018-19,Regular%20Season
1627772,Daniel Hamilton,1610612737,ATL,12,3,9,172.0,10,6,3,0.6,22,0.455,0,0.455,4.5,37,9,28,0.243,62,0.597,5,0.649,5.1,47,15,31,0.319,82,0.573,5,0.61,5.0,2018-19,Regular%20Season
1628464,Daniel Theis,1610612738,BOS,60,35,25,870.0,87,54,32,0.621,195,0.446,5,0.458,6.8,138,50,88,0.362,273,0.505,37,0.585,4.9,225,104,120,0.462,456,0.493,42,0.543,5.7,2018-19,Regular%20Season
201568,Danilo Gallinari,1610612746,LAC,68,40,28,2059.0,54,27,27,0.5,150,0.36,6,0.375,8.6,363,57,306,0.157,579,0.627,49,0.685,5.4,417,84,333,0.201,711,0.586,55,0.636,5.8,2018-19,Regular%20Season
201980,Danny Green,1610612761,TOR,79,55,24,2196.0,60,29,31,0.483,132,0.455,5,0.472,11.6,257,57,200,0.222,451,0.57,33,0.615,6.4,317,86,231,0.271,580,0.547,38,0.585,7.4,2018-19,Regular%20Season
201967,Dante Cunningham,1610612759,SAS,54,31,23,868.0,48,28,20,0.583,111,0.432,1,0.436,8.1,140,25,115,0.179,225,0.622,22,0.69,5.9,188,53,135,0.282,324,0.58,23,0.625,6.5,2018-19,Regular%20Season
203957,Dante Exum,1610612762,UTA,31,15,16,526.0,16,5,11,0.313,33,0.485,0,0.485,11.7,50,9,41,0.18,87,0.575,7,0.625,8.6,66,14,52,0.212,116,0.569,7,0.606,9.4,2018-19,Regular%20Season
1627863,Danuel House Jr.,1610612745,HOU,37,26,11,946.0,25,12,13,0.48,58,0.431,1,0.439,11.1,115,20,95,0.174,206,0.558,18,0.612,7.6,140,32,108,0.229,264,0.53,19,0.571,8.2,2018-19,Regular%20Season
203967,Dario Saric,1610612750,MIN,80,38,42,2001.0,126,82,44,0.651,356,0.354,14,0.368,7.0,331,98,233,0.296,594,0.557,50,0.608,5.5,457,180,277,0.394,921,0.496,64,0.533,5.9,2018-19,Regular%20Season
203121,Darius Miller,1610612740,NOP,58,24,34,1503.0,14,3,10,0.214,44,0.318,6,0.368,20.3,114,28,85,0.246,194,0.588,17,0.644,9.9,128,31,95,0.242,234,0.547,23,0.607,11.0,2018-19,Regular%20Season
201954,Darren Collison,1610612754,IND,71,43,28,2027.0,36,7,29,0.194,112,0.321,5,0.336,17.5,196,13,182,0.066,340,0.576,30,0.632,9.8,232,20,211,0.086,450,0.516,35,0.559,11.0,2018-19,Regular%20Season
1629133,Daryl Macon,1610612742,DAL,3,2,1,77.0,2,0,2,0.0,6,0.333,1,0.4,18.7,10,2,8,0.2,19,0.526,1,0.556,5.9,12,2,10,0.167,25,0.48,2,0.522,8.0,2018-19,Regular%20Season
1628021,David Nwaba,1610612739,CLE,47,14,33,931.0,41,23,17,0.561,107,0.383,5,0.402,8.3,122,26,91,0.213,209,0.584,20,0.646,6.7,163,49,108,0.301,309,0.528,25,0.574,7.1,2018-19,Regular%20Season
202722,Davis Bertans,1610612759,SAS,72,42,30,1585.0,23,7,16,0.304,65,0.354,1,0.359,9.4,241,51,189,0.212,408,0.591,34,0.644,6.3,264,58,205,0.22,451,0.585,35,0.635,6.5,2018-19,Regular%20Season
1628432,Davon Reed,1610612754,IND,3,2,1,31.0,2,1,1,0.5,5,0.4,0,0.4,3.9,4,2,2,0.5,5,0.8,1,1.0,7.1,6,3,3,0.5,10,0.6,1,0.667,6.1,2018-19,Regular%20Season
1628368,De'Aaron Fox,1610612758,SAC,79,38,41,2488.0,43,12,29,0.279,152,0.283,13,0.309,12.6,261,40,219,0.153,459,0.569,45,0.63,8.7,304,52,248,0.171,608,0.5,58,0.553,9.2,2018-19,Regular%20Season
1629001,De'Anthony Melton,1610612756,PHX,46,13,33,953.0,25,16,9,0.64,66,0.379,4,0.403,7.4,109,28,81,0.257,203,0.537,20,0.596,6.7,134,44,90,0.328,263,0.51,24,0.561,6.9,2018-19,Regular%20Season
201599,DeAndre Jordan,1610612752,NYK,69,25,44,2047.0,225,136,87,0.604,510,0.441,8,0.448,5.6,677,173,503,0.256,935,0.724,51,0.766,4.2,902,309,590,0.343,1402,0.643,59,0.672,4.6,2018-19,Regular%20Season
1627761,DeAndre' Bembry,1610612737,ATL,80,28,52,1883.0,54,27,25,0.5,168,0.321,5,0.331,10.3,304,59,247,0.194,483,0.629,31,0.673,7.6,358,86,272,0.24,633,0.566,36,0.6,8.0,2018-19,Regular%20Season
201942,DeMar DeRozan,1610612759,SAS,76,43,33,2652.0,54,25,28,0.463,207,0.261,9,0.273,10.9,408,59,349,0.145,636,0.642,50,0.696,6.7,462,84,377,0.182,810,0.57,59,0.615,7.2,2018-19,Regular%20Season
202326,DeMarcus Cousins,1610612744,GSW,30,23,7,771.0,43,25,18,0.581,117,0.368,2,0.374,4.6,204,57,147,0.279,315,0.648,20,0.692,4.5,247,82,165,0.332,417,0.592,22,0.625,4.5,2018-19,Regular%20Season
201960,DeMarre Carroll,1610612751,BKN,67,36,31,1703.0,68,27,40,0.397,188,0.362,6,0.374,9.5,281,46,232,0.164,492,0.571,51,0.637,6.3,349,73,272,0.209,662,0.527,57,0.577,6.9,2018-19,Regular%20Season
1629152,DeVaughn Akoon-Purcell,1610612743,DEN,3,3,0,11.0,1,0,1,0.0,3,0.333,0,0.333,26.3,3,0,3,0.0,6,0.5,2,0.75,11.8,4,0,4,0.0,9,0.444,2,0.571,15.4,2018-19,Regular%20Season
1629028,Deandre Ayton,1610612756,PHX,71,17,54,2183.0,223,156,66,0.7,479,0.466,12,0.478,5.5,506,149,355,0.294,785,0.645,59,0.697,4.4,729,305,421,0.418,1212,0.601,71,0.639,4.8,2018-19,Regular%20Season
1626153,Delon Wright,1610612763,MEM,67,38,29,1593.0,68,31,38,0.456,170,0.4,3,0.407,8.5,198,31,167,0.157,337,0.588,39,0.664,7.3,266,62,205,0.233,491,0.542,42,0.592,7.6,2018-19,Regular%20Season
1627743,Demetrius Jackson,1610612755,PHI,2,1,1,14.0,2,0,2,0.0,3,0.667,0,0.667,12.0,1,0,1,0.0,1,1.0,0,1.0,2.8,3,0,3,0.0,4,0.75,0,0.75,8.9,2018-19,Regular%20Season
1629061,Deng Adel,1610612739,CLE,13,3,10,178.0,3,1,2,0.333,9,0.333,0,0.333,14.3,16,3,13,0.188,34,0.471,3,0.516,7.9,19,4,15,0.211,43,0.442,3,0.475,8.9,2018-19,Regular%20Season
203471,Dennis Schroder,1610612760,OKC,76,45,31,2238.0,38,6,32,0.158,144,0.264,9,0.281,16.9,242,19,222,0.079,372,0.651,20,0.688,9.2,280,25,254,0.089,512,0.547,29,0.58,10.3,2018-19,Regular%20Season
1628372,Dennis Smith Jr.,1610612752,NYK,50,19,31,1441.0,32,14,18,0.438,116,0.276,11,0.305,12.1,123,18,105,0.146,255,0.482,37,0.564,7.6,155,32,123,0.206,369,0.42,48,0.483,8.6,2018-19,Regular%20Season
1629126,Deonte Burton,1610612760,OKC,16,10,6,176.0,4,1,3,0.25,20,0.2,1,0.211,8.1,24,10,14,0.417,55,0.436,11,0.545,7.8,28,11,17,0.393,75,0.373,12,0.444,7.9,2018-19,Regular%20Season
202324,Derrick Favors,1610612762,UTA,74,45,29,1732.0,202,145,55,0.718,398,0.508,5,0.514,4.6,347,108,240,0.311,597,0.581,64,0.651,4.7,549,253,295,0.461,964,0.57,69,0.613,4.7,2018-19,Regular%20Season
1627884,Derrick Jones Jr.,1610612748,MIA,55,30,25,1110.0,96,58,40,0.604,199,0.482,6,0.497,6.4,144,37,106,0.257,253,0.569,23,0.626,6.8,240,95,146,0.396,434,0.553,29,0.593,6.7,2018-19,Regular%20Season
201565,Derrick Rose,1610612750,MIN,49,24,25,1358.0,33,12,21,0.364,105,0.314,5,0.33,12.5,107,11,95,0.103,221,0.484,23,0.54,9.5,140,23,116,0.164,324,0.432,28,0.473,10.2,2018-19,Regular%20Season
1628401,Derrick White,1610612759,SAS,64,40,24,1651.0,35,15,20,0.429,95,0.368,4,0.385,10.0,212,28,184,0.132,357,0.594,32,0.652,6.8,247,43,204,0.174,450,0.549,36,0.597,7.2,2018-19,Regular%20Season
1626164,Devin Booker,1610612756,PHX,60,14,46,2153.0,39,18,22,0.462,129,0.302,2,0.307,12.3,225,25,200,0.111,375,0.6,21,0.636,8.7,264,43,222,0.163,494,0.534,23,0.561,9.2,2018-19,Regular%20Season
2734,Devin Harris,1610612742,DAL,55,26,29,905.0,12,4,8,0.333,38,0.316,2,0.333,16.7,100,16,84,0.16,163,0.613,11,0.658,9.1,112,20,92,0.179,197,0.569,13,0.609,9.9,2018-19,Regular%20Season
1628421,Devin Robinson,1610612764,WAS,5,0,5,88.0,6,4,2,0.667,10,0.6,0,0.6,6.3,14,4,10,0.286,28,0.5,0,0.5,5.1,20,8,12,0.4,37,0.541,0,0.541,5.5,2018-19,Regular%20Season
1628984,Devonte' Graham,1610612766,CHA,31,10,21,585.0,10,5,5,0.5,34,0.294,3,0.323,13.6,53,11,42,0.208,96,0.552,12,0.631,7.7,63,16,47,0.254,127,0.496,15,0.563,8.6,2018-19,Regular%20Season
203473,Dewayne Dedmon,1610612737,ATL,63,24,39,1588.0,105,67,38,0.638,263,0.399,8,0.412,6.1,374,114,261,0.305,597,0.626,41,0.673,4.9,479,181,299,0.378,820,0.584,49,0.621,5.2,2018-19,Regular%20Season
1627738,Deyonta Davis,1610612737,ATL,8,3,5,118.0,10,7,2,0.7,32,0.313,1,0.323,3.5,26,8,18,0.308,40,0.65,4,0.722,6.2,36,15,20,0.417,66,0.545,5,0.59,5.5,2018-19,Regular%20Season
1628415,Dillon Brooks,1610612763,MEM,13,8,5,254.0,9,4,5,0.444,20,0.45,0,0.45,5.6,22,6,16,0.273,39,0.564,7,0.688,5.8,31,10,21,0.323,57,0.544,7,0.62,5.8,2018-19,Regular%20Season
203079,Dion Waiters,1610612748,MIA,41,20,21,1044.0,7,3,5,0.429,37,0.189,1,0.194,15.9,109,16,93,0.147,191,0.571,19,0.634,9.6,116,19,98,0.164,228,0.509,20,0.558,10.0,2018-19,Regular%20Season
1717,Dirk Nowitzki,1610612742,DAL,44,15,29,711.0,5,2,3,0.4,29,0.172,2,0.185,6.0,153,43,110,0.281,261,0.586,23,0.643,4.6,158,45,113,0.285,279,0.566,25,0.622,4.7,2018-19,Regular%20Season
1627734,Domantas Sabonis,1610612754,IND,74,43,31,1838.0,186,129,58,0.694,436,0.427,13,0.44,4.7,504,143,361,0.284,819,0.615,79,0.681,3.9,690,272,419,0.394,1211,0.57,92,0.617,4.1,2018-19,Regular%20Season
202700,Donatas Motiejunas,1610612759,SAS,3,3,0,13.0,2,1,1,0.5,3,0.667,0,0.667,7.7,1,0,1,0.0,3,0.333,0,0.333,2.5,3,1,2,0.333,6,0.5,0,0.5,5.9,2018-19,Regular%20Season
1628378,Donovan Mitchell,1610612762,UTA,76,49,27,2564.0,59,27,31,0.458,180,0.328,13,0.353,9.6,256,44,211,0.172,394,0.65,23,0.69,9.2,315,71,242,0.225,564,0.559,36,0.597,9.3,2018-19,Regular%20Season
1628978,Donte DiVincenzo,1610612749,MIL,23,18,5,386.0,16,12,4,0.75,35,0.457,1,0.471,8.0,49,7,42,0.143,85,0.576,10,0.653,7.7,65,19,46,0.292,120,0.542,11,0.596,7.7,2018-19,Regular%20Season
1627827,Dorian Finney-Smith,1610612742,DAL,80,33,47,1974.0,138,88,47,0.638,303,0.455,10,0.471,6.5,251,66,185,0.263,467,0.537,63,0.621,5.9,389,154,232,0.396,748,0.52,73,0.576,6.1,2018-19,Regular%20Season
203926,Doug McDermott,1610612754,IND,54,30,24,960.0,17,9,8,0.529,44,0.386,1,0.395,16.0,92,23,68,0.25,171,0.538,13,0.582,7.0,109,32,76,0.294,208,0.524,14,0.562,8.4,2018-19,Regular%20Season
1627733,Dragan Bender,1610612756,PHX,41,8,33,806.0,34,21,13,0.618,92,0.37,0,0.37,6.4,149,41,108,0.275,269,0.554,24,0.608,4.2,183,62,121,0.339,338,0.541,24,0.583,4.6,2018-19,Regular%20Season
203110,Draymond Green,1610612744,GSW,66,48,18,2065.0,60,29,31,0.483,184,0.326,7,0.339,8.4,421,127,287,0.302,692,0.608,50,0.656,5.0,481,156,318,0.324,830,0.58,57,0.622,5.5,2018-19,Regular%20Season
1629234,Drew Eubanks,1610612759,SAS,16,9,7,97.0,6,4,2,0.667,16,0.375,0,0.375,3.9,28,11,17,0.393,39,0.718,2,0.757,4.2,34,15,19,0.441,51,0.667,2,0.694,4.1,2018-19,Regular%20Season
1629130,Duncan Robinson,1610612748,MIA,10,4,6,133.0,2,1,2,0.5,7,0.286,0,0.286,14.7,17,1,16,0.059,32,0.531,6,0.654,8.2,19,2,18,0.105,38,0.5,6,0.594,9.0,2018-19,Regular%20Season
1628605,Dusty Hannahs,1610612763,MEM,1,0,1,14.0,0,0,0,0.0,1,0.0,0,0.0,0.0,1,0,1,0.0,1,1.0,0,1.0,6.2,1,0,1,0.0,2,0.5,0,0.5,6.2,2018-19,Regular%20Season
1628407,Dwayne Bacon,1610612766,CHA,31,14,17,674.0,8,2,6,0.25,37,0.216,1,0.222,16.0,81,23,58,0.284,136,0.596,15,0.669,6.8,89,25,64,0.281,170,0.524,16,0.578,7.6,2018-19,Regular%20Season
2730,Dwight Howard,1610612764,WAS,9,4,5,230.0,24,17,7,0.708,57,0.421,0,0.421,3.0,59,16,43,0.271,97,0.608,8,0.663,4.0,83,33,50,0.398,149,0.557,8,0.589,3.7,2018-19,Regular%20Season
203939,Dwight Powell,1610612742,DAL,76,30,46,1660.0,140,76,64,0.543,363,0.386,6,0.392,7.4,271,57,214,0.21,453,0.598,39,0.655,6.1,411,133,278,0.324,792,0.519,45,0.55,6.5,2018-19,Regular%20Season
2548,Dwyane Wade,1610612748,MIA,71,34,37,1863.0,69,37,31,0.536,137,0.504,15,0.566,8.4,216,30,186,0.139,359,0.602,40,0.677,7.5,285,67,217,0.235,488,0.584,55,0.658,7.7,2018-19,Regular%20Season
1629058,Dzanan Musa,1610612751,BKN,4,1,3,23.0,1,0,1,0.0,3,0.333,0,0.333,16.4,4,3,1,0.75,5,0.8,0,0.8,3.8,5,3,2,0.6,8,0.625,0,0.625,6.3,2018-19,Regular%20Season
202734,E'Twaun Moore,1610612740,NOP,49,19,30,1369.0,34,19,15,0.559,88,0.386,2,0.395,11.1,92,20,73,0.217,150,0.613,6,0.639,10.9,126,39,88,0.31,234,0.538,8,0.558,10.9,2018-19,Regular%20Season
202334,Ed Davis,1610612751,BKN,81,42,39,1446.0,216,147,67,0.681,485,0.445,10,0.455,5.1,478,134,346,0.28,734,0.651,50,0.699,4.3,694,281,413,0.405,1184,0.586,60,0.617,4.6,2018-19,Regular%20Season
1628410,Edmond Sumner,1610612754,IND,10,7,3,144.0,9,8,1,0.889,20,0.45,0,0.45,5.4,15,1,14,0.067,25,0.6,3,0.682,10.3,24,9,15,0.375,45,0.533,3,0.571,8.5,2018-19,Regular%20Season
202327,Ekpe Udoh,1610612762,UTA,36,26,10,267.0,26,18,8,0.692,65,0.4,3,0.419,4.7,62,17,45,0.274,105,0.59,6,0.626,5.5,88,35,53,0.398,167,0.527,9,0.557,5.3,2018-19,Regular%20Season
203901,Elfrid Payton,1610612740,NOP,41,17,24,1226.0,49,21,26,0.429,131,0.374,8,0.398,10.3,171,23,149,0.135,275,0.622,22,0.676,7.9,220,44,175,0.2,399,0.551,30,0.596,8.5,2018-19,Regular%20Season
1629059,Elie Okobo,1610612756,PHX,41,5,36,860.0,12,3,9,0.25,36,0.333,2,0.353,18.4,86,11,76,0.128,147,0.585,6,0.61,9.2,98,14,85,0.143,181,0.541,8,0.566,10.3,2018-19,Regular%20Season
1629150,Emanuel Terry,1610612748,MIA,3,0,3,23.0,3,3,0,1.0,5,0.6,0,0.6,4.7,4,2,2,0.5,8,0.5,1,0.571,3.9,7,5,2,0.714,13,0.538,1,0.583,4.2,2018-19,Regular%20Season
1626144,Emmanuel Mudiay,1610612752,NYK,55,11,44,1533.0,32,15,16,0.469,128,0.25,12,0.276,10.7,157,16,141,0.102,269,0.584,29,0.654,9.5,189,31,157,0.164,387,0.488,41,0.546,9.7,2018-19,Regular%20Season
202683,Enes Freedom,1610612757,POR,67,28,39,1639.0,257,209,47,0.813,611,0.421,14,0.43,3.9,402,114,287,0.284,678,0.593,61,0.652,4.2,659,323,334,0.49,1260,0.523,75,0.556,4.1,2018-19,Regular%20Season
202339,Eric Bledsoe,1610612749,MIL,77,58,19,2269.0,82,51,30,0.622,198,0.414,3,0.421,9.1,280,28,252,0.1,457,0.613,38,0.668,9.3,362,79,282,0.218,646,0.56,41,0.598,9.3,2018-19,Regular%20Season
201569,Eric Gordon,1610612745,HOU,60,38,22,1914.0,17,3,13,0.176,88,0.193,5,0.205,18.3,129,22,105,0.171,238,0.542,16,0.581,9.2,146,25,118,0.171,321,0.455,21,0.487,10.2,2018-19,Regular%20Season
203961,Eric Moreland,1610612761,TOR,5,3,2,43.0,4,4,0,1.0,8,0.5,0,0.5,5.6,16,3,13,0.188,23,0.696,3,0.8,4.0,20,7,13,0.35,31,0.645,3,0.714,4.3,2018-19,Regular%20Season
101141,Ersan Ilyasova,1610612749,MIL,63,46,17,1202.0,94,66,27,0.702,226,0.416,6,0.427,5.6,208,58,149,0.279,351,0.593,31,0.65,5.3,302,124,176,0.411,557,0.542,37,0.581,5.4,2018-19,Regular%20Season
203095,Evan Fournier,1610612753,ORL,75,39,36,2365.0,35,13,21,0.371,109,0.321,5,0.337,12.4,213,43,168,0.202,367,0.58,34,0.64,8.8,248,56,189,0.226,473,0.524,39,0.571,9.3,2018-19,Regular%20Season
202323,Evan Turner,1610612757,POR,70,44,26,1553.0,37,17,20,0.459,127,0.291,8,0.311,9.7,291,43,247,0.148,471,0.618,37,0.671,5.4,328,60,267,0.183,570,0.575,45,0.625,5.9,2018-19,Regular%20Season
1628402,Frank Jackson,1610612740,NOP,48,15,33,1023.0,25,12,12,0.48,76,0.329,3,0.342,9.7,109,19,90,0.174,191,0.571,20,0.637,7.6,134,31,102,0.231,265,0.506,23,0.554,8.0,2018-19,Regular%20Season
1626163,Frank Kaminsky,1610612766,CHA,43,20,23,741.0,39,22,17,0.564,96,0.406,1,0.411,6.5,124,42,82,0.339,236,0.525,27,0.593,4.9,163,64,99,0.393,321,0.508,28,0.556,5.2,2018-19,Regular%20Season
1628412,Frank Mason III,1610612758,SAC,20,10,10,299.0,6,2,4,0.333,21,0.286,2,0.316,11.9,37,5,32,0.135,56,0.661,3,0.698,8.9,43,7,36,0.163,76,0.566,5,0.606,9.3,2018-19,Regular%20Season
1628373,Frank Ntilikina,1610612752,NYK,37,8,29,787.0,12,2,10,0.167,46,0.261,1,0.267,17.9,72,5,67,0.069,133,0.541,10,0.585,10.6,84,7,77,0.083,169,0.497,11,0.532,11.6,2018-19,Regular%20Season
1627832,Fred VanVleet,1610612761,TOR,59,42,17,1629.0,21,4,17,0.19,70,0.3,1,0.304,16.6,146,22,124,0.151,245,0.596,22,0.655,9.8,167,26,141,0.156,313,0.534,23,0.576,10.6,2018-19,Regular%20Season
1627788,Furkan Korkmaz,1610612755,PHI,37,26,11,625.0,16,4,12,0.25,47,0.34,2,0.356,11.4,91,11,81,0.121,137,0.664,6,0.695,6.9,107,15,93,0.14,173,0.618,8,0.648,7.6,2018-19,Regular%20Season
202066,Garrett Temple,1610612746,LAC,72,37,35,1981.0,28,10,18,0.357,97,0.289,8,0.315,12.7,188,41,148,0.218,322,0.584,26,0.635,8.7,216,51,166,0.236,399,0.541,34,0.592,9.2,2018-19,Regular%20Season
1629109,Gary Clark,1610612745,HOU,39,24,15,576.0,24,10,14,0.417,57,0.421,2,0.436,11.8,92,23,69,0.25,163,0.564,12,0.609,6.3,116,33,83,0.284,213,0.545,14,0.583,7.4,2018-19,Regular%20Season
203914,Gary Harris,1610612743,DEN,54,38,16,1557.0,41,14,27,0.341,114,0.36,1,0.363,11.2,119,20,97,0.168,206,0.578,12,0.613,11.2,160,34,124,0.213,316,0.506,13,0.528,11.2,2018-19,Regular%20Season
1627780,Gary Payton II,1610612764,WAS,2,1,1,15.0,1,1,0,1.0,1,1.0,0,1.0,3.0,1,0,1,0.0,5,0.2,1,0.25,2.1,2,1,1,0.5,6,0.333,1,0.4,2.5,2018-19,Regular%20Season
1629018,Gary Trent Jr.,1610612757,POR,9,8,1,92.0,1,0,1,0.0,3,0.333,1,0.5,14.7,10,1,9,0.1,19,0.526,2,0.588,7.3,11,1,10,0.091,22,0.5,3,0.579,8.0,2018-19,Regular%20Season
201588,George Hill,1610612749,MIL,55,37,18,1217.0,39,18,21,0.462,97,0.402,4,0.419,8.6,109,19,90,0.174,208,0.524,10,0.551,8.4,148,37,111,0.25,302,0.49,14,0.514,8.5,2018-19,Regular%20Season
1628994,George King,1610612756,PHX,1,0,1,6.0,0,0,0,0.0,0,0.0,0,0.0,0.0,1,0,1,0.0,2,0.5,0,0.5,11.6,1,0,1,0.0,2,0.5,0,0.5,11.6,2018-19,Regular%20Season
1627777,Georges Niang,1610612762,UTA,40,27,13,414.0,11,3,8,0.273,30,0.367,1,0.379,18.3,76,12,64,0.158,124,0.613,8,0.655,6.5,87,15,72,0.172,145,0.6,9,0.64,8.0,2018-19,Regular%20Season
101123,Gerald Green,1610612745,HOU,68,45,23,1411.0,30,5,23,0.167,72,0.417,4,0.441,13.8,152,19,131,0.125,274,0.555,20,0.598,7.7,182,24,154,0.132,334,0.545,24,0.587,8.6,2018-19,Regular%20Season
203507,Giannis Antetokounmpo,1610612749,MIL,72,56,16,2358.0,159,105,53,0.66,401,0.397,9,0.406,6.4,739,176,562,0.238,1044,0.708,74,0.762,4.6,898,281,615,0.313,1378,0.652,83,0.693,5.0,2018-19,Regular%20Season
203922,Glenn Robinson III,1610612765,DET,31,15,16,483.0,17,8,9,0.471,57,0.298,2,0.309,7.8,54,7,47,0.13,108,0.5,6,0.529,7.2,71,15,56,0.211,158,0.449,8,0.473,7.3,2018-19,Regular%20Season
201609,Goran Dragic,1610612748,MIA,33,16,17,926.0,20,4,16,0.2,60,0.333,4,0.357,12.7,91,11,80,0.121,169,0.538,16,0.595,9.1,111,15,96,0.135,226,0.491,20,0.539,9.7,2018-19,Regular%20Season
202330,Gordon Hayward,1610612738,BOS,71,43,28,1862.0,51,28,25,0.549,172,0.297,6,0.307,9.8,271,36,235,0.133,418,0.648,25,0.69,7.3,322,64,260,0.199,558,0.577,31,0.611,7.7,2018-19,Regular%20Season
203476,Gorgui Dieng,1610612750,MIN,73,32,41,1012.0,81,50,30,0.617,210,0.386,4,0.393,7.0,230,54,175,0.235,366,0.628,27,0.678,5.0,311,104,205,0.334,546,0.57,31,0.604,5.5,2018-19,Regular%20Season
1628960,Grayson Allen,1610612762,UTA,14,10,4,185.0,3,1,2,0.333,6,0.5,0,0.5,18.5,20,3,18,0.15,28,0.714,2,0.769,10.6,23,4,20,0.174,34,0.676,2,0.719,11.6,2018-19,Regular%20Season
202328,Greg Monroe,1610612755,PHI,40,26,14,475.0,67,46,21,0.687,148,0.453,3,0.462,4.9,105,35,70,0.333,164,0.64,13,0.695,4.4,172,81,91,0.471,302,0.57,16,0.601,4.6,2018-19,Regular%20Season
1627824,Guerschon Yabusele,1610612738,BOS,24,18,6,193.0,23,13,9,0.565,40,0.575,1,0.59,8.6,30,8,22,0.267,58,0.517,7,0.588,6.1,53,21,31,0.396,96,0.552,8,0.602,7.2,2018-19,Regular%20Season
1628977,Hamidou Diallo,1610612760,OKC,40,23,17,478.0,38,23,15,0.605,76,0.5,2,0.514,5.1,59,14,45,0.237,92,0.641,5,0.678,8.6,97,37,60,0.381,165,0.588,7,0.614,7.2,2018-19,Regular%20Season
203084,Harrison Barnes,1610612758,SAC,77,34,43,2533.0,57,29,28,0.509,177,0.322,7,0.335,8.8,304,55,249,0.181,495,0.614,42,0.671,6.7,361,84,277,0.233,647,0.558,49,0.604,7.0,2018-19,Regular%20Season
1628385,Harry Giles III,1610612758,SAC,53,23,30,791.0,66,48,17,0.727,140,0.471,3,0.482,4.6,156,44,112,0.282,282,0.553,27,0.612,4.9,222,92,129,0.414,404,0.55,30,0.594,4.8,2018-19,Regular%20Season
202355,Hassan Whiteside,1610612748,MIA,72,33,39,1674.0,257,194,58,0.755,506,0.508,10,0.518,4.3,560,184,379,0.329,861,0.65,65,0.704,3.9,817,378,437,0.463,1319,0.619,75,0.657,4.1,2018-19,Regular%20Season
1629312,Haywood Highsmith,1610612755,PHI,4,1,3,35.0,0,0,0,0.0,5,0.0,0,0.0,0.0,5,0,5,0.0,7,0.714,0,0.714,7.0,5,0,5,0.0,11,0.455,0,0.455,7.0,2018-19,Regular%20Season
1627740,Henry Ellenson,1610612752,NYK,15,3,12,237.0,5,2,3,0.4,28,0.179,1,0.185,6.1,61,11,50,0.18,92,0.663,11,0.753,4.3,66,13,53,0.197,110,0.6,12,0.673,4.4,2018-19,Regular%20Season
203546,Ian Clark,1610612740,NOP,42,17,25,789.0,13,4,9,0.308,41,0.317,2,0.333,15.5,76,10,66,0.132,129,0.589,15,0.667,9.7,89,14,75,0.157,169,0.527,17,0.586,10.5,2018-19,Regular%20Season
101133,Ian Mahinmi,1610612764,WAS,31,10,21,476.0,48,29,20,0.604,114,0.421,2,0.429,5.8,80,27,51,0.338,167,0.479,16,0.53,5.6,128,56,71,0.438,276,0.464,18,0.496,5.7,2018-19,Regular%20Season
1628387,Ike Anigbogu,1610612754,IND,3,2,1,6.0,1,1,0,1.0,4,0.25,0,0.25,3.0,2,1,1,0.5,2,1.0,0,1.0,5.6,3,2,1,0.667,6,0.5,0,0.5,4.7,2018-19,Regular%20Season
202697,Iman Shumpert,1610612745,HOU,58,36,22,1376.0,27,12,15,0.444,93,0.29,7,0.314,12.2,156,25,132,0.16,262,0.595,20,0.645,7.4,183,37,147,0.202,330,0.555,27,0.604,8.1,2018-19,Regular%20Season
1629067,Isaac Bonga,1610612747,LAL,14,5,9,108.0,9,2,7,0.222,17,0.529,0,0.529,11.3,16,7,9,0.438,28,0.571,8,0.8,5.5,25,9,16,0.36,43,0.581,8,0.714,7.6,2018-19,Regular%20Season
1629353,Isaac Humphries,1610612737,ATL,4,0,4,51.0,4,1,3,0.25,8,0.5,1,0.571,7.0,7,1,6,0.143,12,0.583,0,0.583,3.6,11,2,9,0.182,19,0.579,1,0.611,4.8,2018-19,Regular%20Season
1628515,Isaiah Briscoe,1610612753,ORL,28,13,15,496.0,5,1,4,0.2,16,0.313,0,0.313,8.2,69,10,59,0.145,105,0.657,7,0.704,8.7,74,11,63,0.149,121,0.612,7,0.649,8.6,2018-19,Regular%20Season
203477,Isaiah Canaan,1610612749,MIL,24,7,17,535.0,6,2,4,0.333,20,0.3,2,0.333,21.3,51,7,44,0.137,86,0.593,12,0.689,9.3,57,9,48,0.158,104,0.548,14,0.633,10.5,2018-19,Regular%20Season
1628392,Isaiah Hartenstein,1610612745,HOU,22,14,8,203.0,21,17,4,0.81,61,0.344,2,0.356,5.4,26,11,14,0.423,63,0.413,4,0.441,7.1,47,28,18,0.596,120,0.392,6,0.412,6.4,2018-19,Regular%20Season
1628439,Isaiah Hicks,1610612752,NYK,2,1,1,29.0,2,1,1,0.5,9,0.222,0,0.222,9.9,5,1,4,0.2,10,0.5,2,0.625,3.5,7,2,5,0.286,18,0.389,2,0.438,5.3,2018-19,Regular%20Season
202738,Isaiah Thomas,1610612743,DEN,9,4,5,137.0,5,1,4,0.2,15,0.333,0,0.333,16.9,8,2,5,0.25,12,0.667,1,0.727,10.2,13,3,9,0.231,27,0.481,1,0.5,13.0,2018-19,Regular%20Season
202397,Ish Smith,1610612765,DET,53,31,22,1209.0,23,7,17,0.304,68,0.338,3,0.354,13.9,122,20,102,0.164,238,0.513,27,0.578,8.2,145,27,119,0.186,295,0.492,30,0.547,9.1,2018-19,Regular%20Season
1628397,Ivan Rabb,1610612763,MEM,44,20,24,707.0,70,55,15,0.786,174,0.402,6,0.417,5.8,136,48,87,0.353,216,0.63,22,0.701,4.6,206,103,102,0.5,380,0.542,28,0.585,5.0,2018-19,Regular%20Season
1627826,Ivica Zubac,1610612746,LAC,58,32,26,1037.0,115,88,26,0.765,264,0.436,3,0.441,4.1,247,91,156,0.368,426,0.58,49,0.655,4.3,362,179,182,0.494,670,0.54,52,0.586,4.2,2018-19,Regular%20Season
200826,J.J. Barea,1610612742,DAL,37,20,17,727.0,13,0,13,0.0,42,0.31,4,0.342,14.2,82,6,75,0.073,122,0.672,4,0.695,9.3,95,6,88,0.063,163,0.583,8,0.613,10.0,2018-19,Regular%20Season
1629122,J.P. Macura,1610612766,CHA,2,1,1,17.0,0,0,0,0.0,4,0.0,0,0.0,0.0,3,0,3,0.0,4,0.75,0,0.75,5.8,3,0,3,0.0,8,0.375,0,0.375,5.8,2018-19,Regular%20Season
200755,JJ Redick,1610612755,PHI,66,45,21,2076.0,20,5,15,0.25,60,0.333,8,0.385,18.3,164,18,146,0.11,302,0.543,21,0.584,10.3,184,23,161,0.125,359,0.513,29,0.558,11.1,2018-19,Regular%20Season
2747,JR Smith,1610612739,CLE,9,1,8,213.0,0,0,0,0.0,7,0.0,1,0.0,0.0,18,3,15,0.167,35,0.514,2,0.545,7.3,18,3,15,0.167,38,0.474,3,0.514,7.3,2018-19,Regular%20Season
203960,JaKarr Sampson,1610612741,CHI,4,1,3,127.0,5,2,3,0.4,17,0.294,1,0.313,8.6,27,4,23,0.148,37,0.73,0,0.73,4.2,32,6,26,0.188,49,0.653,1,0.667,4.9,2018-19,Regular%20Season
203210,JaMychal Green,1610612746,LAC,65,31,34,1371.0,104,73,33,0.702,271,0.384,1,0.385,5.2,305,70,234,0.23,445,0.685,33,0.74,5.1,409,143,267,0.35,675,0.606,34,0.638,5.1,2018-19,Regular%20Season
201580,JaVale McGee,1610612747,LAL,75,35,40,1671.0,195,139,56,0.713,386,0.505,7,0.515,4.8,371,119,251,0.321,635,0.584,52,0.636,4.1,566,258,307,0.456,990,0.572,59,0.608,4.4,2018-19,Regular%20Season
203953,Jabari Parker,1610612764,WAS,63,18,45,1720.0,79,49,28,0.62,227,0.348,6,0.357,7.2,341,79,262,0.232,554,0.616,42,0.666,6.0,420,128,290,0.305,739,0.568,48,0.608,6.2,2018-19,Regular%20Season
1628980,Jacob Evans,1610612744,GSW,12,8,4,159.0,6,3,3,0.5,8,0.75,0,0.75,9.9,19,6,13,0.316,31,0.613,1,0.633,8.1,25,9,16,0.36,39,0.641,1,0.658,8.6,2018-19,Regular%20Season
203109,Jae Crowder,1610612762,UTA,77,46,31,2089.0,59,16,43,0.271,158,0.373,3,0.381,13.1,318,47,270,0.148,500,0.636,38,0.688,6.6,377,63,313,0.167,618,0.61,41,0.653,7.6,2018-19,Regular%20Season
1626143,Jahlil Okafor,1610612740,NOP,51,19,32,904.0,82,56,25,0.683,202,0.406,2,0.41,4.7,196,60,136,0.306,341,0.575,38,0.647,5.1,278,116,161,0.417,527,0.528,40,0.571,5.0,2018-19,Regular%20Season
1627774,Jake Layman,1610612757,POR,63,43,20,1254.0,56,27,28,0.482,128,0.438,4,0.452,8.9,161,33,128,0.205,277,0.581,22,0.631,6.5,217,60,156,0.276,393,0.552,26,0.591,7.1,2018-19,Regular%20Season
1627751,Jakob Poeltl,1610612759,SAS,75,42,33,1261.0,178,127,50,0.713,324,0.549,4,0.556,5.3,232,93,140,0.401,431,0.538,61,0.627,4.4,410,220,190,0.537,739,0.555,65,0.608,4.8,2018-19,Regular%20Season
1628973,Jalen Brunson,1610612742,DAL,54,14,40,1338.0,25,9,16,0.36,80,0.313,6,0.338,11.7,144,24,120,0.167,232,0.621,15,0.664,8.8,169,33,136,0.195,309,0.547,21,0.587,9.3,2018-19,Regular%20Season
1627883,Jalen Jones,1610612739,CLE,13,2,11,190.0,11,5,6,0.455,35,0.314,1,0.324,4.0,23,4,19,0.174,40,0.575,3,0.622,4.6,34,9,25,0.265,72,0.472,4,0.5,4.4,2018-19,Regular%20Season
2037,Jamal Crawford,1610612756,PHX,40,10,30,864.0,8,1,7,0.125,21,0.381,0,0.381,20.5,77,7,70,0.091,106,0.726,5,0.762,10.9,85,8,77,0.094,125,0.68,5,0.708,11.8,2018-19,Regular%20Season
1627750,Jamal Murray,1610612743,DEN,72,48,24,2360.0,65,34,31,0.523,181,0.359,11,0.382,10.8,252,39,212,0.155,398,0.633,33,0.69,9.0,317,73,243,0.23,568,0.558,44,0.605,9.4,2018-19,Regular%20Season
203516,James Ennis III,1610612755,PHI,51,31,20,1147.0,60,37,23,0.617,148,0.405,2,0.411,6.5,121,13,108,0.107,249,0.486,32,0.558,6.4,181,50,131,0.276,388,0.466,34,0.511,6.4,2018-19,Regular%20Season
201935,James Harden,1610612745,HOU,78,51,27,2867.0,66,32,35,0.485,260,0.254,9,0.263,10.3,452,78,371,0.173,702,0.644,56,0.7,6.9,518,110,406,0.212,903,0.574,65,0.618,7.4,2018-19,Regular%20Season
201949,James Johnson,1610612748,MIA,52,26,26,1116.0,22,14,8,0.636,62,0.355,3,0.373,7.2,153,32,121,0.209,268,0.571,22,0.622,6.5,175,46,129,0.263,326,0.537,25,0.581,6.6,2018-19,Regular%20Season
203263,James Nunnally,1610612745,HOU,3,1,2,50.0,0,0,0,0.0,4,0.0,2,0.0,0.0,5,1,4,0.2,7,0.714,1,0.833,5.6,5,1,4,0.2,9,0.556,3,0.833,5.6,2018-19,Regular%20Season
201162,Jared Dudley,1610612751,BKN,50,25,25,1094.0,34,16,18,0.471,87,0.391,2,0.4,7.3,121,27,94,0.223,280,0.432,35,0.494,6.2,155,43,112,0.277,355,0.437,37,0.487,6.4,2018-19,Regular%20Season
1629123,Jared Terrell,1610612750,MIN,5,1,4,64.0,0,0,0,0.0,2,0.0,1,0.0,0.0,5,0,5,0.0,8,0.625,0,0.625,10.3,5,0,5,0.0,10,0.5,1,0.556,10.3,2018-19,Regular%20Season
1626185,Jarell Martin,1610612753,ORL,31,15,16,288.0,11,8,3,0.727,37,0.297,1,0.306,5.2,62,14,48,0.226,98,0.633,6,0.674,5.0,73,22,51,0.301,131,0.557,7,0.589,5.0,2018-19,Regular%20Season
1628991,Jaren Jackson Jr.,1610612763,MEM,57,22,35,1500.0,73,59,15,0.808,182,0.401,7,0.417,5.6,199,77,120,0.387,379,0.525,36,0.58,6.3,272,136,135,0.5,555,0.49,43,0.531,6.1,2018-19,Regular%20Season
1628417,Jaron Blossomgame,1610612739,CLE,26,4,22,422.0,26,13,12,0.5,56,0.464,0,0.464,6.1,72,15,56,0.208,118,0.61,9,0.661,4.2,98,28,68,0.286,171,0.573,9,0.605,4.7,2018-19,Regular%20Season
1629020,Jarred Vanderbilt,1610612743,DEN,9,4,5,56.0,6,6,0,1.0,19,0.316,0,0.316,3.7,16,5,11,0.313,26,0.615,4,0.727,4.5,22,11,11,0.5,45,0.489,4,0.537,4.3,2018-19,Regular%20Season
1628386,Jarrett Allen,1610612751,BKN,80,42,38,2096.0,191,122,70,0.639,452,0.423,9,0.431,5.4,481,124,356,0.258,864,0.557,75,0.61,4.5,672,246,426,0.366,1270,0.529,84,0.567,4.7,2018-19,Regular%20Season
201160,Jason Smith,1610612740,NOP,18,9,9,180.0,16,11,5,0.688,39,0.41,0,0.41,5.5,36,8,28,0.222,68,0.529,4,0.563,5.2,52,19,33,0.365,104,0.5,4,0.52,5.3,2018-19,Regular%20Season
1628393,Jawun Evans,1610612760,OKC,4,2,2,54.0,1,1,0,1.0,1,1.0,0,1.0,4.4,11,1,10,0.091,14,0.786,0,0.786,8.2,12,2,10,0.167,15,0.8,0,0.8,7.9,2018-19,Regular%20Season
1629121,Jaylen Adams,1610612737,ATL,26,10,16,376.0,11,4,7,0.364,26,0.423,0,0.423,14.4,49,2,48,0.041,85,0.576,6,0.62,9.2,60,6,55,0.1,109,0.55,6,0.583,10.1,2018-19,Regular%20Season
1627759,Jaylen Brown,1610612738,BOS,74,41,33,1913.0,65,32,32,0.492,185,0.351,8,0.367,9.1,248,42,206,0.169,431,0.575,45,0.642,6.3,313,74,238,0.236,598,0.523,53,0.574,6.8,2018-19,Regular%20Season
1628537,Jaylen Morris,1610612749,MIL,4,4,0,29.0,0,0,0,0.0,0,0.0,0,0.0,0.0,5,2,3,0.4,7,0.714,0,0.714,10.1,5,2,3,0.4,7,0.714,0,0.714,10.1,2018-19,Regular%20Season
1628369,Jayson Tatum,1610612738,BOS,79,48,31,2455.0,70,33,37,0.471,203,0.345,8,0.359,10.1,407,65,341,0.16,590,0.69,43,0.744,6.3,477,98,378,0.205,758,0.629,51,0.675,6.9,2018-19,Regular%20Season
201145,Jeff Green,1610612764,WAS,73,27,46,2031.0,56,30,26,0.536,126,0.444,7,0.471,8.1,250,59,190,0.236,467,0.535,45,0.592,7.1,306,89,216,0.291,577,0.53,52,0.583,7.3,2018-19,Regular%20Season
201952,Jeff Teague,1610612750,MIN,40,22,18,1221.0,16,4,13,0.25,66,0.242,6,0.267,15.2,90,9,81,0.1,162,0.556,14,0.608,9.8,106,13,94,0.123,224,0.473,20,0.52,10.6,2018-19,Regular%20Season
1629203,Jemerrio Jones,1610612747,LAL,5,3,2,142.0,16,8,8,0.5,34,0.471,2,0.5,9.7,33,7,26,0.212,53,0.623,9,0.75,5.6,49,15,34,0.306,87,0.563,11,0.645,6.9,2018-19,Regular%20Season
203924,Jerami Grant,1610612760,OKC,79,47,32,2578.0,96,47,46,0.49,271,0.354,16,0.376,9.0,312,77,235,0.247,581,0.537,44,0.581,7.2,408,124,281,0.304,826,0.494,60,0.533,7.6,2018-19,Regular%20Season
203087,Jeremy Lamb,1610612766,CHA,78,37,41,2225.0,65,33,31,0.508,173,0.376,4,0.385,7.6,369,75,294,0.203,615,0.6,57,0.661,5.6,434,108,325,0.249,773,0.561,61,0.61,5.9,2018-19,Regular%20Season
202391,Jeremy Lin,1610612761,TOR,67,27,40,1327.0,22,7,15,0.318,78,0.282,3,0.293,16.3,157,27,129,0.172,287,0.547,28,0.606,8.2,179,34,144,0.19,359,0.499,31,0.546,9.2,2018-19,Regular%20Season
1626170,Jerian Grant,1610612753,ORL,42,16,26,767.0,19,6,13,0.316,45,0.422,1,0.432,16.8,74,12,63,0.162,135,0.548,11,0.597,8.5,93,18,76,0.194,177,0.525,12,0.564,10.2,2018-19,Regular%20Season
1629010,Jerome Robinson,1610612746,LAC,23,12,11,263.0,3,1,2,0.333,12,0.25,1,0.273,16.4,37,5,32,0.135,62,0.597,5,0.649,6.9,40,6,34,0.15,74,0.541,6,0.588,7.6,2018-19,Regular%20Season
201573,Jerryd Bayless,1610612750,MIN,23,9,14,526.0,11,2,10,0.182,33,0.333,1,0.344,25.0,51,7,44,0.137,92,0.554,8,0.607,8.0,62,9,54,0.145,124,0.5,9,0.539,11.2,2018-19,Regular%20Season
1628975,Jevon Carter,1610612763,MEM,26,7,19,474.0,14,2,12,0.143,29,0.483,1,0.5,19.9,52,8,43,0.154,89,0.584,9,0.65,9.8,66,10,55,0.152,116,0.569,10,0.623,11.9,2018-19,Regular%20Season
202690,Jimmer Fredette,1610612756,PHX,5,0,5,59.0,1,0,1,0.0,3,0.333,0,0.333,22.5,6,0,6,0.0,13,0.462,2,0.545,8.7,7,0,7,0.0,16,0.438,2,0.5,10.7,2018-19,Regular%20Season
202710,Jimmy Butler,1610612755,PHI,64,38,26,2147.0,120,82,39,0.683,230,0.522,9,0.543,8.3,219,46,172,0.21,377,0.581,35,0.64,7.6,339,128,211,0.378,604,0.561,44,0.605,7.8,2018-19,Regular%20Season
201149,Joakim Noah,1610612763,MEM,42,14,28,693.0,58,39,17,0.672,169,0.343,3,0.349,5.5,180,58,122,0.322,289,0.623,16,0.659,4.1,238,97,139,0.408,439,0.542,19,0.567,4.4,2018-19,Regular%20Season
201975,Jodie Meeks,1610612761,TOR,6,5,1,88.0,1,0,1,0.0,4,0.25,1,0.333,26.9,11,1,10,0.091,20,0.55,0,0.55,8.7,12,1,11,0.083,24,0.5,1,0.522,10.2,2018-19,Regular%20Season
203925,Joe Harris,1610612751,BKN,75,40,35,2265.0,52,24,29,0.462,168,0.31,5,0.319,10.6,239,65,173,0.272,494,0.484,50,0.538,6.7,291,89,202,0.306,650,0.448,55,0.489,7.4,2018-19,Regular%20Season
204060,Joe Ingles,1610612762,UTA,80,49,31,2504.0,34,8,25,0.235,104,0.327,6,0.347,13.5,291,43,247,0.148,469,0.62,41,0.68,7.9,325,51,272,0.157,563,0.577,47,0.63,8.5,2018-19,Regular%20Season
203954,Joel Embiid,1610612755,PHI,63,43,20,2121.0,158,110,48,0.696,437,0.362,10,0.37,4.9,705,203,503,0.288,1094,0.644,97,0.707,4.5,863,313,551,0.363,1471,0.587,107,0.633,4.6,2018-19,Regular%20Season
1628381,John Collins,1610612737,ATL,61,24,37,1828.0,219,166,54,0.758,531,0.412,17,0.426,4.7,376,109,266,0.29,617,0.609,59,0.674,4.1,595,275,320,0.462,1104,0.539,76,0.579,4.3,2018-19,Regular%20Season
203089,John Henson,1610612739,CLE,14,10,4,188.0,16,10,6,0.625,49,0.327,1,0.333,7.6,55,10,44,0.182,85,0.647,6,0.696,5.2,71,20,50,0.282,126,0.563,7,0.597,5.7,2018-19,Regular%20Season
203098,John Jenkins,1610612752,NYK,19,6,13,290.0,6,0,6,0.0,9,0.667,1,0.75,20.6,31,1,30,0.032,55,0.564,6,0.633,9.7,37,1,36,0.027,63,0.587,7,0.661,11.5,2018-19,Regular%20Season
202322,John Wall,1610612764,WAS,30,10,20,1041.0,15,4,11,0.267,63,0.238,1,0.242,15.5,101,14,87,0.139,171,0.591,21,0.673,9.7,116,18,98,0.155,233,0.498,22,0.55,10.4,2018-19,Regular%20Season
1628405,Johnathan Motley,1610612746,LAC,18,8,10,149.0,18,10,8,0.556,46,0.391,0,0.391,4.8,33,7,26,0.212,55,0.6,3,0.635,4.4,51,17,34,0.333,92,0.554,3,0.573,4.5,2018-19,Regular%20Season
1629140,Johnathan Williams,1610612747,LAL,20,8,12,357.0,48,28,20,0.583,103,0.466,3,0.48,4.9,51,11,40,0.216,87,0.586,7,0.638,5.0,99,39,60,0.394,185,0.535,10,0.566,5.0,2018-19,Regular%20Season
202720,Jon Leuer,1610612765,DET,31,10,21,357.0,27,17,9,0.63,67,0.403,2,0.415,4.5,70,17,53,0.243,114,0.614,13,0.693,5.0,97,34,62,0.351,173,0.561,15,0.614,4.9,2018-19,Regular%20Season
1628413,Jonah Bolden,1610612755,PHI,36,21,15,590.0,46,33,14,0.717,111,0.414,3,0.426,8.6,114,31,83,0.272,179,0.637,18,0.708,5.1,160,64,97,0.4,274,0.584,21,0.632,6.1,2018-19,Regular%20Season
201973,Jonas Jerebko,1610612744,GSW,68,48,20,1181.0,72,38,33,0.528,172,0.419,6,0.434,7.5,215,64,151,0.298,355,0.606,29,0.66,5.7,287,102,184,0.355,508,0.565,35,0.607,6.1,2018-19,Regular%20Season
202685,Jonas Valanciunas,1610612763,MEM,48,31,17,1072.0,106,84,21,0.792,283,0.375,7,0.384,4.2,313,115,197,0.367,505,0.62,40,0.673,3.5,419,199,218,0.475,755,0.555,47,0.592,3.7,2018-19,Regular%20Season
1628371,Jonathan Isaac,1610612753,ORL,73,35,38,1936.0,99,66,34,0.667,237,0.418,9,0.434,5.8,302,76,225,0.252,537,0.562,47,0.616,4.7,401,142,259,0.354,758,0.529,56,0.571,5.0,2018-19,Regular%20Season
203613,Jonathon Simmons,1610612755,PHI,45,21,24,903.0,26,16,10,0.615,82,0.317,4,0.333,8.7,93,20,73,0.215,156,0.596,16,0.664,7.8,119,36,83,0.303,235,0.506,20,0.553,8.0,2018-19,Regular%20Season
1628395,Jordan Bell,1610612744,GSW,57,40,17,724.0,55,33,21,0.6,122,0.451,3,0.462,7.1,127,42,87,0.331,240,0.529,25,0.591,4.9,182,75,108,0.412,349,0.521,28,0.567,5.5,2018-19,Regular%20Season
203903,Jordan Clarkson,1610612739,CLE,73,18,55,2023.0,82,40,43,0.488,171,0.48,6,0.497,11.0,188,22,165,0.117,331,0.568,32,0.629,7.9,270,62,208,0.23,493,0.548,38,0.593,8.8,2018-19,Regular%20Season
1628070,Jordan Loyd,1610612761,TOR,5,4,1,33.0,1,1,0,1.0,1,1.0,0,1.0,6.6,8,2,6,0.25,13,0.615,2,0.727,7.1,9,3,6,0.333,14,0.643,2,0.75,7.0,2018-19,Regular%20Season
203895,Jordan McRae,1610612764,WAS,17,5,12,261.0,6,4,1,0.667,12,0.5,0,0.5,11.4,34,5,29,0.147,52,0.654,3,0.694,8.9,40,9,30,0.225,64,0.625,3,0.656,9.2,2018-19,Regular%20Season
101181,Jose Calderon,1610612765,DET,31,14,17,487.0,11,2,9,0.182,29,0.379,0,0.379,14.9,49,5,44,0.102,86,0.57,5,0.605,9.1,60,7,53,0.117,112,0.536,5,0.561,10.2,2018-19,Regular%20Season
1628404,Josh Hart,1610612747,LAL,63,28,35,1635.0,35,15,19,0.429,117,0.299,7,0.318,12.4,213,51,162,0.239,380,0.561,43,0.632,7.0,248,66,181,0.266,489,0.507,50,0.565,7.8,2018-19,Regular%20Season
1628367,Josh Jackson,1610612756,PHX,77,19,58,1961.0,66,35,31,0.53,203,0.325,8,0.338,9.2,281,58,223,0.206,474,0.593,39,0.646,6.7,347,93,254,0.268,649,0.535,47,0.576,7.1,2018-19,Regular%20Season
1629006,Josh Okogie,1610612750,MIN,69,28,41,1726.0,41,25,15,0.61,113,0.363,8,0.39,8.7,177,40,137,0.226,320,0.553,35,0.621,7.4,218,65,152,0.298,432,0.505,43,0.56,7.7,2018-19,Regular%20Season
1626196,Josh Richardson,1610612748,MIA,71,34,37,2474.0,54,16,38,0.296,154,0.351,7,0.367,12.3,209,27,181,0.129,378,0.553,46,0.63,10.1,263,43,219,0.163,521,0.505,53,0.562,10.5,2018-19,Regular%20Season
201950,Jrue Holiday,1610612740,NOP,67,30,37,2402.0,75,41,32,0.547,206,0.364,10,0.383,8.8,259,52,208,0.201,441,0.587,42,0.649,8.1,334,93,240,0.278,637,0.524,52,0.571,8.3,2018-19,Regular%20Season
1627823,Juancho Hernangomez,1610612743,DEN,61,38,23,1301.0,64,35,28,0.547,163,0.393,5,0.405,7.0,201,35,167,0.174,325,0.618,25,0.67,5.9,265,70,195,0.264,468,0.566,30,0.605,6.1,2018-19,Regular%20Season
1627395,Julian Washburn,1610612763,MEM,13,4,9,227.0,8,4,4,0.5,20,0.4,0,0.4,6.8,33,8,25,0.242,55,0.6,5,0.66,7.1,41,12,29,0.293,72,0.569,5,0.612,7.0,2018-19,Regular%20Season
203944,Julius Randle,1610612740,NOP,73,31,42,2232.0,162,108,51,0.667,416,0.389,16,0.405,5.1,472,114,358,0.242,726,0.65,59,0.708,5.0,634,222,409,0.35,1085,0.584,75,0.628,5.0,2018-19,Regular%20Season
1626147,Justin Anderson,1610612737,ATL,27,12,15,367.0,24,15,10,0.625,49,0.49,2,0.511,7.4,59,8,51,0.136,91,0.648,4,0.678,6.1,83,23,61,0.277,135,0.615,6,0.643,6.5,2018-19,Regular%20Season
203200,Justin Holiday,1610612763,MEM,77,24,53,2487.0,45,17,28,0.378,109,0.413,1,0.417,13.2,273,47,223,0.172,473,0.577,39,0.629,7.1,318,64,251,0.201,560,0.568,40,0.612,8.0,2018-19,Regular%20Season
1628382,Justin Jackson,1610612742,DAL,66,29,37,1414.0,44,17,27,0.386,85,0.518,5,0.55,9.8,168,40,128,0.238,275,0.611,26,0.675,8.2,212,57,155,0.269,352,0.602,31,0.66,8.5,2018-19,Regular%20Season
1628383,Justin Patton,1610612755,PHI,3,2,1,21.0,2,2,0,1.0,7,0.286,1,0.333,2.5,4,1,3,0.25,5,0.8,0,0.8,4.7,6,3,3,0.5,11,0.545,1,0.6,4.0,2018-19,Regular%20Season
1626159,Justise Winslow,1610612748,MIA,66,30,36,1960.0,63,30,32,0.476,188,0.335,9,0.352,10.5,292,65,226,0.223,552,0.529,75,0.612,6.2,355,95,258,0.268,721,0.492,84,0.557,6.9,2018-19,Regular%20Season
203994,Jusuf Nurkic,1610612757,POR,72,45,27,1974.0,243,183,57,0.753,513,0.474,17,0.49,5.0,505,145,359,0.287,838,0.603,87,0.672,4.1,748,328,416,0.439,1322,0.566,104,0.614,4.4,2018-19,Regular%20Season
1628443,Kadeem Allen,1610612752,NYK,18,3,15,405.0,8,5,3,0.625,21,0.381,2,0.421,9.9,43,9,34,0.209,78,0.551,8,0.614,7.5,51,14,37,0.275,97,0.526,10,0.586,7.9,2018-19,Regular%20Season
203564,Kalin Lucas,1610612765,DET,1,0,1,6.0,0,0,0,0.0,1,0.0,0,0.0,0.0,3,1,2,0.333,3,1.0,0,1.0,10.5,3,1,2,0.333,4,0.75,0,0.75,10.5,2018-19,Regular%20Season
1626157,Karl-Anthony Towns,1610612750,MIN,77,34,43,2545.0,263,172,91,0.654,567,0.464,8,0.47,6.5,691,213,475,0.308,1058,0.653,80,0.707,4.6,954,385,566,0.404,1562,0.611,88,0.647,5.2,2018-19,Regular%20Season
202695,Kawhi Leonard,1610612761,TOR,60,41,19,2040.0,78,54,23,0.692,207,0.377,12,0.4,7.1,361,107,253,0.296,536,0.674,30,0.713,6.6,439,161,276,0.367,712,0.617,42,0.655,6.7,2018-19,Regular%20Season
1628966,Keita Bates-Diop,1610612750,MIN,27,9,18,496.0,16,8,8,0.5,40,0.4,1,0.41,7.7,67,15,52,0.224,115,0.583,7,0.62,6.9,83,23,60,0.277,153,0.542,8,0.572,7.0,2018-19,Regular%20Season
203482,Kelly Olynyk,1610612748,MIA,77,38,39,1789.0,72,41,31,0.569,213,0.338,8,0.351,7.7,303,56,246,0.185,510,0.594,43,0.649,6.3,375,97,277,0.259,694,0.54,51,0.583,6.5,2018-19,Regular%20Season
1626162,Kelly Oubre Jr.,1610612756,PHX,68,21,47,1912.0,71,48,23,0.676,232,0.306,9,0.318,7.4,254,50,205,0.197,459,0.553,34,0.598,6.0,325,98,228,0.302,666,0.488,43,0.522,6.3,2018-19,Regular%20Season
202689,Kemba Walker,1610612766,CHA,81,39,42,2824.0,52,20,32,0.385,239,0.218,13,0.23,12.6,309,57,253,0.184,540,0.572,52,0.633,9.0,361,77,285,0.213,766,0.471,65,0.515,9.5,2018-19,Regular%20Season
202702,Kenneth Faried,1610612745,HOU,36,20,16,724.0,97,66,31,0.68,183,0.53,2,0.536,5.1,153,44,108,0.288,243,0.63,17,0.677,4.7,250,110,139,0.44,416,0.601,19,0.63,4.9,2018-19,Regular%20Season
1629026,Kenrich Williams,1610612740,NOP,39,13,26,1052.0,55,26,26,0.473,131,0.42,3,0.43,9.3,164,41,125,0.25,279,0.588,30,0.659,6.4,219,67,151,0.306,398,0.55,33,0.6,7.1,2018-19,Regular%20Season
203145,Kent Bazemore,1610612737,ATL,65,24,41,1608.0,37,15,22,0.405,106,0.349,7,0.374,13.8,224,33,191,0.147,390,0.574,27,0.617,6.9,261,48,213,0.184,484,0.539,34,0.58,7.9,2018-19,Regular%20Season
203484,Kentavious Caldwell-Pope,1610612747,LAL,75,35,40,1908.0,48,18,29,0.375,117,0.41,4,0.425,13.8,190,23,167,0.121,329,0.578,37,0.651,7.0,238,41,196,0.172,441,0.54,41,0.595,8.3,2018-19,Regular%20Season
201142,Kevin Durant,1610612744,GSW,77,54,23,2683.0,33,16,17,0.485,133,0.248,10,0.268,11.9,464,90,370,0.194,666,0.697,45,0.747,6.1,497,106,387,0.213,764,0.651,55,0.701,6.5,2018-19,Regular%20Season
1628989,Kevin Huerter,1610612737,ATL,72,27,45,1996.0,60,23,36,0.383,148,0.405,8,0.429,11.8,185,33,152,0.178,322,0.575,20,0.613,8.1,245,56,188,0.229,463,0.529,28,0.563,9.0,2018-19,Regular%20Season
1628995,Kevin Knox II,1610612752,NYK,68,12,56,2051.0,60,34,28,0.567,166,0.361,4,0.37,9.9,271,55,215,0.203,451,0.601,36,0.653,6.4,331,89,243,0.269,604,0.548,40,0.587,7.0,2018-19,Regular%20Season
201567,Kevin Love,1610612739,CLE,22,7,15,598.0,33,27,5,0.818,87,0.379,3,0.393,5.3,206,45,158,0.218,279,0.738,18,0.789,4.8,239,72,163,0.301,353,0.677,21,0.72,4.8,2018-19,Regular%20Season
1626172,Kevon Looney,1610612744,GSW,79,55,24,1471.0,193,129,64,0.668,359,0.538,18,0.566,5.1,223,84,139,0.377,421,0.53,41,0.587,5.3,416,213,203,0.512,753,0.552,59,0.599,5.2,2018-19,Regular%20Season
203920,Khem Birch,1610612753,ORL,45,25,20,610.0,79,60,17,0.759,155,0.51,4,0.523,5.0,111,41,70,0.369,197,0.563,19,0.624,5.2,190,101,87,0.532,344,0.552,23,0.592,5.1,2018-19,Regular%20Season
203114,Khris Middleton,1610612749,MIL,77,56,21,2393.0,50,27,23,0.54,165,0.303,7,0.316,8.8,411,55,356,0.134,627,0.656,41,0.701,6.7,461,82,379,0.178,775,0.595,48,0.634,6.9,2018-19,Regular%20Season
1629017,Khyri Thomas,1610612765,DET,13,6,7,120.0,4,2,2,0.5,6,0.667,0,0.667,12.0,16,1,15,0.063,24,0.667,2,0.727,7.3,20,3,17,0.15,28,0.714,2,0.769,8.3,2018-19,Regular%20Season
202691,Klay Thompson,1610612744,GSW,78,55,23,2652.0,37,13,25,0.351,109,0.339,5,0.356,11.7,262,47,214,0.179,494,0.53,59,0.602,7.8,299,60,239,0.201,594,0.503,64,0.564,8.3,2018-19,Regular%20Season
201585,Kosta Koufos,1610612758,SAC,39,19,20,483.0,52,27,25,0.519,131,0.397,9,0.426,6.3,125,37,88,0.296,210,0.595,7,0.616,4.3,177,64,113,0.362,318,0.557,16,0.586,4.9,2018-19,Regular%20Season
1628961,Kostas Antetokounmpo,1610612742,DAL,1,0,1,6.0,0,0,0,0.0,0,0.0,0,0.0,0.0,1,0,1,0.0,1,1.0,0,1.0,5.8,1,0,1,0.0,1,1.0,0,1.0,5.8,2018-19,Regular%20Season
1627739,Kris Dunn,1610612741,CHI,43,14,29,1317.0,19,6,13,0.316,64,0.297,3,0.311,14.6,164,24,139,0.146,272,0.603,28,0.672,6.6,183,30,152,0.164,333,0.55,31,0.606,7.5,2018-19,Regular%20Season
203937,Kyle Anderson,1610612763,MEM,43,19,24,1282.0,48,25,23,0.521,126,0.381,0,0.381,7.7,203,39,165,0.192,308,0.659,19,0.702,7.0,251,64,188,0.255,411,0.611,19,0.64,7.1,2018-19,Regular%20Season
2594,Kyle Korver,1610612762,UTA,57,33,24,1139.0,9,3,6,0.333,32,0.281,2,0.3,21.0,147,18,129,0.122,267,0.551,30,0.62,7.7,156,21,135,0.135,290,0.538,32,0.605,8.5,2018-19,Regular%20Season
1628398,Kyle Kuzma,1610612747,LAL,68,32,36,2257.0,60,30,30,0.5,195,0.308,7,0.319,10.9,322,59,261,0.183,568,0.567,46,0.617,6.7,382,89,291,0.233,738,0.518,53,0.558,7.3,2018-19,Regular%20Season
200768,Kyle Lowry,1610612761,TOR,65,47,18,2213.0,41,23,18,0.561,151,0.272,4,0.279,10.3,271,51,220,0.188,492,0.551,31,0.588,8.1,312,74,238,0.237,642,0.486,35,0.514,8.4,2018-19,Regular%20Season
203124,Kyle O'Quinn,1610612754,IND,35,19,16,345.0,29,20,8,0.69,67,0.433,3,0.453,5.7,90,27,63,0.3,143,0.629,9,0.672,4.4,119,47,71,0.395,201,0.592,12,0.63,4.7,2018-19,Regular%20Season
202681,Kyrie Irving,1610612738,BOS,67,37,30,2214.0,71,37,34,0.521,186,0.382,9,0.401,10.3,264,41,225,0.155,447,0.591,26,0.627,8.6,335,78,259,0.233,627,0.534,35,0.566,8.9,2018-19,Regular%20Season
200746,LaMarcus Aldridge,1610612759,SAS,81,48,33,2687.0,251,182,67,0.725,530,0.474,8,0.481,5.2,493,144,350,0.292,802,0.615,68,0.672,6.0,744,326,417,0.438,1296,0.574,76,0.61,5.7,2018-19,Regular%20Season
202362,Lance Stephenson,1610612747,LAL,61,29,32,1090.0,32,16,16,0.5,95,0.337,2,0.344,9.6,183,33,149,0.18,291,0.629,22,0.68,6.2,215,49,165,0.228,382,0.563,24,0.601,6.7,2018-19,Regular%20Season
202498,Lance Thomas,1610612752,NYK,40,6,34,712.0,21,10,11,0.476,73,0.288,4,0.304,7.1,96,25,71,0.26,140,0.686,11,0.744,7.4,117,35,82,0.299,199,0.588,15,0.636,7.4,2018-19,Regular%20Season
1629013,Landry Shamet,1610612746,LAC,60,40,20,1439.0,20,4,16,0.2,47,0.426,2,0.444,16.9,112,14,98,0.125,214,0.523,22,0.583,9.3,132,18,114,0.136,252,0.524,24,0.579,10.4,2018-19,Regular%20Season
204038,Langston Galloway,1610612765,DET,64,35,29,1458.0,49,15,34,0.306,101,0.485,0,0.485,14.1,122,15,107,0.123,186,0.656,10,0.693,10.1,171,30,141,0.175,279,0.613,10,0.636,11.2,2018-19,Regular%20Season
1626204,Larry Nance Jr.,1610612739,CLE,67,16,51,1795.0,168,106,57,0.631,359,0.468,6,0.476,5.7,384,101,272,0.263,594,0.646,39,0.692,4.8,552,207,329,0.375,927,0.595,45,0.626,5.1,2018-19,Regular%20Season
1628374,Lauri Markkanen,1610612741,CHI,51,16,35,1654.0,74,46,28,0.622,182,0.407,4,0.416,6.9,391,93,300,0.238,531,0.736,24,0.771,5.0,465,139,328,0.299,679,0.685,28,0.714,5.3,2018-19,Regular%20Season
2544,LeBron James,1610612747,LAL,55,28,27,1937.0,57,34,22,0.596,183,0.311,9,0.328,8.7,408,79,329,0.194,579,0.705,35,0.75,6.7,465,113,351,0.243,730,0.637,44,0.678,6.9,2018-19,Regular%20Season
1629022,Lonnie Walker IV,1610612759,SAS,10,7,3,95.0,0,0,0,0.0,5,0.0,0,0.0,0.0,17,3,14,0.176,24,0.708,1,0.739,7.0,17,3,14,0.176,27,0.63,1,0.654,7.0,2018-19,Regular%20Season
1628366,Lonzo Ball,1610612747,LAL,46,24,22,1400.0,54,35,18,0.648,134,0.403,7,0.425,8.2,197,47,149,0.239,297,0.663,28,0.732,6.6,251,82,167,0.327,425,0.591,35,0.644,6.9,2018-19,Regular%20Season
203485,Lorenzo Brown,1610612761,TOR,18,13,5,192.0,5,3,2,0.6,15,0.333,2,0.385,9.0,26,3,22,0.115,41,0.634,3,0.684,5.1,31,6,24,0.194,56,0.554,5,0.608,5.7,2018-19,Regular%20Season
101150,Lou Williams,1610612746,LAC,69,44,25,1861.0,40,19,21,0.475,110,0.364,5,0.381,10.5,182,18,165,0.099,294,0.619,19,0.662,8.9,222,37,186,0.167,399,0.556,24,0.592,9.3,2018-19,Regular%20Season
201601,Luc Mbah a Moute,1610612746,LAC,4,2,2,61.0,2,1,1,0.5,5,0.4,1,0.5,9.4,5,1,3,0.2,12,0.417,1,0.455,7.6,7,2,4,0.286,16,0.438,2,0.5,8.2,2018-19,Regular%20Season
1629029,Luka Doncic,1610612742,DAL,71,27,44,2287.0,86,57,29,0.663,216,0.398,8,0.413,7.9,477,92,385,0.193,731,0.653,62,0.713,5.7,563,149,414,0.265,926,0.608,70,0.658,6.0,2018-19,Regular%20Season
1628379,Luke Kennard,1610612765,DET,57,27,30,1350.0,12,4,8,0.333,43,0.279,1,0.286,13.6,171,25,146,0.146,245,0.698,11,0.731,7.6,183,29,154,0.158,283,0.647,12,0.675,8.0,2018-19,Regular%20Season
1628436,Luke Kornet,1610612752,NYK,36,6,30,711.0,27,14,12,0.519,58,0.466,0,0.466,7.8,105,37,68,0.352,207,0.507,26,0.58,6.4,132,51,80,0.386,254,0.52,26,0.579,6.7,2018-19,Regular%20Season
2736,Luol Deng,1610612750,MIN,18,9,9,349.0,20,8,12,0.4,46,0.435,4,0.476,9.3,53,9,44,0.17,87,0.609,5,0.646,5.4,73,17,56,0.233,128,0.57,9,0.613,6.5,2018-19,Regular%20Season
1627781,Malachi Richardson,1610612761,TOR,7,3,4,55.0,1,0,1,0.0,3,0.333,0,0.333,24.7,11,1,10,0.091,15,0.733,1,0.786,6.3,12,1,11,0.083,17,0.706,1,0.75,7.9,2018-19,Regular%20Season
1627763,Malcolm Brogdon,1610612749,MIL,63,48,15,1825.0,65,34,29,0.523,149,0.436,1,0.439,10.9,223,39,184,0.175,368,0.606,33,0.666,8.0,288,73,213,0.253,516,0.558,34,0.598,8.7,2018-19,Regular%20Season
1626259,Malcolm Miller,1610612761,TOR,4,4,0,26.0,1,0,1,0.0,2,0.5,0,0.5,3.1,4,0,4,0.0,5,0.8,0,0.8,6.0,5,0,5,0.0,6,0.833,0,0.833,5.4,2018-19,Regular%20Season
1627736,Malik Beasley,1610612743,DEN,72,47,25,1717.0,35,15,20,0.429,103,0.34,5,0.357,12.5,165,30,135,0.182,282,0.585,31,0.657,8.2,200,45,155,0.225,373,0.536,36,0.593,9.0,2018-19,Regular%20Season
1628370,Malik Monk,1610612766,CHA,60,31,29,1092.0,16,5,11,0.313,65,0.246,4,0.262,17.1,121,13,106,0.107,182,0.665,14,0.72,7.7,137,18,117,0.131,244,0.561,18,0.606,8.8,2018-19,Regular%20Season
202705,MarShon Brooks,1610612763,MEM,21,12,9,322.0,12,7,5,0.583,28,0.429,0,0.429,5.5,33,4,28,0.121,54,0.611,3,0.647,7.5,45,11,33,0.244,79,0.57,3,0.592,6.9,2018-19,Regular%20Season
201188,Marc Gasol,1610612761,TOR,79,39,40,2436.0,80,55,22,0.688,201,0.398,5,0.408,6.5,547,172,373,0.314,866,0.632,75,0.692,4.7,627,227,395,0.362,1029,0.609,80,0.661,4.9,2018-19,Regular%20Season
101162,Marcin Gortat,1610612746,LAC,44,24,20,733.0,67,34,34,0.507,169,0.396,2,0.401,6.1,194,56,138,0.289,303,0.64,33,0.719,4.3,261,90,172,0.345,460,0.567,35,0.614,4.8,2018-19,Regular%20Season
201158,Marco Belinelli,1610612759,SAS,69,42,27,1607.0,16,2,13,0.125,62,0.258,2,0.267,18.9,182,21,161,0.115,310,0.587,24,0.636,6.8,198,23,174,0.116,362,0.547,26,0.589,7.7,2018-19,Regular%20Season
1629094,Marcus Derrickson,1610612744,GSW,9,8,1,59.0,8,4,4,0.5,13,0.615,0,0.615,11.7,5,1,4,0.2,14,0.357,2,0.417,6.5,13,5,8,0.385,25,0.52,2,0.565,9.7,2018-19,Regular%20Season
202694,Marcus Morris Sr.,1610612738,BOS,75,44,31,2091.0,76,30,45,0.395,230,0.33,3,0.335,7.9,382,78,304,0.204,601,0.636,34,0.674,5.9,458,108,349,0.236,791,0.579,37,0.607,6.2,2018-19,Regular%20Season
203935,Marcus Smart,1610612738,BOS,77,46,31,2138.0,57,34,23,0.596,150,0.38,4,0.39,7.9,177,47,130,0.266,335,0.528,35,0.59,8.5,234,81,153,0.346,481,0.486,39,0.529,8.3,2018-19,Regular%20Season
1626209,Mario Hezonja,1610612752,NYK,55,12,43,1163.0,28,12,16,0.429,92,0.304,3,0.315,8.8,205,34,171,0.166,317,0.647,27,0.707,5.9,233,46,187,0.197,385,0.605,30,0.656,6.3,2018-19,Regular%20Season
1628365,Markelle Fultz,1610612753,ORL,18,12,6,400.0,26,14,10,0.538,60,0.433,1,0.441,6.8,44,5,39,0.114,86,0.512,6,0.55,9.0,70,19,49,0.271,145,0.483,7,0.507,8.2,2018-19,Regular%20Season
202693,Markieff Morris,1610612760,OKC,56,23,33,1241.0,61,38,22,0.623,130,0.469,1,0.473,6.4,204,57,146,0.279,357,0.571,26,0.616,5.9,265,95,168,0.358,471,0.563,27,0.597,6.0,2018-19,Regular%20Season
1627737,Marquese Chriss,1610612739,CLE,37,12,25,474.0,40,30,10,0.75,108,0.37,4,0.385,5.9,101,28,75,0.277,176,0.574,10,0.608,6.4,141,58,85,0.411,267,0.528,14,0.557,6.2,2018-19,Regular%20Season
1628963,Marvin Bagley III,1610612758,SAC,62,30,32,1568.0,162,105,56,0.648,360,0.45,9,0.462,5.1,309,84,223,0.272,466,0.663,26,0.702,4.8,471,189,279,0.401,794,0.593,35,0.621,4.9,2018-19,Regular%20Season
101107,Marvin Williams,1610612766,CHA,75,35,40,2133.0,76,45,31,0.592,188,0.404,9,0.425,10.2,331,82,250,0.248,561,0.59,57,0.657,6.1,407,127,281,0.312,734,0.554,66,0.609,6.9,2018-19,Regular%20Season
203486,Mason Plumlee,1610612743,DEN,82,54,28,1731.0,165,108,57,0.655,446,0.37,15,0.383,5.3,359,93,265,0.259,625,0.574,59,0.634,4.7,524,201,322,0.384,1056,0.496,74,0.534,4.9,2018-19,Regular%20Season
203521,Matthew Dellavedova,1610612739,CLE,38,17,21,674.0,6,1,5,0.167,32,0.188,4,0.214,14.1,71,9,62,0.127,130,0.546,12,0.602,8.5,77,10,67,0.13,160,0.481,16,0.535,8.9,2018-19,Regular%20Season
203090,Maurice Harkless,1610612757,POR,57,35,22,1381.0,77,47,30,0.61,173,0.445,3,0.453,7.2,192,51,138,0.266,301,0.638,30,0.708,6.0,269,98,168,0.364,457,0.589,33,0.634,6.4,2018-19,Regular%20Season
1628467,Maxi Kleber,1610612742,DAL,68,29,39,1462.0,90,53,38,0.589,212,0.425,5,0.435,8.0,239,74,162,0.31,430,0.556,41,0.614,5.5,329,127,200,0.386,610,0.539,46,0.583,6.2,2018-19,Regular%20Season
1628982,Melvin Frazier Jr.,1610612753,ORL,5,4,1,20.0,3,1,2,0.333,3,1.0,0,1.0,4.8,2,1,1,0.5,4,0.5,0,0.5,4.7,5,2,3,0.4,7,0.714,0,0.714,4.8,2018-19,Regular%20Season
203086,Meyers Leonard,1610612757,POR,56,32,24,840.0,49,29,21,0.592,119,0.412,1,0.415,6.7,184,50,134,0.272,275,0.669,14,0.705,4.5,233,79,155,0.339,383,0.608,15,0.633,4.9,2018-19,Regular%20Season
201563,Michael Beasley,1610612747,LAL,25,10,15,275.0,13,8,6,0.615,33,0.394,1,0.406,4.5,47,9,38,0.191,82,0.573,10,0.653,5.4,60,17,44,0.283,113,0.531,11,0.588,5.2,2018-19,Regular%20Season
203487,Michael Carter-Williams,1610612753,ORL,20,13,7,311.0,19,10,9,0.526,39,0.487,1,0.5,9.2,51,16,35,0.314,86,0.593,9,0.662,6.3,70,26,44,0.371,124,0.565,10,0.614,7.1,2018-19,Regular%20Season
203077,Michael Kidd-Gilchrist,1610612766,CHA,59,27,32,1144.0,88,58,30,0.659,214,0.411,8,0.427,5.3,157,55,103,0.35,321,0.489,30,0.54,5.8,245,113,133,0.461,529,0.463,38,0.499,5.6,2018-19,Regular%20Season
1628969,Mikal Bridges,1610612756,PHX,73,16,57,2255.0,56,26,30,0.464,116,0.483,4,0.5,11.8,208,46,164,0.221,373,0.558,36,0.617,8.4,264,72,194,0.273,478,0.552,40,0.603,9.1,2018-19,Regular%20Season
201144,Mike Conley,1610612763,MEM,68,29,39,2277.0,40,14,26,0.35,123,0.325,7,0.345,13.3,199,30,169,0.151,329,0.605,24,0.652,9.5,239,44,195,0.184,452,0.529,31,0.568,10.1,2018-19,Regular%20Season
203488,Mike Muscala,1610612747,LAL,60,33,27,1277.0,57,31,26,0.544,158,0.361,7,0.377,6.7,186,48,137,0.258,377,0.493,52,0.572,5.8,243,79,163,0.325,526,0.462,59,0.52,6.0,2018-19,Regular%20Season
203118,Mike Scott,1610612755,PHI,75,42,33,1362.0,43,13,31,0.302,115,0.374,2,0.381,12.0,233,51,181,0.219,375,0.621,30,0.675,5.9,276,64,212,0.232,462,0.597,32,0.642,6.8,2018-19,Regular%20Season
1628970,Miles Bridges,1610612766,CHA,76,36,40,1663.0,67,40,26,0.597,170,0.394,6,0.409,8.1,256,64,193,0.25,384,0.667,31,0.725,6.0,323,104,219,0.322,531,0.608,37,0.654,6.4,2018-19,Regular%20Season
203101,Miles Plumlee,1610612737,ATL,14,1,13,151.0,16,10,6,0.625,32,0.5,2,0.533,4.2,23,7,16,0.304,51,0.451,7,0.523,4.7,39,17,22,0.436,80,0.488,9,0.549,4.5,2018-19,Regular%20Season
1628462,Milos Teodosic,1610612746,LAC,5,4,1,60.0,2,0,2,0.0,2,1.0,0,1.0,15.8,13,1,12,0.077,17,0.765,2,0.867,6.5,15,1,14,0.067,19,0.789,2,0.882,7.8,2018-19,Regular%20Season
1628249,Mitchell Creek,1610612750,MIN,3,0,3,45.0,6,4,2,0.667,11,0.545,1,0.6,8.9,6,3,3,0.5,11,0.545,0,0.545,9.8,12,7,5,0.583,22,0.545,1,0.571,9.3,2018-19,Regular%20Season
1629011,Mitchell Robinson,1610612752,NYK,64,15,49,1348.0,175,127,46,0.726,347,0.504,2,0.507,5.4,246,80,166,0.325,403,0.61,28,0.656,6.1,421,207,212,0.492,738,0.57,30,0.595,5.8,2018-19,Regular%20Season
1628964,Mo Bamba,1610612753,ORL,43,17,26,708.0,61,43,16,0.705,151,0.404,5,0.418,5.9,162,54,106,0.333,270,0.6,26,0.664,3.6,223,97,122,0.435,408,0.547,31,0.592,4.2,2018-19,Regular%20Season
1628420,Monte Morris,1610612743,DEN,69,48,21,1693.0,35,8,27,0.229,96,0.365,4,0.38,15.9,158,23,135,0.146,262,0.603,19,0.65,9.9,193,31,162,0.161,357,0.541,23,0.578,11.0,2018-19,Regular%20Season
1626149,Montrezl Harrell,1610612746,LAC,81,48,33,2143.0,184,122,62,0.663,440,0.418,11,0.429,4.5,351,129,223,0.368,663,0.529,75,0.597,5.5,535,251,285,0.469,1059,0.505,86,0.55,5.2,2018-19,Regular%20Season
1629021,Moritz Wagner,1610612747,LAL,31,10,21,407.0,17,10,7,0.588,51,0.333,4,0.362,7.7,68,22,46,0.324,109,0.624,10,0.687,4.5,85,32,53,0.376,152,0.559,14,0.616,5.2,2018-19,Regular%20Season
1626167,Myles Turner,1610612754,IND,74,43,31,2119.0,101,66,35,0.653,249,0.406,9,0.421,5.7,430,147,282,0.342,842,0.511,92,0.573,4.2,531,213,317,0.401,1061,0.5,101,0.553,4.5,2018-19,Regular%20Season
1628513,Naz Mitrou-Long,1610612762,UTA,3,1,2,42.0,1,0,1,0.0,2,0.5,0,0.5,14.6,5,0,5,0.0,10,0.5,1,0.556,9.8,6,0,6,0.0,12,0.5,1,0.545,10.6,2018-19,Regular%20Season
202357,Nemanja Bjelica,1610612758,SAC,74,37,37,1739.0,125,96,28,0.768,246,0.508,8,0.525,5.2,319,87,231,0.273,519,0.615,37,0.662,5.2,444,183,259,0.412,736,0.603,45,0.643,5.2,2018-19,Regular%20Season
2403,Nene,1610612745,HOU,41,29,12,541.0,34,19,15,0.559,104,0.327,7,0.351,6.7,89,30,59,0.337,154,0.578,10,0.618,5.3,123,49,74,0.398,249,0.494,17,0.53,5.7,2018-19,Regular%20Season
203457,Nerlens Noel,1610612760,OKC,74,45,29,1019.0,126,84,41,0.667,266,0.474,6,0.485,5.4,198,51,147,0.258,384,0.516,42,0.579,4.6,324,135,188,0.417,624,0.519,48,0.563,4.9,2018-19,Regular%20Season
201156,Nick Young,1610612743,DEN,1,1,0,7.0,0,0,0,0.0,0,0.0,0,0.0,0.0,1,0,1,0.0,2,0.5,1,1.0,11.0,1,0,1,0.0,2,0.5,1,1.0,11.0,2018-19,Regular%20Season
201587,Nicolas Batum,1610612766,CHA,74,34,40,2338.0,71,39,31,0.549,177,0.401,4,0.41,8.0,319,82,236,0.257,503,0.634,37,0.685,6.6,390,121,267,0.31,649,0.601,41,0.641,6.8,2018-19,Regular%20Season
203917,Nik Stauskas,1610612739,CLE,56,30,26,875.0,18,7,11,0.389,42,0.429,2,0.45,13.9,109,11,98,0.101,166,0.657,13,0.712,6.5,127,18,109,0.142,204,0.623,15,0.672,7.5,2018-19,Regular%20Season
203999,Nikola Jokic,1610612743,DEN,80,53,27,2504.0,228,184,45,0.807,508,0.449,11,0.459,5.0,637,204,432,0.32,1014,0.628,73,0.677,4.2,865,388,477,0.449,1462,0.592,84,0.628,4.4,2018-19,Regular%20Season
202703,Nikola Mirotic,1610612749,MIL,46,24,22,1245.0,60,39,21,0.65,153,0.392,2,0.397,5.8,279,61,217,0.219,403,0.692,30,0.748,4.8,339,100,238,0.295,524,0.647,32,0.689,5.0,2018-19,Regular%20Season
202696,Nikola Vucevic,1610612753,ORL,78,39,39,2447.0,220,161,59,0.732,443,0.497,15,0.514,5.7,711,228,482,0.321,1070,0.664,63,0.706,4.2,931,389,541,0.418,1468,0.634,78,0.67,4.6,2018-19,Regular%20Season
203943,Noah Vonleh,1610612752,NYK,65,13,52,1685.0,112,77,35,0.688,296,0.378,5,0.385,6.7,406,107,300,0.264,649,0.626,41,0.668,4.5,518,184,335,0.355,912,0.568,46,0.598,5.0,2018-19,Regular%20Season
1626181,Norman Powell,1610612761,TOR,53,40,13,1044.0,16,10,6,0.625,59,0.271,3,0.286,11.7,123,15,107,0.122,193,0.637,15,0.691,6.9,139,25,113,0.18,242,0.574,18,0.621,7.5,2018-19,Regular%20Season
1628384,OG Anunoby,1610612761,TOR,62,43,19,1277.0,58,28,28,0.483,148,0.392,3,0.4,7.5,139,33,105,0.237,237,0.586,12,0.618,5.1,197,61,133,0.31,360,0.547,15,0.571,5.8,2018-19,Regular%20Season
1627855,Okaro White,1610612764,WAS,1,0,1,3.0,1,1,0,1.0,1,1.0,0,1.0,7.3,1,0,1,0.0,1,1.0,0,1.0,10.2,2,1,1,0.5,2,1.0,0,1.0,8.8,2018-19,Regular%20Season
1629016,Omari Spellman,1610612737,ATL,44,14,30,794.0,72,48,24,0.667,160,0.45,5,0.465,5.4,122,34,88,0.279,225,0.542,21,0.598,5.0,194,82,112,0.423,362,0.536,26,0.577,5.1,2018-19,Regular%20Season
201956,Omri Casspi,1610612763,MEM,33,13,20,507.0,17,9,8,0.529,58,0.293,0,0.293,8.9,98,20,78,0.204,151,0.649,13,0.71,5.0,115,29,86,0.252,204,0.564,13,0.602,5.6,2018-19,Regular%20Season
203490,Otto Porter Jr.,1610612741,CHI,55,24,31,1649.0,53,32,21,0.604,159,0.333,6,0.346,8.0,250,48,199,0.192,414,0.604,28,0.648,6.0,303,80,220,0.264,550,0.551,34,0.587,6.3,2018-19,Regular%20Season
200782,P.J. Tucker,1610612745,HOU,81,52,29,2764.0,121,67,54,0.554,333,0.363,9,0.373,8.3,358,97,260,0.271,658,0.544,66,0.605,5.7,479,164,314,0.342,952,0.503,75,0.546,6.4,2018-19,Regular%20Season
1628408,PJ Dozier,1610612738,BOS,3,2,1,46.0,6,4,2,0.667,6,1.0,0,1.0,6.7,11,1,10,0.091,14,0.786,0,0.786,5.7,17,5,12,0.294,20,0.85,0,0.85,6.0,2018-19,Regular%20Season
1627783,Pascal Siakam,1610612761,TOR,80,57,23,2548.0,124,62,60,0.5,268,0.463,10,0.481,8.0,425,98,326,0.231,689,0.617,56,0.671,5.5,549,160,386,0.291,924,0.594,66,0.64,6.0,2018-19,Regular%20Season
1626192,Pat Connaughton,1610612749,MIL,54,37,17,1206.0,61,28,33,0.459,121,0.504,2,0.513,8.3,197,38,159,0.193,314,0.627,26,0.684,5.9,258,66,192,0.256,431,0.599,28,0.64,6.4,2018-19,Regular%20Season
201976,Patrick Beverley,1610612746,LAC,77,47,30,2104.0,76,29,44,0.382,186,0.409,14,0.442,10.5,312,44,266,0.141,521,0.599,42,0.651,7.1,388,73,310,0.188,694,0.559,56,0.608,7.7,2018-19,Regular%20Season
1627775,Patrick McCaw,1610612761,TOR,25,17,8,358.0,7,3,4,0.429,23,0.304,2,0.333,13.7,41,10,31,0.244,62,0.661,3,0.695,8.7,48,13,35,0.271,84,0.571,5,0.608,9.4,2018-19,Regular%20Season
202335,Patrick Patterson,1610612760,OKC,56,35,21,802.0,42,20,22,0.476,82,0.512,4,0.538,9.0,104,26,78,0.25,198,0.525,16,0.571,6.1,146,46,100,0.315,271,0.539,20,0.582,6.9,2018-19,Regular%20Season
201988,Patty Mills,1610612759,SAS,78,48,30,1829.0,24,1,23,0.042,60,0.4,0,0.4,19.0,158,15,143,0.095,249,0.635,8,0.656,10.8,182,16,166,0.088,307,0.593,8,0.609,11.9,2018-19,Regular%20Season
2200,Pau Gasol,1610612749,MIL,29,16,13,357.0,22,16,6,0.727,51,0.431,0,0.431,5.7,115,37,78,0.322,167,0.689,9,0.728,4.2,137,53,84,0.387,209,0.656,9,0.685,4.4,2018-19,Regular%20Season
202331,Paul George,1610612760,OKC,76,45,31,2801.0,105,41,64,0.39,271,0.387,11,0.404,12.1,517,102,414,0.197,828,0.624,74,0.686,6.5,622,143,478,0.23,1072,0.58,85,0.63,7.5,2018-19,Regular%20Season
200794,Paul Millsap,1610612743,DEN,68,48,20,1855.0,153,103,49,0.673,377,0.406,16,0.424,6.2,352,73,280,0.207,555,0.634,43,0.688,5.7,505,176,329,0.349,895,0.564,59,0.604,5.8,2018-19,Regular%20Season
203112,Quincy Acy,1610612756,PHX,6,0,6,92.0,3,1,2,0.333,15,0.2,0,0.2,5.0,22,6,15,0.273,34,0.647,2,0.688,4.6,25,7,17,0.28,45,0.556,2,0.581,4.6,2018-19,Regular%20Season
202347,Quincy Pondexter,1610612759,SAS,26,16,10,212.0,8,3,5,0.375,20,0.4,2,0.444,9.2,38,3,35,0.079,57,0.667,11,0.826,7.9,46,6,40,0.13,76,0.605,13,0.73,8.2,2018-19,Regular%20Season
1626188,Quinn Cook,1610612744,GSW,58,39,19,956.0,22,4,17,0.182,47,0.468,3,0.5,14.0,135,15,120,0.111,208,0.649,16,0.703,7.7,157,19,137,0.121,254,0.618,19,0.668,8.6,2018-19,Regular%20Season
1626154,RJ Hunter,1610612738,BOS,1,1,0,26.0,1,0,1,0.0,2,0.5,0,0.5,33.8,2,1,1,0.5,8,0.25,2,0.333,4.9,3,1,2,0.333,10,0.3,2,0.375,14.5,2018-19,Regular%20Season
200765,Rajon Rondo,1610612747,LAL,44,18,26,1323.0,34,14,20,0.412,109,0.312,4,0.324,12.7,209,25,180,0.12,325,0.643,23,0.692,8.1,243,39,200,0.16,424,0.573,27,0.612,8.7,2018-19,Regular%20Season
203526,Raul Neto,1610612762,UTA,22,16,6,342.0,6,1,5,0.167,21,0.286,2,0.316,12.3,56,12,44,0.214,95,0.589,11,0.667,8.8,62,13,49,0.21,115,0.539,13,0.608,9.1,2018-19,Regular%20Season
1628959,Rawle Alkins,1610612741,CHI,7,2,5,98.0,11,8,3,0.727,18,0.611,0,0.611,9.1,15,3,12,0.2,24,0.625,4,0.75,6.0,26,11,15,0.423,42,0.619,4,0.684,7.3,2018-19,Regular%20Season
1629034,Ray Spalding,1610612756,PHX,11,3,8,142.0,15,12,3,0.8,37,0.405,0,0.405,4.6,33,8,25,0.242,59,0.559,7,0.635,5.4,48,20,28,0.417,91,0.527,7,0.571,5.1,2018-19,Regular%20Season
101109,Raymond Felton,1610612760,OKC,19,12,7,259.0,4,0,4,0.0,13,0.308,1,0.333,17.9,30,6,24,0.2,47,0.638,3,0.682,11.1,34,6,28,0.176,60,0.567,4,0.607,11.9,2018-19,Regular%20Season
203493,Reggie Bullock Jr.,1610612747,LAL,57,25,32,1713.0,21,7,14,0.333,69,0.304,5,0.328,13.7,151,20,130,0.132,250,0.604,19,0.654,9.1,172,27,144,0.157,310,0.555,24,0.601,9.7,2018-19,Regular%20Season
202704,Reggie Jackson,1610612765,DET,75,38,37,2120.0,45,12,33,0.267,132,0.341,9,0.366,15.0,171,22,148,0.129,320,0.534,33,0.596,8.9,216,34,181,0.157,448,0.482,42,0.532,10.2,2018-19,Regular%20Season
1626158,Richaun Holmes,1610612756,PHX,67,16,51,1173.0,115,79,35,0.687,291,0.395,3,0.399,5.5,216,74,142,0.343,446,0.484,50,0.545,4.7,331,153,177,0.462,717,0.462,53,0.498,5.0,2018-19,Regular%20Season
201937,Ricky Rubio,1610612762,UTA,66,40,26,1862.0,33,10,22,0.303,79,0.418,6,0.452,16.1,206,30,174,0.146,355,0.58,38,0.65,9.0,239,40,196,0.167,432,0.553,44,0.616,10.0,2018-19,Regular%20Season
203496,Robert Covington,1610612750,MIN,35,20,15,1203.0,28,13,13,0.464,77,0.364,4,0.384,13.3,165,38,126,0.23,314,0.525,31,0.583,6.0,193,51,139,0.264,384,0.503,35,0.553,7.0,2018-19,Regular%20Season
1629057,Robert Williams III,1610612738,BOS,23,13,10,254.0,27,22,5,0.815,58,0.466,0,0.466,5.7,54,13,40,0.241,89,0.607,7,0.659,5.1,81,35,45,0.432,141,0.574,7,0.604,5.3,2018-19,Regular%20Season
201577,Robin Lopez,1610612741,CHI,70,20,50,1547.0,140,113,26,0.807,323,0.433,5,0.44,4.0,145,54,88,0.372,344,0.422,58,0.507,5.7,285,167,114,0.586,661,0.431,63,0.477,4.9,2018-19,Regular%20Season
1629066,Rodions Kurucs,1610612751,BKN,62,35,27,1277.0,56,36,18,0.643,169,0.331,5,0.341,7.4,190,39,151,0.205,332,0.572,39,0.648,6.2,246,75,169,0.305,489,0.503,44,0.553,6.4,2018-19,Regular%20Season
203918,Rodney Hood,1610612757,POR,63,26,37,1692.0,25,5,20,0.2,71,0.352,8,0.397,16.6,132,21,110,0.159,213,0.62,11,0.653,9.2,157,26,130,0.166,278,0.565,19,0.606,10.4,2018-19,Regular%20Season
203585,Rodney McGruder,1610612746,LAC,56,26,30,1452.0,60,27,31,0.45,174,0.345,10,0.366,8.2,178,32,147,0.18,309,0.576,35,0.65,8.0,238,59,178,0.248,475,0.501,45,0.553,8.1,2018-19,Regular%20Season
1627758,Ron Baker,1610612764,WAS,6,2,4,85.0,1,0,1,0.0,2,0.5,0,0.5,6.0,10,1,9,0.1,18,0.556,0,0.556,11.1,11,1,10,0.091,19,0.579,0,0.579,10.7,2018-19,Regular%20Season
1626178,Rondae Hollis-Jefferson,1610612751,BKN,59,27,32,1234.0,83,50,32,0.602,233,0.356,7,0.367,7.8,227,50,177,0.22,421,0.539,45,0.604,5.2,310,100,209,0.323,623,0.498,52,0.543,5.9,2018-19,Regular%20Season
1626220,Royce O'Neale,1610612762,UTA,75,47,28,1602.0,22,9,13,0.409,67,0.328,2,0.338,12.8,262,64,198,0.244,410,0.639,30,0.689,6.6,284,73,211,0.257,471,0.603,32,0.647,7.0,2018-19,Regular%20Season
200752,Rudy Gay,1610612759,SAS,69,42,27,1842.0,63,38,23,0.603,190,0.332,6,0.342,8.0,407,86,319,0.211,597,0.682,25,0.712,4.8,470,124,342,0.264,755,0.623,31,0.649,5.2,2018-19,Regular%20Season
203497,Rudy Gobert,1610612762,UTA,80,50,30,2544.0,304,206,95,0.678,689,0.441,10,0.448,5.0,724,174,539,0.24,1173,0.617,109,0.68,3.9,1028,380,634,0.37,1804,0.57,119,0.61,4.2,2018-19,Regular%20Season
201566,Russell Westbrook,1610612760,OKC,72,43,29,2593.0,106,41,63,0.387,368,0.288,17,0.302,9.4,691,86,600,0.124,924,0.748,37,0.779,6.6,797,127,663,0.159,1201,0.664,54,0.695,6.9,2018-19,Regular%20Season
201583,Ryan Anderson,1610612748,MIA,17,5,12,289.0,18,11,7,0.611,43,0.419,2,0.439,7.6,36,12,24,0.333,66,0.545,8,0.621,5.2,54,23,31,0.426,107,0.505,10,0.557,6.0,2018-19,Regular%20Season
1627853,Ryan Arcidiacono,1610612741,CHI,72,20,52,1800.0,27,5,21,0.185,73,0.37,4,0.391,14.0,190,23,168,0.121,351,0.541,31,0.594,8.6,217,28,189,0.129,417,0.52,35,0.568,9.2,2018-19,Regular%20Season
1629151,Ryan Broekhoff,1610612742,DAL,26,10,16,351.0,8,3,5,0.375,24,0.333,1,0.348,14.0,55,11,45,0.2,84,0.655,8,0.724,9.5,63,14,50,0.222,105,0.6,9,0.656,10.1,2018-19,Regular%20Season
1626257,Salah Mejri,1610612742,DAL,31,10,21,381.0,36,20,16,0.556,94,0.383,2,0.391,5.5,95,33,62,0.347,165,0.576,10,0.613,4.4,131,53,78,0.405,250,0.524,12,0.55,4.7,2018-19,Regular%20Season
1626155,Sam Dekker,1610612764,WAS,41,13,28,736.0,49,24,23,0.49,135,0.363,4,0.374,6.3,93,12,81,0.129,169,0.55,13,0.596,6.6,142,36,104,0.254,290,0.49,17,0.52,6.5,2018-19,Regular%20Season
1628400,Semi Ojeleye,1610612738,BOS,39,26,13,506.0,24,13,12,0.542,52,0.462,1,0.471,11.1,62,19,43,0.306,114,0.544,12,0.608,7.2,86,32,55,0.372,159,0.541,13,0.589,8.3,2018-19,Regular%20Season
201586,Serge Ibaka,1610612761,TOR,74,53,21,2010.0,156,113,43,0.724,353,0.442,6,0.45,5.1,445,132,313,0.297,762,0.584,57,0.631,4.1,601,245,356,0.408,1082,0.555,63,0.59,4.4,2018-19,Regular%20Season
203552,Seth Curry,1610612757,POR,56,38,18,1131.0,26,7,19,0.269,58,0.448,2,0.464,15.5,93,9,84,0.097,159,0.585,12,0.633,10.4,119,16,103,0.134,216,0.551,14,0.589,11.5,2018-19,Regular%20Season
203894,Shabazz Napier,1610612751,BKN,41,20,21,823.0,18,4,14,0.222,62,0.29,4,0.31,19.3,82,10,72,0.122,156,0.526,19,0.599,8.1,100,14,86,0.14,215,0.465,23,0.521,10.1,2018-19,Regular%20Season
1628983,Shai Gilgeous-Alexander,1610612746,LAC,78,47,31,2089.0,57,18,36,0.316,145,0.393,8,0.416,13.5,175,46,130,0.263,319,0.549,29,0.603,8.3,232,64,166,0.276,453,0.512,37,0.558,9.6,2018-19,Regular%20Season
1629003,Shake Milton,1610612755,PHI,14,6,8,221.0,9,1,7,0.111,18,0.5,3,0.6,12.5,26,3,23,0.115,47,0.553,5,0.619,7.0,35,4,30,0.114,65,0.538,8,0.614,8.3,2018-19,Regular%20Season
1627885,Shaquille Harrison,1610612741,CHI,63,18,45,1306.0,33,16,18,0.485,104,0.317,5,0.333,9.2,187,24,162,0.128,306,0.611,23,0.661,8.3,220,40,180,0.182,404,0.545,28,0.585,8.4,2018-19,Regular%20Season
2733,Shaun Livingston,1610612744,GSW,50,35,15,773.0,42,23,19,0.548,71,0.592,4,0.627,8.5,75,14,61,0.187,130,0.577,11,0.63,9.0,117,37,80,0.316,200,0.585,15,0.632,8.8,2018-19,Regular%20Season
202714,Shelvin Mack,1610612766,CHA,46,17,29,1092.0,18,7,11,0.389,58,0.31,3,0.327,16.5,86,11,75,0.128,171,0.503,17,0.558,10.0,104,18,86,0.173,228,0.456,20,0.5,11.1,2018-19,Regular%20Season
1628414,Sindarius Thornwell,1610612746,LAC,26,16,10,217.0,5,3,2,0.6,15,0.333,0,0.333,6.6,39,10,29,0.256,62,0.629,6,0.696,7.4,44,13,31,0.295,74,0.595,6,0.647,7.3,2018-19,Regular%20Season
1627746,Skal Labissiere,1610612757,POR,15,7,8,154.0,9,7,1,0.778,15,0.6,2,0.692,4.7,34,10,24,0.294,54,0.63,5,0.694,6.0,43,17,25,0.395,69,0.623,7,0.694,5.8,2018-19,Regular%20Season
203524,Solomon Hill,1610612740,NOP,38,12,26,821.0,34,16,19,0.471,84,0.405,5,0.43,7.3,99,25,73,0.253,164,0.604,13,0.656,7.1,133,41,92,0.308,243,0.547,18,0.591,7.2,2018-19,Regular%20Season
203915,Spencer Dinwiddie,1610612751,BKN,60,32,28,1705.0,26,5,20,0.192,84,0.31,3,0.321,16.0,140,20,121,0.143,242,0.579,16,0.619,9.4,166,25,141,0.151,323,0.514,19,0.546,10.4,2018-19,Regular%20Season
1626169,Stanley Johnson,1610612740,NOP,63,28,35,1167.0,34,21,12,0.618,108,0.315,4,0.327,10.9,183,28,155,0.153,298,0.614,25,0.67,6.9,217,49,167,0.226,388,0.559,29,0.604,7.5,2018-19,Regular%20Season
201939,Stephen Curry,1610612744,GSW,69,52,17,2331.0,45,18,26,0.4,144,0.313,6,0.326,11.5,324,57,263,0.176,539,0.601,41,0.651,7.7,369,75,289,0.203,683,0.54,47,0.58,8.2,2018-19,Regular%20Season
1628425,Sterling Brown,1610612749,MIL,51,38,13,964.0,29,15,13,0.517,82,0.354,1,0.358,10.0,155,22,133,0.142,244,0.635,23,0.701,7.2,184,37,146,0.201,323,0.57,24,0.615,7.6,2018-19,Regular%20Season
203500,Steven Adams,1610612760,OKC,79,46,33,2634.0,384,234,141,0.609,799,0.481,22,0.494,5.4,367,128,240,0.349,705,0.521,73,0.581,5.2,751,362,381,0.482,1478,0.508,95,0.543,5.3,2018-19,Regular%20Season
1629004,Svi Mykhailiuk,1610612765,DET,18,7,11,258.0,9,3,6,0.333,13,0.692,0,0.692,12.4,26,4,22,0.154,40,0.65,3,0.703,10.3,35,7,28,0.2,53,0.66,3,0.7,10.8,2018-19,Regular%20Season
1628388,T.J. Leaf,1610612754,IND,50,30,20,495.0,43,25,19,0.581,80,0.538,0,0.538,6.1,82,20,62,0.244,129,0.636,9,0.683,6.4,125,45,81,0.36,200,0.625,9,0.654,6.3,2018-19,Regular%20Season
204456,T.J. McConnell,1610612755,PHI,66,41,25,1342.0,27,3,24,0.111,70,0.386,3,0.403,11.9,142,21,121,0.148,242,0.587,26,0.657,8.2,169,24,145,0.142,307,0.55,29,0.608,8.8,2018-19,Regular%20Season
203933,T.J. Warren,1610612756,PHX,43,10,33,1360.0,31,11,20,0.355,108,0.287,3,0.295,9.6,143,35,107,0.245,258,0.554,21,0.603,7.5,174,46,127,0.264,344,0.506,24,0.544,7.8,2018-19,Regular%20Season
1628769,Tahjere McCall,1610612751,BKN,1,0,1,8.0,0,0,0,0.0,0,0.0,0,0.0,0.0,1,0,1,0.0,1,1.0,0,1.0,6.5,1,0,1,0.0,1,1.0,0,1.0,6.5,2018-19,Regular%20Season
201959,Taj Gibson,1610612750,MIN,70,32,38,1686.0,172,120,51,0.698,410,0.42,13,0.433,5.8,286,73,212,0.255,476,0.601,42,0.659,5.7,458,193,263,0.421,854,0.536,55,0.573,5.7,2018-19,Regular%20Season
1627752,Taurean Prince,1610612737,ATL,54,19,35,1527.0,22,7,16,0.318,66,0.333,4,0.355,15.4,177,35,141,0.198,286,0.619,23,0.673,7.2,199,42,157,0.211,348,0.572,27,0.62,8.1,2018-19,Regular%20Season
1628390,Terrance Ferguson,1610612760,OKC,59,34,25,1616.0,33,13,22,0.394,76,0.434,5,0.465,12.9,105,19,86,0.181,204,0.515,18,0.565,9.2,138,32,108,0.232,276,0.5,23,0.545,10.0,2018-19,Regular%20Season
203093,Terrence Jones,1610612745,HOU,1,1,0,4.0,0,0,0,0.0,1,0.0,0,0.0,0.0,4,2,2,0.5,4,1.0,0,1.0,3.5,4,2,2,0.5,4,1.0,0,1.0,3.5,2018-19,Regular%20Season
203082,Terrence Ross,1610612753,ORL,78,40,38,2075.0,26,10,17,0.385,77,0.338,4,0.356,14.6,250,26,224,0.104,414,0.604,30,0.651,6.5,276,36,241,0.13,478,0.577,34,0.622,7.3,2018-19,Regular%20Season
1626179,Terry Rozier,1610612738,BOS,77,46,31,1766.0,32,8,23,0.25,106,0.302,8,0.327,10.6,275,41,235,0.149,463,0.594,35,0.643,7.4,307,49,258,0.16,563,0.545,43,0.59,7.7,2018-19,Regular%20Season
200757,Thabo Sefolosha,1610612762,UTA,43,25,18,568.0,8,3,5,0.375,39,0.205,1,0.211,13.3,114,20,92,0.175,182,0.626,17,0.691,5.8,122,23,97,0.189,207,0.589,18,0.646,6.3,2018-19,Regular%20Season
201152,Thaddeus Young,1610612754,IND,81,47,34,2489.0,192,129,62,0.672,461,0.416,16,0.431,5.2,331,74,250,0.224,587,0.564,46,0.612,6.0,523,203,312,0.388,1022,0.512,62,0.545,5.7,2018-19,Regular%20Season
1629033,Theo Pinson,1610612751,BKN,12,4,8,197.0,4,2,2,0.5,14,0.286,0,0.286,13.9,32,5,26,0.156,55,0.582,2,0.604,6.9,36,7,28,0.194,66,0.545,2,0.563,7.7,2018-19,Regular%20Season
1628418,Thomas Bryant,1610612764,WAS,68,26,42,1464.0,110,65,41,0.591,254,0.433,10,0.451,5.8,335,118,211,0.352,557,0.601,52,0.663,4.2,445,183,252,0.411,784,0.568,62,0.616,4.6,2018-19,Regular%20Season
1629118,Thomas Welsh,1610612743,DEN,4,3,1,19.0,0,0,0,0.0,3,0.0,1,0.0,0.0,4,1,3,0.25,6,0.667,1,0.8,7.7,4,1,3,0.25,8,0.5,2,0.667,7.7,2018-19,Regular%20Season
1627748,Thon Maker,1610612765,DET,59,41,18,945.0,41,20,21,0.488,132,0.311,5,0.323,6.7,161,32,129,0.199,304,0.53,34,0.596,6.1,202,52,150,0.257,411,0.491,39,0.543,6.2,2018-19,Regular%20Season
204025,Tim Frazier,1610612749,MIL,49,21,28,1067.0,41,16,25,0.39,105,0.39,7,0.418,10.4,127,17,109,0.134,211,0.602,22,0.672,7.3,168,33,134,0.196,304,0.553,29,0.611,8.1,2018-19,Regular%20Season
203501,Tim Hardaway Jr.,1610612742,DAL,61,14,47,1951.0,33,22,11,0.667,108,0.306,7,0.327,11.6,187,27,161,0.144,332,0.563,28,0.615,8.2,220,49,172,0.223,424,0.519,35,0.566,8.7,2018-19,Regular%20Season
1627789,Timothe Luwawu-Cabarrot,1610612741,CHI,29,12,17,559.0,11,4,7,0.364,45,0.244,3,0.262,14.5,86,24,61,0.279,138,0.623,14,0.694,5.9,97,28,68,0.289,176,0.551,17,0.61,6.9,2018-19,Regular%20Season
202699,Tobias Harris,1610612755,PHI,82,46,36,2848.0,69,34,36,0.493,231,0.299,11,0.314,8.0,576,103,471,0.179,907,0.635,83,0.699,5.6,645,137,507,0.212,1092,0.591,94,0.646,5.8,2018-19,Regular%20Season
203107,Tomas Satoransky,1610612764,WAS,70,31,39,1956.0,81,38,42,0.469,179,0.453,9,0.476,9.4,194,24,169,0.124,339,0.572,30,0.628,8.3,275,62,211,0.225,515,0.534,39,0.578,8.6,2018-19,Regular%20Season
1628396,Tony Bradley,1610612762,UTA,3,2,1,36.0,9,8,1,0.889,17,0.529,1,0.563,3.6,6,0,6,0.0,8,0.75,1,0.857,3.2,15,8,7,0.533,24,0.625,2,0.682,3.4,2018-19,Regular%20Season
2225,Tony Parker,1610612766,CHA,44,23,21,814.0,14,4,10,0.286,61,0.23,6,0.255,12.7,69,5,64,0.072,109,0.633,8,0.683,10.5,83,9,74,0.108,169,0.491,14,0.535,10.9,2018-19,Regular%20Season
203503,Tony Snell,1610612749,MIL,62,46,16,1153.0,29,19,10,0.655,82,0.354,3,0.367,10.6,128,17,111,0.133,234,0.547,23,0.607,6.9,157,36,121,0.229,299,0.525,26,0.575,7.6,2018-19,Regular%20Season
1628470,Torrey Craig,1610612743,DEN,64,44,20,1419.0,89,53,37,0.596,213,0.418,6,0.43,8.3,174,30,144,0.172,306,0.569,29,0.628,7.3,263,83,181,0.316,496,0.53,35,0.57,7.7,2018-19,Regular%20Season
1629027,Trae Young,1610612737,ATL,78,29,49,2423.0,64,17,46,0.266,200,0.32,7,0.332,12.7,237,20,218,0.084,402,0.59,31,0.639,9.6,301,37,264,0.123,591,0.509,38,0.544,10.2,2018-19,Regular%20Season
1626203,Treveon Graham,1610612751,BKN,32,18,14,667.0,23,15,7,0.652,85,0.271,3,0.28,6.5,84,16,68,0.19,149,0.564,15,0.627,6.7,107,31,75,0.29,230,0.465,18,0.505,6.7,2018-19,Regular%20Season
1628979,Trevon Duval,1610612745,HOU,1,0,1,4.0,0,0,0,0.0,0,0.0,0,0.0,0.0,1,1,0,1.0,1,1.0,0,1.0,9.0,1,1,0,1.0,1,1.0,0,1.0,9.0,2018-19,Regular%20Season
2772,Trevor Ariza,1610612764,WAS,67,21,46,2304.0,48,20,27,0.417,169,0.284,1,0.286,10.6,316,55,260,0.174,500,0.632,33,0.677,6.3,364,75,287,0.206,618,0.589,34,0.623,6.9,2018-19,Regular%20Season
203504,Trey Burke,1610612742,DAL,42,12,30,876.0,28,10,18,0.357,74,0.378,5,0.406,11.3,71,10,60,0.141,124,0.573,11,0.628,10.2,99,20,78,0.202,197,0.503,16,0.547,10.5,2018-19,Regular%20Season
1626168,Trey Lyles,1610612743,DEN,62,40,22,1117.0,44,27,16,0.614,125,0.352,4,0.364,7.4,202,46,154,0.228,338,0.598,15,0.625,5.3,246,73,170,0.297,446,0.552,19,0.576,5.7,2018-19,Regular%20Season
202684,Tristan Thompson,1610612739,CLE,42,8,34,1176.0,172,132,40,0.767,365,0.471,7,0.48,4.2,260,72,187,0.277,446,0.583,39,0.639,4.9,432,204,227,0.472,793,0.545,46,0.578,4.6,2018-19,Regular%20Season
1628972,Troy Brown Jr.,1610612764,WAS,36,14,22,631.0,33,18,14,0.545,80,0.413,1,0.418,10.3,105,24,80,0.229,159,0.66,12,0.714,7.1,138,42,94,0.304,237,0.582,13,0.616,7.9,2018-19,Regular%20Season
1628505,Troy Caupain,1610612753,ORL,3,2,1,13.0,1,0,1,0.0,1,1.0,0,1.0,32.4,2,1,1,0.5,4,0.5,0,0.5,5.9,3,1,2,0.333,5,0.6,0,0.6,14.8,2018-19,Regular%20Season
203584,Troy Daniels,1610612756,PHX,36,9,27,615.0,13,5,8,0.385,31,0.419,2,0.448,9.7,60,9,51,0.15,115,0.522,9,0.566,6.9,73,14,59,0.192,145,0.503,11,0.545,7.4,2018-19,Regular%20Season
1627786,Troy Williams,1610612758,SAC,19,7,12,304.0,12,6,6,0.5,39,0.308,1,0.316,7.7,47,13,34,0.277,73,0.644,3,0.671,6.0,59,19,40,0.322,109,0.541,4,0.562,6.3,2018-19,Regular%20Season
1628463,Tyler Cavanaugh,1610612762,UTA,6,4,2,30.0,3,1,2,0.333,4,0.75,0,0.75,15.2,5,2,3,0.4,8,0.625,1,0.714,4.5,8,3,5,0.375,12,0.667,1,0.727,8.5,2018-19,Regular%20Season
1629093,Tyler Davis,1610612760,OKC,1,1,0,1.0,1,1,0,1.0,1,1.0,0,1.0,2.3,0,0,0,0.0,0,0.0,0,0.0,0.0,1,1,0,1.0,1,1.0,0,1.0,2.3,2018-19,Regular%20Season
1628416,Tyler Dorsey,1610612763,MEM,36,8,28,617.0,27,10,15,0.37,57,0.474,3,0.5,11.0,86,10,76,0.116,131,0.656,11,0.717,7.0,113,20,91,0.177,184,0.614,14,0.665,7.9,2018-19,Regular%20Season
204020,Tyler Johnson,1610612756,PHX,54,26,28,1456.0,34,17,17,0.5,101,0.337,8,0.366,11.7,139,10,127,0.072,271,0.513,30,0.577,8.4,173,27,144,0.156,372,0.465,38,0.518,9.1,2018-19,Regular%20Season
1628399,Tyler Lydon,1610612743,DEN,12,7,5,64.0,7,6,1,0.857,20,0.35,0,0.35,5.4,11,1,10,0.091,17,0.647,0,0.647,5.7,18,7,11,0.389,36,0.5,0,0.5,5.6,2018-19,Regular%20Season
203092,Tyler Zeller,1610612763,MEM,6,3,3,93.0,11,7,4,0.636,36,0.306,2,0.324,5.3,13,5,8,0.385,28,0.464,6,0.591,4.6,24,12,12,0.5,62,0.387,8,0.444,4.9,2018-19,Regular%20Season
201936,Tyreke Evans,1610612754,IND,62,37,25,1262.0,33,16,17,0.485,114,0.289,13,0.327,11.1,168,34,134,0.202,252,0.667,13,0.703,8.4,201,50,151,0.249,359,0.56,26,0.604,8.8,2018-19,Regular%20Season
1627820,Tyrone Wallace,1610612746,LAC,45,25,20,568.0,20,11,8,0.55,66,0.303,1,0.308,8.8,81,18,63,0.222,137,0.591,14,0.659,6.2,101,29,71,0.287,198,0.51,15,0.552,6.7,2018-19,Regular%20Season
2199,Tyson Chandler,1610612747,LAL,52,25,27,863.0,92,60,33,0.652,199,0.462,7,0.479,5.0,215,71,143,0.33,376,0.572,37,0.634,4.6,307,131,176,0.427,561,0.547,44,0.594,4.7,2018-19,Regular%20Season
1626145,Tyus Jones,1610612750,MIN,57,23,34,1366.0,23,3,20,0.13,50,0.46,2,0.479,17.0,111,7,105,0.063,180,0.617,10,0.653,9.9,134,10,125,0.075,227,0.59,12,0.623,11.1,2018-19,Regular%20Season
2617,Udonis Haslem,1610612748,MIA,7,5,2,64.0,3,2,1,0.667,8,0.375,0,0.375,3.3,24,4,20,0.167,38,0.632,3,0.686,4.2,27,6,21,0.222,45,0.6,3,0.643,4.1,2018-19,Regular%20Season
203506,Victor Oladipo,1610612754,IND,36,25,11,1147.0,21,10,12,0.476,90,0.233,5,0.247,10.8,181,31,150,0.171,276,0.656,16,0.696,7.1,202,41,162,0.203,365,0.553,21,0.587,7.5,2018-19,Regular%20Season
1713,Vince Carter,1610612737,ATL,63,20,43,1147.0,31,14,17,0.452,97,0.32,4,0.333,11.3,163,40,123,0.245,325,0.502,23,0.54,5.9,194,54,140,0.278,390,0.497,27,0.534,6.8,2018-19,Regular%20Season
1629053,Vincent Edwards,1610612745,HOU,2,1,1,16.0,1,0,1,0.0,1,1.0,0,1.0,20.7,1,0,1,0.0,1,1.0,0,1.0,3.1,2,0,2,0.0,2,1.0,0,1.0,11.9,2018-19,Regular%20Season
1627735,Wade Baldwin IV,1610612757,POR,9,7,2,69.0,2,1,1,0.5,10,0.2,1,0.222,5.5,13,2,11,0.154,20,0.65,1,0.684,8.1,15,3,12,0.2,27,0.556,2,0.6,7.7,2018-19,Regular%20Season
1627215,Walt Lemon Jr.,1610612741,CHI,6,1,5,167.0,4,2,2,0.5,18,0.222,0,0.222,8.7,23,1,22,0.043,33,0.697,2,0.742,7.6,27,3,24,0.111,47,0.574,2,0.6,7.8,2018-19,Regular%20Season
201961,Wayne Ellington,1610612765,DET,41,21,20,1115.0,14,0,14,0.0,39,0.359,4,0.4,17.7,93,13,80,0.14,154,0.604,6,0.628,9.8,107,13,94,0.121,187,0.572,10,0.605,10.8,2018-19,Regular%20Season
1627782,Wayne Selden,1610612741,CHI,60,23,37,1262.0,37,18,20,0.486,94,0.394,3,0.407,11.8,143,24,119,0.168,222,0.644,16,0.694,8.3,180,42,139,0.233,306,0.588,19,0.627,9.0,2018-19,Regular%20Season
1628976,Wendell Carter Jr.,1610612741,CHI,43,10,33,1092.0,87,61,26,0.701,204,0.426,5,0.437,5.8,217,85,132,0.392,387,0.561,30,0.608,4.5,304,146,158,0.48,578,0.526,35,0.56,4.9,2018-19,Regular%20Season
1628411,Wes Iwundu,1610612753,ORL,59,32,27,1114.0,37,19,18,0.514,83,0.446,4,0.468,8.3,146,24,121,0.164,227,0.643,13,0.682,7.0,183,43,139,0.235,304,0.602,17,0.638,7.3,2018-19,Regular%20Season
202325,Wesley Johnson,1610612764,WAS,28,12,16,468.0,12,4,8,0.333,34,0.353,0,0.353,11.6,60,11,49,0.183,90,0.667,5,0.706,8.0,72,15,57,0.208,118,0.61,5,0.637,8.6,2018-19,Regular%20Season
202083,Wesley Matthews,1610612754,IND,61,22,39,1865.0,32,12,20,0.375,85,0.376,8,0.416,13.5,138,24,114,0.174,257,0.537,19,0.58,9.7,170,36,134,0.212,335,0.507,27,0.552,10.4,2018-19,Regular%20Season
203115,Will Barton,1610612743,DEN,41,25,16,1150.0,32,13,19,0.406,88,0.364,5,0.386,11.5,167,31,134,0.186,263,0.635,18,0.682,6.3,199,44,153,0.221,338,0.589,23,0.632,7.1,2018-19,Regular%20Season
1626161,Willie Cauley-Stein,1610612758,SAC,79,38,41,2188.0,181,103,77,0.569,411,0.44,13,0.455,7.2,497,165,332,0.332,831,0.598,78,0.66,4.5,678,268,409,0.395,1210,0.56,91,0.606,5.3,2018-19,Regular%20Season
1626195,Willy Hernangomez,1610612766,CHA,55,29,26,800.0,117,87,31,0.744,226,0.518,2,0.522,5.3,194,55,140,0.284,322,0.602,18,0.638,4.4,311,142,171,0.457,532,0.585,20,0.607,4.7,2018-19,Regular%20Season
201163,Wilson Chandler,1610612746,LAC,49,34,15,1137.0,47,28,20,0.596,111,0.423,3,0.435,7.5,161,40,121,0.248,257,0.626,11,0.654,6.0,208,68,141,0.327,358,0.581,14,0.605,6.3,2018-19,Regular%20Season
1628999,Yante Maten,1610612748,MIA,2,1,1,13.0,1,0,1,0.0,1,1.0,0,1.0,4.6,2,1,1,0.5,8,0.25,0,0.25,2.1,3,1,2,0.333,9,0.333,0,0.333,2.9,2018-19,Regular%20Season
1627812,Yogi Ferrell,1610612758,SAC,53,22,31,895.0,13,4,9,0.308,41,0.317,4,0.351,14.1,96,8,86,0.083,166,0.578,18,0.649,9.8,109,12,95,0.11,204,0.534,22,0.599,10.3,2018-19,Regular%20Season
1629139,Yuta Watanabe,1610612763,MEM,13,5,8,165.0,4,1,3,0.25,10,0.4,0,0.4,12.3,27,7,20,0.259,42,0.643,3,0.692,6.6,31,8,23,0.258,52,0.596,3,0.633,7.3,2018-19,Regular%20Season
1628380,Zach Collins,1610612757,POR,75,50,25,1336.0,109,75,30,0.688,271,0.402,9,0.416,5.7,215,83,131,0.386,414,0.519,43,0.58,4.8,324,158,161,0.488,663,0.489,52,0.53,5.1,2018-19,Regular%20Season
203897,Zach LaVine,1610612741,CHI,62,16,46,2130.0,40,23,15,0.575,183,0.219,6,0.226,6.6,251,32,218,0.127,401,0.626,42,0.699,5.9,291,55,233,0.189,565,0.515,48,0.563,6.0,2018-19,Regular%20Season
2585,Zaza Pachulia,1610612765,DET,65,34,31,852.0,99,70,27,0.707,253,0.391,4,0.398,4.5,166,61,104,0.367,328,0.506,36,0.568,4.3,265,131,131,0.494,561,0.472,40,0.509,4.4,2018-19,Regular%20Season
1629015,Zhaire Smith,1610612755,PHI,5,2,3,101.0,3,3,0,1.0,7,0.429,0,0.429,4.6,10,1,9,0.1,15,0.667,2,0.769,10.4,13,4,9,0.308,22,0.591,2,0.65,9.0,2018-19,Regular%20Season
203932,Aaron Gordon,1610612753,ORL,5,1,4,164.0,11,6,5,0.545,21,0.524,1,0.55,4.8,25,7,18,0.28,37,0.676,2,0.714,5.6,36,13,23,0.361,57,0.632,3,0.667,5.4,2018-19,Playoffs
201143,Al Horford,1610612738,BOS,9,5,4,310.0,13,10,3,0.769,38,0.342,0,0.342,5.3,68,16,52,0.235,98,0.694,8,0.756,6.9,81,26,55,0.321,132,0.614,8,0.653,6.6,2018-19,Playoffs
202329,Al-Farouq Aminu,1610612757,POR,16,8,8,399.0,29,19,10,0.655,70,0.414,4,0.439,8.0,71,20,51,0.282,129,0.55,12,0.607,4.4,100,39,61,0.39,196,0.51,16,0.556,5.5,2018-19,Playoffs
1628035,Alfonzo McKinnie,1610612744,GSW,19,11,8,218.0,17,15,2,0.882,37,0.459,1,0.472,4.8,33,11,22,0.333,56,0.589,3,0.623,4.8,50,26,24,0.52,92,0.543,4,0.568,4.8,2018-19,Playoffs
101161,Amir Johnson,1610612755,PHI,3,2,1,15.0,3,2,1,0.667,6,0.5,0,0.5,3.2,2,1,1,0.5,5,0.4,1,0.5,2.6,5,3,2,0.6,11,0.455,1,0.5,3.0,2018-19,Playoffs
203083,Andre Drummond,1610612765,DET,4,0,4,127.0,20,15,5,0.75,44,0.455,2,0.476,4.3,32,8,23,0.25,47,0.681,3,0.727,4.4,52,23,28,0.442,88,0.591,5,0.627,4.4,2018-19,Playoffs
2738,Andre Iguodala,1610612744,GSW,21,13,8,629.0,27,15,12,0.556,62,0.435,0,0.435,9.7,64,19,45,0.297,118,0.542,4,0.561,8.5,91,34,57,0.374,177,0.514,4,0.526,8.9,2018-19,Playoffs
101106,Andrew Bogut,1610612744,GSW,18,12,6,176.0,23,16,7,0.696,43,0.535,0,0.535,5.6,51,11,40,0.216,76,0.671,5,0.718,3.8,74,27,47,0.365,112,0.661,5,0.692,4.4,2018-19,Playoffs
203382,Aron Baynes,1610612738,BOS,7,4,3,104.0,6,6,0,1.0,18,0.333,0,0.333,5.0,19,5,14,0.263,37,0.514,4,0.576,5.9,25,11,14,0.44,54,0.463,4,0.5,5.7,2018-19,Playoffs
203085,Austin Rivers,1610612745,HOU,9,5,4,206.0,2,1,1,0.5,11,0.182,0,0.182,3.7,19,4,15,0.211,33,0.576,7,0.731,10.7,21,5,16,0.238,42,0.5,7,0.6,10.0,2018-19,Playoffs
1627732,Ben Simmons,1610612755,PHI,12,7,5,421.0,23,16,8,0.696,65,0.354,1,0.359,6.1,61,6,55,0.098,97,0.629,8,0.685,7.4,84,22,63,0.262,155,0.542,9,0.575,7.0,2018-19,Playoffs
201933,Blake Griffin,1610612765,DET,2,0,2,58.0,4,3,1,0.75,6,0.667,0,0.667,3.1,8,2,6,0.25,13,0.615,0,0.615,5.6,12,5,7,0.417,18,0.667,0,0.667,4.8,2018-19,Playoffs
1626246,Boban Marjanovic,1610612755,PHI,9,6,3,98.0,13,9,4,0.692,26,0.5,3,0.565,5.4,23,6,17,0.261,40,0.575,5,0.657,4.6,36,15,21,0.417,65,0.554,8,0.632,4.9,2018-19,Playoffs
202711,Bojan Bogdanovic,1610612754,IND,4,0,4,148.0,3,1,2,0.333,9,0.333,0,0.333,12.7,20,2,18,0.1,36,0.556,3,0.606,6.3,23,3,20,0.13,42,0.548,3,0.59,7.1,2018-19,Playoffs
202954,Brad Wanamaker,1610612738,BOS,1,0,1,4.0,0,0,0,0.0,0,0.0,0,0.0,0.0,0,0,1,0.0,1,0.0,0,0.0,18.4,0,0,1,0.0,1,0.0,0,0.0,18.4,2018-19,Playoffs
201572,Brook Lopez,1610612749,MIL,14,9,5,420.0,12,10,2,0.833,26,0.462,1,0.48,7.4,70,21,49,0.3,131,0.534,7,0.565,6.5,82,31,51,0.378,153,0.536,8,0.566,6.6,2018-19,Playoffs
1628971,Bruce Brown,1610612765,DET,3,0,3,44.0,1,0,1,0.0,3,0.333,0,0.333,2.9,7,4,3,0.571,10,0.7,2,0.875,5.7,8,4,4,0.5,13,0.615,2,0.727,5.3,2018-19,Playoffs
1627854,Bryn Forbes,1610612759,SAS,6,3,3,188.0,1,0,1,0.0,3,0.333,0,0.333,34.9,24,7,17,0.292,36,0.667,2,0.706,7.0,25,7,18,0.28,39,0.641,2,0.676,8.1,2018-19,Playoffs
203468,CJ McCollum,1610612757,POR,16,8,8,635.0,14,8,6,0.571,44,0.318,1,0.326,8.8,66,15,51,0.227,90,0.733,6,0.786,9.1,80,23,57,0.288,133,0.602,7,0.635,9.0,2018-19,Playoffs
1627747,Caris LeVert,1610612751,BKN,5,1,4,144.0,6,2,4,0.333,18,0.333,2,0.375,14.2,17,7,10,0.412,32,0.531,2,0.567,4.8,23,9,14,0.391,49,0.469,4,0.511,7.3,2018-19,Playoffs
1628449,Chris Boucher,1610612761,TOR,1,1,0,2.0,0,0,0,0.0,2,0.0,0,0.0,0.0,1,0,1,0.0,1,1.0,0,1.0,6.3,1,0,1,0.0,3,0.333,0,0.333,6.3,2018-19,Playoffs
101108,Chris Paul,1610612745,HOU,11,6,5,397.0,14,3,11,0.214,26,0.538,0,0.538,13.1,56,12,44,0.214,104,0.538,14,0.622,7.6,70,15,55,0.214,129,0.543,14,0.609,8.7,2018-19,Playoffs
203991,Clint Capela,1610612745,HOU,11,6,5,331.0,41,21,20,0.512,96,0.427,0,0.427,7.7,72,22,49,0.306,123,0.585,11,0.643,5.0,113,43,69,0.381,215,0.526,11,0.554,6.0,2018-19,Playoffs
202709,Cory Joseph,1610612754,IND,4,0,4,85.0,1,1,0,1.0,5,0.2,0,0.2,4.7,6,1,5,0.167,16,0.375,0,0.375,7.8,7,2,5,0.286,21,0.333,0,0.333,7.4,2018-19,Playoffs
1626156,D'Angelo Russell,1610612751,BKN,5,1,4,148.0,2,1,1,0.5,6,0.333,1,0.4,2.1,16,2,14,0.125,26,0.615,2,0.667,8.6,18,3,15,0.167,32,0.563,3,0.621,7.9,2018-19,Playoffs
201571,D.J. Augustin,1610612753,ORL,5,1,4,141.0,1,1,0,1.0,10,0.1,0,0.1,2.3,7,0,7,0.0,19,0.368,3,0.438,6.5,8,1,7,0.125,27,0.296,3,0.333,6.0,2018-19,Playoffs
1628391,D.J. Wilson,1610612749,MIL,6,5,1,38.0,1,1,0,1.0,3,0.333,0,0.333,7.0,9,2,7,0.222,13,0.692,1,0.75,4.1,10,3,7,0.3,15,0.667,1,0.714,4.3,2018-19,Playoffs
1627745,Damian Jones,1610612744,GSW,2,2,0,3.0,0,0,0,0.0,0,0.0,0,0.0,0.0,2,0,2,0.0,2,1.0,0,1.0,4.0,2,0,2,0.0,2,1.0,0,1.0,4.0,2018-19,Playoffs
203081,Damian Lillard,1610612757,POR,16,8,8,650.0,8,2,6,0.25,38,0.211,4,0.235,12.5,68,13,55,0.191,118,0.576,10,0.63,7.6,76,15,61,0.197,154,0.494,14,0.543,8.1,2018-19,Playoffs
1628464,Daniel Theis,1610612738,BOS,5,4,1,33.0,4,3,1,0.75,10,0.4,0,0.4,2.3,6,2,4,0.333,8,0.75,2,1.0,5.5,10,5,5,0.5,16,0.625,2,0.714,4.2,2018-19,Playoffs
201568,Danilo Gallinari,1610612746,LAC,6,2,4,201.0,9,5,4,0.556,23,0.391,0,0.391,7.7,28,7,20,0.25,44,0.636,2,0.667,5.6,37,12,24,0.324,67,0.552,2,0.569,6.1,2018-19,Playoffs
201980,Danny Green,1610612761,TOR,24,16,8,684.0,17,5,12,0.294,54,0.315,2,0.327,11.3,70,10,60,0.143,131,0.534,9,0.574,6.7,87,15,72,0.172,182,0.478,11,0.509,7.6,2018-19,Playoffs
201967,Dante Cunningham,1610612759,SAS,3,2,1,8.0,2,0,2,0.0,4,0.5,0,0.5,7.5,4,1,3,0.25,5,0.8,0,0.8,5.4,6,1,5,0.167,8,0.75,0,0.75,6.1,2018-19,Playoffs
1627863,Danuel House Jr.,1610612745,HOU,6,4,2,135.0,2,0,2,0.0,7,0.286,0,0.286,10.3,20,6,14,0.3,36,0.556,1,0.571,6.4,22,6,16,0.273,42,0.524,1,0.537,6.8,2018-19,Playoffs
201954,Darren Collison,1610612754,IND,4,0,4,117.0,4,2,2,0.5,9,0.444,0,0.444,9.4,8,0,8,0.0,14,0.571,1,0.615,9.0,12,2,10,0.167,23,0.522,1,0.545,9.1,2018-19,Playoffs
202722,Davis Bertans,1610612759,SAS,3,1,2,53.0,0,0,0,0.0,2,0.0,1,0.0,0.0,8,2,6,0.25,16,0.5,3,0.615,6.1,8,2,6,0.25,17,0.471,4,0.615,6.1,2018-19,Playoffs
201942,DeMar DeRozan,1610612759,SAS,7,3,4,251.0,10,3,7,0.3,27,0.37,3,0.417,18.5,37,8,29,0.216,51,0.725,2,0.755,6.5,47,11,36,0.234,69,0.681,5,0.734,9.0,2018-19,Playoffs
202326,DeMarcus Cousins,1610612744,GSW,7,3,4,125.0,9,8,1,0.889,38,0.237,2,0.25,4.6,30,8,22,0.267,48,0.625,4,0.682,4.7,39,16,23,0.41,81,0.481,6,0.52,4.7,2018-19,Playoffs
201960,DeMarre Carroll,1610612751,BKN,5,1,4,119.0,6,2,4,0.333,21,0.286,0,0.286,12.0,14,2,12,0.143,32,0.438,5,0.519,4.9,20,4,16,0.2,52,0.385,5,0.426,7.0,2018-19,Playoffs
203471,Dennis Schroder,1610612760,OKC,5,1,4,151.0,2,1,1,0.5,8,0.25,0,0.25,6.3,14,1,13,0.071,18,0.778,0,0.778,13.9,16,2,14,0.125,26,0.615,0,0.615,13.0,2018-19,Playoffs
1629126,Deonte Burton,1610612760,OKC,1,0,1,4.0,1,1,0,1.0,1,1.0,0,1.0,2.5,1,1,0,1.0,1,1.0,0,1.0,4.1,2,2,0,1.0,2,1.0,0,1.0,3.3,2018-19,Playoffs
202324,Derrick Favors,1610612762,UTA,5,1,4,103.0,15,11,4,0.733,36,0.417,0,0.417,3.6,22,10,12,0.455,41,0.537,2,0.564,4.5,37,21,16,0.568,75,0.493,2,0.507,4.2,2018-19,Playoffs
1628401,Derrick White,1610612759,SAS,7,3,4,191.0,1,1,0,1.0,9,0.111,1,0.125,3.3,20,2,18,0.1,38,0.526,5,0.606,6.8,21,3,18,0.143,47,0.447,6,0.512,6.6,2018-19,Playoffs
1627734,Domantas Sabonis,1610612754,IND,4,0,4,96.0,7,5,2,0.714,21,0.333,0,0.333,3.6,22,8,14,0.364,34,0.647,3,0.71,4.2,29,13,16,0.448,54,0.537,3,0.569,4.1,2018-19,Playoffs
202700,Donatas Motiejunas,1610612759,SAS,3,1,2,15.0,3,3,0,1.0,4,0.75,0,0.75,4.1,4,0,4,0.0,7,0.571,0,0.571,3.6,7,3,4,0.429,10,0.7,0,0.7,3.8,2018-19,Playoffs
1628378,Donovan Mitchell,1610612762,UTA,5,1,4,193.0,7,5,2,0.714,21,0.333,0,0.333,9.7,18,3,15,0.167,31,0.581,2,0.621,8.6,25,8,17,0.32,50,0.5,2,0.521,8.9,2018-19,Playoffs
203926,Doug McDermott,1610612754,IND,2,0,2,24.0,3,2,1,0.667,3,1.0,0,1.0,13.9,2,0,2,0.0,5,0.4,0,0.4,14.6,5,2,3,0.4,8,0.625,0,0.625,14.2,2018-19,Playoffs
203110,Draymond Green,1610612744,GSW,22,14,8,850.0,41,26,14,0.634,104,0.394,3,0.406,8.1,182,54,127,0.297,297,0.613,23,0.664,5.2,223,80,141,0.359,383,0.582,26,0.625,5.7,2018-19,Playoffs
202334,Ed Davis,1610612751,BKN,3,1,2,41.0,4,2,2,0.5,13,0.308,0,0.308,3.5,15,4,11,0.267,23,0.652,1,0.682,4.8,19,6,13,0.316,34,0.559,1,0.576,4.5,2018-19,Playoffs
1628410,Edmond Sumner,1610612754,IND,1,0,1,2.0,0,0,0,0.0,0,0.0,0,0.0,0.0,2,0,2,0.0,2,1.0,0,1.0,5.8,2,0,2,0.0,2,1.0,0,1.0,5.8,2018-19,Playoffs
202683,Enes Freedom,1610612757,POR,16,8,8,461.0,52,41,12,0.788,146,0.356,6,0.371,3.5,102,45,57,0.441,162,0.63,15,0.694,3.9,154,86,69,0.558,305,0.505,21,0.542,3.8,2018-19,Playoffs
202339,Eric Bledsoe,1610612749,MIL,15,10,5,423.0,20,5,15,0.25,58,0.345,4,0.37,10.9,36,5,31,0.139,68,0.529,4,0.563,8.9,56,10,46,0.179,123,0.455,8,0.487,9.6,2018-19,Playoffs
201569,Eric Gordon,1610612745,HOU,11,6,5,410.0,5,1,4,0.2,12,0.417,0,0.417,19.7,23,3,19,0.13,48,0.479,4,0.523,9.4,28,4,23,0.143,60,0.467,4,0.5,11.3,2018-19,Playoffs
203961,Eric Moreland,1610612761,TOR,8,6,2,28.0,2,0,1,0.0,3,0.667,0,0.667,17.0,12,3,9,0.25,19,0.632,1,0.667,3.5,14,3,10,0.214,20,0.7,1,0.737,4.5,2018-19,Playoffs
101141,Ersan Ilyasova,1610612749,MIL,14,10,4,261.0,20,10,9,0.5,50,0.4,0,0.4,6.4,51,7,44,0.137,83,0.614,10,0.699,4.8,71,17,53,0.239,129,0.55,10,0.597,5.2,2018-19,Playoffs
203095,Evan Fournier,1610612753,ORL,5,1,4,175.0,3,0,3,0.0,9,0.333,1,0.375,20.1,13,0,13,0.0,21,0.619,2,0.684,9.7,16,0,16,0.0,30,0.533,3,0.593,11.7,2018-19,Playoffs
202323,Evan Turner,1610612757,POR,16,8,8,245.0,13,10,3,0.769,32,0.406,1,0.419,6.7,59,16,44,0.271,92,0.641,8,0.702,4.9,72,26,47,0.361,120,0.6,9,0.649,5.2,2018-19,Playoffs
1627832,Fred VanVleet,1610612761,TOR,19,12,7,489.0,7,0,8,0.0,13,0.538,0,0.538,19.7,33,7,27,0.212,60,0.55,3,0.579,11.2,40,7,35,0.175,73,0.548,3,0.571,12.8,2018-19,Playoffs
1627788,Furkan Korkmaz,1610612755,PHI,3,2,1,26.0,0,0,0,0.0,1,0.0,0,0.0,0.0,6,3,3,0.5,9,0.667,0,0.667,3.9,6,3,3,0.5,10,0.6,0,0.6,3.9,2018-19,Playoffs
202066,Garrett Temple,1610612746,LAC,4,1,3,40.0,1,0,1,0.0,3,0.333,0,0.333,7.5,6,0,6,0.0,8,0.75,0,0.75,12.7,7,0,7,0.0,10,0.7,0,0.7,12.0,2018-19,Playoffs
1629109,Gary Clark,1610612745,HOU,1,1,0,3.0,0,0,0,0.0,0,0.0,0,0.0,0.0,1,0,1,0.0,1,1.0,0,1.0,3.5,1,0,1,0.0,1,1.0,0,1.0,3.5,2018-19,Playoffs
203914,Gary Harris,1610612743,DEN,14,7,7,517.0,9,3,6,0.333,38,0.237,2,0.25,9.3,49,7,42,0.143,80,0.613,4,0.645,12.0,58,10,48,0.172,112,0.518,6,0.547,11.5,2018-19,Playoffs
201588,George Hill,1610612749,MIL,15,10,5,394.0,15,8,7,0.533,40,0.375,3,0.405,7.6,38,2,36,0.053,62,0.613,4,0.655,7.7,53,10,43,0.189,102,0.52,7,0.558,7.7,2018-19,Playoffs
1627777,Georges Niang,1610612762,UTA,5,1,4,55.0,0,0,0,0.0,1,0.0,0,0.0,0.0,14,3,11,0.214,22,0.636,2,0.7,5.3,14,3,11,0.214,22,0.636,2,0.7,5.3,2018-19,Playoffs
101123,Gerald Green,1610612745,HOU,6,4,2,62.0,0,0,0,0.0,6,0.0,0,0.0,0.0,12,1,11,0.083,19,0.632,2,0.706,7.4,12,1,11,0.083,22,0.545,2,0.6,7.4,2018-19,Playoffs
203507,Giannis Antetokounmpo,1610612749,MIL,15,10,5,514.0,36,30,7,0.833,84,0.429,2,0.439,6.1,147,25,122,0.17,228,0.645,22,0.714,5.3,183,55,129,0.301,303,0.604,24,0.656,5.4,2018-19,Playoffs
203922,Glenn Robinson III,1610612765,DET,2,0,2,33.0,2,1,1,0.5,6,0.333,0,0.333,2.8,5,2,3,0.4,7,0.714,0,0.714,3.8,7,3,4,0.429,12,0.583,0,0.583,3.5,2018-19,Playoffs
202330,Gordon Hayward,1610612738,BOS,8,5,3,236.0,3,2,1,0.667,15,0.2,1,0.214,11.9,33,5,28,0.152,60,0.55,4,0.589,7.4,36,7,29,0.194,72,0.5,5,0.537,7.8,2018-19,Playoffs
1628960,Grayson Allen,1610612762,UTA,1,0,1,10.0,0,0,0,0.0,0,0.0,0,0.0,0.0,1,0,1,0.0,2,0.5,0,0.5,5.4,1,0,1,0.0,2,0.5,0,0.5,5.4,2018-19,Playoffs
202328,Greg Monroe,1610612755,PHI,8,5,3,87.0,14,12,2,0.857,27,0.519,1,0.538,5.6,17,3,14,0.176,26,0.654,0,0.654,3.9,31,15,16,0.484,53,0.585,1,0.596,4.6,2018-19,Playoffs
1627824,Guerschon Yabusele,1610612738,BOS,2,1,1,8.0,1,1,0,1.0,2,0.5,0,0.5,5.4,1,0,1,0.0,4,0.25,1,0.333,6.5,2,1,1,0.5,6,0.333,1,0.4,5.9,2018-19,Playoffs
202697,Iman Shumpert,1610612745,HOU,7,3,4,99.0,1,0,1,0.0,8,0.125,1,0.143,20.5,11,3,8,0.273,19,0.579,2,0.647,8.7,12,3,9,0.25,26,0.462,3,0.522,9.7,2018-19,Playoffs
1628392,Isaiah Hartenstein,1610612745,HOU,1,1,0,2.0,1,1,0,1.0,1,1.0,0,1.0,4.1,0,0,0,0.0,0,0.0,0,0.0,0.0,1,1,0,1.0,1,1.0,0,1.0,4.1,2018-19,Playoffs
202397,Ish Smith,1610612765,DET,4,0,4,81.0,1,0,1,0.0,5,0.2,0,0.2,7.8,10,0,10,0.0,21,0.476,2,0.526,9.2,11,0,11,0.0,24,0.458,2,0.5,9.0,2018-19,Playoffs
1627826,Ivica Zubac,1610612746,LAC,4,1,3,39.0,11,11,0,1.0,15,0.733,1,0.786,2.9,11,1,10,0.091,16,0.688,0,0.688,6.0,22,12,10,0.545,31,0.71,1,0.733,4.5,2018-19,Playoffs
200755,JJ Redick,1610612755,PHI,8,4,4,259.0,1,0,1,0.0,4,0.25,1,0.333,14.9,16,2,14,0.125,34,0.471,3,0.516,7.8,17,2,15,0.118,38,0.447,4,0.5,8.2,2018-19,Playoffs
203210,JaMychal Green,1610612746,LAC,6,2,4,141.0,6,3,3,0.5,22,0.273,0,0.273,7.5,26,2,24,0.077,44,0.591,3,0.634,5.9,32,5,27,0.156,62,0.516,3,0.542,6.2,2018-19,Playoffs
1628980,Jacob Evans,1610612744,GSW,1,1,0,3.0,0,0,0,0.0,0,0.0,0,0.0,0.0,1,0,1,0.0,1,1.0,0,1.0,15.0,1,0,1,0.0,1,1.0,0,1.0,15.0,2018-19,Playoffs
203109,Jae Crowder,1610612762,UTA,5,1,4,130.0,4,3,1,0.75,12,0.333,1,0.364,6.3,25,5,20,0.2,39,0.641,0,0.641,6.4,29,8,21,0.276,47,0.617,1,0.63,6.4,2018-19,Playoffs
1627774,Jake Layman,1610612757,POR,2,1,1,11.0,1,1,0,1.0,3,0.333,0,0.333,9.7,3,2,1,0.667,4,0.75,0,0.75,4.5,4,3,1,0.75,7,0.571,0,0.571,5.8,2018-19,Playoffs
1627751,Jakob Poeltl,1610612759,SAS,7,3,4,177.0,25,18,7,0.72,49,0.51,1,0.521,4.6,29,15,14,0.517,49,0.592,4,0.644,4.1,54,33,21,0.611,96,0.563,5,0.593,4.3,2018-19,Playoffs
1627750,Jamal Murray,1610612743,DEN,13,6,7,475.0,19,10,9,0.526,37,0.514,2,0.543,9.7,42,4,38,0.095,71,0.592,4,0.627,10.5,61,14,47,0.23,106,0.575,6,0.61,10.2,2018-19,Playoffs
203516,James Ennis III,1610612755,PHI,11,7,4,232.0,16,9,7,0.563,34,0.471,3,0.516,7.0,26,6,20,0.231,43,0.605,5,0.684,5.8,42,15,27,0.357,75,0.56,8,0.627,6.3,2018-19,Playoffs
201935,James Harden,1610612745,HOU,11,6,5,424.0,9,6,3,0.667,46,0.196,1,0.2,6.2,66,9,58,0.136,100,0.66,6,0.702,6.9,75,15,61,0.2,138,0.543,7,0.573,6.8,2018-19,Playoffs
201162,Jared Dudley,1610612751,BKN,2,0,2,35.0,0,0,0,0.0,0,0.0,0,0.0,0.0,2,0,2,0.0,7,0.286,1,0.333,5.0,2,0,2,0.0,7,0.286,1,0.333,5.0,2018-19,Playoffs
1626185,Jarell Martin,1610612753,ORL,2,0,2,12.0,1,0,1,0.0,1,1.0,0,1.0,2.4,1,1,0,1.0,3,0.333,0,0.333,11.2,2,1,1,0.5,4,0.5,0,0.5,6.8,2018-19,Playoffs
1629020,Jarred Vanderbilt,1610612743,DEN,1,0,1,2.0,0,0,0,0.0,0,0.0,0,0.0,0.0,1,0,1,0.0,1,1.0,0,1.0,20.8,1,0,1,0.0,1,1.0,0,1.0,20.8,2018-19,Playoffs
1628386,Jarrett Allen,1610612751,BKN,5,1,4,110.0,15,10,5,0.667,22,0.682,0,0.682,4.6,19,9,10,0.474,35,0.543,2,0.576,3.8,34,19,15,0.559,55,0.618,2,0.642,4.2,2018-19,Playoffs
1627759,Jaylen Brown,1610612738,BOS,9,5,4,274.0,6,4,2,0.667,16,0.375,0,0.375,10.2,46,10,36,0.217,76,0.605,6,0.657,5.6,52,14,38,0.269,90,0.578,6,0.619,6.1,2018-19,Playoffs
1628369,Jayson Tatum,1610612738,BOS,9,5,4,295.0,7,4,3,0.571,37,0.189,0,0.189,5.8,53,7,46,0.132,73,0.726,7,0.803,5.9,60,11,49,0.183,99,0.606,7,0.652,5.9,2018-19,Playoffs
203924,Jerami Grant,1610612760,OKC,5,1,4,176.0,6,4,2,0.667,18,0.333,0,0.333,6.5,21,9,13,0.429,51,0.412,8,0.488,6.2,27,13,15,0.481,68,0.397,8,0.45,6.2,2018-19,Playoffs
202391,Jeremy Lin,1610612761,TOR,2,2,0,6.0,0,0,0,0.0,1,0.0,0,0.0,0.0,3,0,3,0.0,3,1.0,0,1.0,7.5,3,0,3,0.0,4,0.75,0,0.75,7.5,2018-19,Playoffs
1626170,Jerian Grant,1610612753,ORL,1,0,1,5.0,0,0,0,0.0,0,0.0,0,0.0,0.0,4,0,4,0.0,4,1.0,0,1.0,8.6,4,0,4,0.0,4,1.0,0,1.0,8.6,2018-19,Playoffs
1629010,Jerome Robinson,1610612746,LAC,4,1,3,35.0,2,1,1,0.5,4,0.5,0,0.5,13.1,4,0,4,0.0,6,0.667,0,0.667,9.4,6,1,5,0.167,10,0.6,0,0.6,10.7,2018-19,Playoffs
202710,Jimmy Butler,1610612755,PHI,12,7,5,421.0,22,14,8,0.636,47,0.468,5,0.524,8.3,50,12,39,0.24,82,0.61,2,0.625,7.7,72,26,47,0.361,128,0.563,7,0.595,7.9,2018-19,Playoffs
201975,Jodie Meeks,1610612761,TOR,6,5,1,40.0,0,0,0,0.0,0,0.0,0,0.0,0.0,9,1,8,0.111,11,0.818,1,0.9,5.9,9,1,8,0.111,11,0.818,1,0.9,5.9,2018-19,Playoffs
203925,Joe Harris,1610612751,BKN,5,1,4,149.0,6,4,2,0.667,12,0.5,1,0.545,7.6,15,6,9,0.4,33,0.455,5,0.536,8.4,21,10,11,0.476,45,0.467,6,0.538,8.2,2018-19,Playoffs
204060,Joe Ingles,1610612762,UTA,5,1,4,151.0,3,0,3,0.0,5,0.6,0,0.6,14.9,21,2,19,0.095,30,0.7,1,0.724,8.5,24,2,22,0.083,34,0.706,1,0.727,9.3,2018-19,Playoffs
203954,Joel Embiid,1610612755,PHI,11,6,5,334.0,21,14,7,0.667,59,0.356,1,0.362,5.8,94,25,69,0.266,155,0.606,20,0.696,4.1,115,39,76,0.339,208,0.553,21,0.615,4.4,2018-19,Playoffs
1628413,Jonah Bolden,1610612755,PHI,7,5,2,62.0,4,0,4,0.0,8,0.5,0,0.5,8.4,10,1,9,0.1,17,0.588,3,0.714,5.2,14,1,13,0.071,21,0.667,3,0.778,6.1,2018-19,Playoffs
201973,Jonas Jerebko,1610612744,GSW,13,10,3,113.0,15,8,7,0.533,21,0.714,0,0.714,5.9,19,2,17,0.105,30,0.633,1,0.655,4.5,34,10,24,0.294,50,0.68,1,0.694,5.1,2018-19,Playoffs
1628371,Jonathan Isaac,1610612753,ORL,5,1,4,137.0,10,7,3,0.7,23,0.435,2,0.476,5.0,21,1,20,0.048,38,0.553,6,0.656,4.8,31,8,23,0.258,61,0.508,8,0.585,4.9,2018-19,Playoffs
203613,Jonathon Simmons,1610612755,PHI,5,3,2,45.0,2,2,0,1.0,6,0.333,1,0.4,3.6,7,2,5,0.286,8,0.875,0,0.875,5.8,9,4,5,0.444,14,0.643,1,0.692,5.3,2018-19,Playoffs
1628395,Jordan Bell,1610612744,GSW,9,7,2,84.0,7,5,2,0.714,18,0.389,1,0.412,5.0,12,4,8,0.333,27,0.444,0,0.444,6.9,19,9,10,0.474,43,0.442,1,0.452,6.2,2018-19,Playoffs
1627823,Juancho Hernangomez,1610612743,DEN,2,1,1,10.0,0,0,0,0.0,1,0.0,0,0.0,0.0,3,1,2,0.333,3,1.0,0,1.0,6.0,3,1,2,0.333,4,0.75,0,0.75,6.0,2018-19,Playoffs
202695,Kawhi Leonard,1610612761,TOR,24,16,8,939.0,54,32,23,0.593,128,0.422,7,0.446,7.5,164,39,125,0.238,255,0.643,20,0.698,6.3,218,71,148,0.326,358,0.609,27,0.659,6.6,2018-19,Playoffs
202702,Kenneth Faried,1610612745,HOU,6,4,2,56.0,3,3,0,1.0,11,0.273,0,0.273,6.1,18,9,9,0.5,27,0.667,1,0.692,3.4,21,12,9,0.571,37,0.568,1,0.583,3.8,2018-19,Playoffs
201142,Kevin Durant,1610612744,GSW,12,8,4,442.0,1,1,0,1.0,16,0.063,1,0.067,3.1,58,13,45,0.224,105,0.552,12,0.624,5.8,59,14,45,0.237,119,0.496,13,0.557,5.8,2018-19,Playoffs
1626172,Kevon Looney,1610612744,GSW,21,14,7,431.0,41,30,11,0.732,87,0.471,3,0.488,4.4,53,18,35,0.34,102,0.52,12,0.589,5.1,94,48,46,0.511,186,0.505,15,0.55,4.8,2018-19,Playoffs
203920,Khem Birch,1610612753,ORL,5,1,4,92.0,9,7,2,0.778,25,0.36,0,0.36,5.5,22,8,15,0.364,33,0.667,3,0.733,4.5,31,15,17,0.484,57,0.544,3,0.574,4.8,2018-19,Playoffs
203114,Khris Middleton,1610612749,MIL,15,10,5,515.0,9,3,6,0.333,29,0.31,0,0.31,16.5,86,9,76,0.105,123,0.699,7,0.741,7.3,95,12,82,0.126,147,0.646,7,0.679,8.2,2018-19,Playoffs
1629017,Khyri Thomas,1610612765,DET,2,0,2,13.0,0,0,0,0.0,0,0.0,0,0.0,0.0,2,1,1,0.5,3,0.667,0,0.667,12.2,2,1,1,0.5,3,0.667,0,0.667,12.2,2018-19,Playoffs
202691,Klay Thompson,1610612744,GSW,21,14,7,818.0,12,8,4,0.667,39,0.308,4,0.343,8.8,74,19,55,0.257,130,0.569,15,0.643,7.4,86,27,59,0.314,165,0.521,19,0.589,7.6,2018-19,Playoffs
2594,Kyle Korver,1610612762,UTA,3,0,3,28.0,1,0,1,0.0,1,1.0,0,1.0,12.0,4,1,3,0.25,6,0.667,1,0.8,12.0,5,1,4,0.2,6,0.833,1,1.0,12.0,2018-19,Playoffs
200768,Kyle Lowry,1610612761,TOR,24,16,8,900.0,21,8,13,0.381,67,0.313,2,0.323,17.0,96,24,72,0.25,194,0.495,13,0.53,8.1,117,32,85,0.274,260,0.45,15,0.478,9.7,2018-19,Playoffs
202681,Kyrie Irving,1610612738,BOS,9,5,4,330.0,5,1,4,0.2,16,0.313,0,0.313,7.9,34,5,30,0.147,62,0.548,6,0.607,8.7,39,6,34,0.154,78,0.5,6,0.542,8.6,2018-19,Playoffs
200746,LaMarcus Aldridge,1610612759,SAS,7,3,4,244.0,19,17,2,0.895,44,0.432,1,0.442,3.8,48,13,35,0.271,75,0.64,5,0.686,5.8,67,30,37,0.448,114,0.588,6,0.62,5.2,2018-19,Playoffs
1629013,Landry Shamet,1610612746,LAC,5,2,3,153.0,1,0,1,0.0,3,0.333,0,0.333,24.4,11,3,8,0.273,15,0.733,1,0.786,9.3,12,3,9,0.25,17,0.706,1,0.75,10.6,2018-19,Playoffs
204038,Langston Galloway,1610612765,DET,4,0,4,110.0,2,0,2,0.0,3,0.667,0,0.667,14.0,13,1,12,0.077,20,0.65,0,0.65,10.2,15,1,14,0.067,23,0.652,0,0.652,10.7,2018-19,Playoffs
1629022,Lonnie Walker IV,1610612759,SAS,2,0,2,13.0,0,0,0,0.0,0,0.0,0,0.0,0.0,2,1,1,0.5,2,1.0,0,1.0,8.2,2,1,1,0.5,2,1.0,0,1.0,8.2,2018-19,Playoffs
101150,Lou Williams,1610612746,LAC,6,2,4,176.0,6,4,2,0.667,17,0.353,0,0.353,10.9,11,1,10,0.091,20,0.55,0,0.55,9.8,17,5,12,0.294,37,0.459,0,0.459,10.2,2018-19,Playoffs
1628379,Luke Kennard,1610612765,DET,4,0,4,133.0,0,0,0,0.0,2,0.0,0,0.0,0.0,16,4,12,0.25,30,0.533,6,0.667,6.4,16,4,12,0.25,30,0.533,6,0.667,6.4,2018-19,Playoffs
1627763,Malcolm Brogdon,1610612749,MIL,7,3,4,198.0,6,4,2,0.667,15,0.4,1,0.429,9.4,28,6,22,0.214,43,0.651,4,0.718,10.3,34,10,24,0.294,57,0.596,5,0.654,10.1,2018-19,Playoffs
1626259,Malcolm Miller,1610612761,TOR,4,2,2,13.0,0,0,0,0.0,2,0.0,0,0.0,0.0,5,2,3,0.4,5,1.0,0,1.0,8.5,5,2,3,0.4,6,0.833,0,0.833,8.5,2018-19,Playoffs
1627736,Malik Beasley,1610612743,DEN,13,7,6,274.0,11,8,3,0.727,29,0.379,1,0.393,6.0,37,5,32,0.135,51,0.725,6,0.822,7.9,48,13,35,0.271,76,0.632,7,0.696,7.5,2018-19,Playoffs
201188,Marc Gasol,1610612761,TOR,24,16,8,735.0,16,10,6,0.625,50,0.32,1,0.327,6.9,138,37,100,0.268,207,0.667,11,0.704,5.2,154,47,106,0.305,249,0.618,12,0.65,5.4,2018-19,Playoffs
201158,Marco Belinelli,1610612759,SAS,6,3,3,116.0,0,0,0,0.0,3,0.0,0,0.0,0.0,13,2,11,0.154,19,0.684,0,0.684,8.0,13,2,11,0.154,22,0.591,0,0.591,8.0,2018-19,Playoffs
202694,Marcus Morris Sr.,1610612738,BOS,9,5,4,254.0,12,9,3,0.75,27,0.444,0,0.444,8.0,61,17,44,0.279,94,0.649,7,0.701,6.7,73,26,47,0.356,118,0.619,7,0.658,6.9,2018-19,Playoffs
203935,Marcus Smart,1610612738,BOS,2,0,2,32.0,4,3,1,0.75,6,0.667,0,0.667,9.3,0,0,0,0.0,2,0.0,2,0.0,0.0,4,3,1,0.75,8,0.5,2,0.667,9.3,2018-19,Playoffs
202693,Markieff Morris,1610612760,OKC,4,1,3,55.0,4,2,2,0.5,12,0.333,3,0.444,7.7,9,3,6,0.333,18,0.5,2,0.563,4.6,13,5,8,0.385,30,0.433,5,0.52,5.5,2018-19,Playoffs
203486,Mason Plumlee,1610612743,DEN,13,6,7,207.0,26,17,8,0.654,61,0.426,1,0.433,3.8,36,17,20,0.472,68,0.529,2,0.545,3.8,62,34,28,0.548,128,0.484,3,0.496,3.8,2018-19,Playoffs
203090,Maurice Harkless,1610612757,POR,15,8,7,366.0,29,16,13,0.552,71,0.408,4,0.433,7.0,49,14,35,0.286,77,0.636,6,0.69,6.2,78,30,48,0.385,139,0.561,10,0.605,6.5,2018-19,Playoffs
1628982,Melvin Frazier Jr.,1610612753,ORL,2,0,2,12.0,1,1,0,1.0,1,1.0,0,1.0,4.6,3,0,3,0.0,4,0.75,0,0.75,9.7,4,1,3,0.25,5,0.8,0,0.8,8.4,2018-19,Playoffs
203086,Meyers Leonard,1610612757,POR,9,3,6,158.0,6,4,2,0.667,13,0.462,0,0.462,9.6,34,9,25,0.265,42,0.81,2,0.85,5.3,40,13,27,0.325,54,0.741,2,0.769,6.0,2018-19,Playoffs
203487,Michael Carter-Williams,1610612753,ORL,4,1,3,74.0,2,1,1,0.5,9,0.222,1,0.25,12.6,18,1,17,0.056,23,0.783,0,0.783,6.2,20,2,18,0.1,31,0.645,1,0.667,6.8,2018-19,Playoffs
203118,Mike Scott,1610612755,PHI,9,5,4,179.0,4,1,3,0.25,13,0.308,0,0.308,9.8,30,8,22,0.267,48,0.625,6,0.714,6.2,34,9,25,0.265,60,0.567,6,0.63,6.6,2018-19,Playoffs
1628420,Monte Morris,1610612743,DEN,9,5,4,154.0,3,1,2,0.333,9,0.333,1,0.375,19.8,16,3,13,0.188,17,0.941,0,0.941,10.1,19,4,15,0.211,25,0.76,1,0.792,11.6,2018-19,Playoffs
1626149,Montrezl Harrell,1610612746,LAC,6,2,4,158.0,12,10,2,0.833,25,0.48,0,0.48,3.7,21,6,15,0.286,47,0.447,5,0.5,5.6,33,16,17,0.485,72,0.458,5,0.493,4.9,2018-19,Playoffs
1626167,Myles Turner,1610612754,IND,4,0,4,126.0,4,2,2,0.5,20,0.2,3,0.235,7.6,21,4,17,0.19,37,0.568,6,0.677,4.8,25,6,19,0.24,54,0.463,9,0.556,5.3,2018-19,Playoffs
2403,Nene,1610612745,HOU,6,3,3,49.0,9,7,2,0.778,13,0.692,0,0.692,7.0,5,1,4,0.2,14,0.357,1,0.385,4.3,14,8,6,0.571,27,0.519,1,0.538,6.1,2018-19,Playoffs
203457,Nerlens Noel,1610612760,OKC,5,1,4,60.0,11,5,6,0.455,22,0.5,0,0.5,5.3,8,3,5,0.375,25,0.32,3,0.364,5.6,19,8,11,0.421,46,0.413,3,0.442,5.4,2018-19,Playoffs
203999,Nikola Jokic,1610612743,DEN,14,7,7,556.0,54,47,6,0.87,104,0.519,2,0.529,4.1,128,50,78,0.391,242,0.529,26,0.593,4.6,182,97,84,0.533,337,0.54,28,0.589,4.4,2018-19,Playoffs
202703,Nikola Mirotic,1610612749,MIL,13,9,4,283.0,17,12,5,0.706,37,0.459,1,0.472,3.3,43,6,37,0.14,64,0.672,2,0.694,4.9,60,18,42,0.3,96,0.625,3,0.645,4.4,2018-19,Playoffs
202696,Nikola Vucevic,1610612753,ORL,5,1,4,147.0,9,7,2,0.778,20,0.45,0,0.45,5.4,31,6,25,0.194,42,0.738,1,0.756,5.0,40,13,27,0.325,62,0.645,1,0.656,5.0,2018-19,Playoffs
1626181,Norman Powell,1610612761,TOR,19,14,5,325.0,5,0,5,0.0,19,0.263,0,0.263,19.2,46,8,37,0.174,70,0.657,8,0.742,7.5,51,8,42,0.157,86,0.593,8,0.654,8.7,2018-19,Playoffs
200782,P.J. Tucker,1610612745,HOU,11,6,5,426.0,19,9,10,0.474,60,0.317,1,0.322,6.8,63,18,45,0.286,115,0.548,6,0.578,6.0,82,27,55,0.329,168,0.488,7,0.509,6.2,2018-19,Playoffs
1627783,Pascal Siakam,1610612761,TOR,24,16,8,891.0,40,18,20,0.45,105,0.381,1,0.385,9.0,131,33,98,0.252,201,0.652,10,0.686,6.5,171,51,118,0.298,296,0.578,11,0.6,7.1,2018-19,Playoffs
1626192,Pat Connaughton,1610612749,MIL,15,10,5,324.0,10,6,4,0.6,30,0.333,0,0.333,6.1,83,20,63,0.241,114,0.728,11,0.806,5.9,93,26,67,0.28,142,0.655,11,0.71,5.9,2018-19,Playoffs
201976,Patrick Beverley,1610612746,LAC,6,2,4,195.0,8,5,3,0.625,24,0.333,0,0.333,10.9,40,3,37,0.075,62,0.645,8,0.741,6.6,48,8,40,0.167,86,0.558,8,0.615,7.3,2018-19,Playoffs
1627775,Patrick McCaw,1610612761,TOR,2,2,0,13.0,2,0,2,0.0,3,0.667,0,0.667,15.1,1,0,1,0.0,1,1.0,0,1.0,2.4,3,0,3,0.0,3,1.0,0,1.0,10.9,2018-19,Playoffs
201988,Patty Mills,1610612759,SAS,7,3,4,152.0,1,0,1,0.0,3,0.333,0,0.333,22.8,14,1,12,0.071,21,0.667,1,0.7,12.7,15,1,13,0.067,24,0.625,1,0.652,13.4,2018-19,Playoffs
202331,Paul George,1610612760,OKC,5,1,4,204.0,6,3,3,0.5,18,0.333,0,0.333,14.1,37,12,25,0.324,63,0.587,8,0.673,8.2,43,15,28,0.349,79,0.544,8,0.606,9.0,2018-19,Playoffs
200794,Paul Millsap,1610612743,DEN,14,7,7,469.0,24,14,10,0.583,76,0.316,5,0.338,6.6,70,20,49,0.286,134,0.522,13,0.579,6.2,94,34,59,0.362,209,0.45,18,0.492,6.3,2018-19,Playoffs
202347,Quincy Pondexter,1610612759,SAS,1,0,1,4.0,0,0,0,0.0,0,0.0,0,0.0,0.0,1,0,1,0.0,1,1.0,0,1.0,3.4,1,0,1,0.0,1,1.0,0,1.0,3.4,2018-19,Playoffs
1626188,Quinn Cook,1610612744,GSW,14,10,4,183.0,2,0,2,0.0,7,0.286,1,0.333,20.1,16,2,14,0.125,29,0.552,2,0.593,7.4,18,2,16,0.111,35,0.514,3,0.563,8.8,2018-19,Playoffs
203526,Raul Neto,1610612762,UTA,2,0,2,15.0,0,0,0,0.0,0,0.0,0,0.0,0.0,3,0,3,0.0,3,1.0,0,1.0,7.1,3,0,3,0.0,3,1.0,0,1.0,7.1,2018-19,Playoffs
101109,Raymond Felton,1610612760,OKC,2,1,1,25.0,0,0,0,0.0,0,0.0,0,0.0,0.0,2,0,2,0.0,2,1.0,0,1.0,7.4,2,0,2,0.0,2,1.0,0,1.0,7.4,2018-19,Playoffs
202704,Reggie Jackson,1610612765,DET,4,0,4,108.0,5,1,4,0.2,13,0.385,1,0.417,10.6,8,1,7,0.125,17,0.471,0,0.471,7.1,13,2,11,0.154,29,0.448,1,0.464,8.4,2018-19,Playoffs
201937,Ricky Rubio,1610612762,UTA,5,1,4,168.0,3,1,2,0.333,11,0.273,0,0.273,14.1,13,2,11,0.154,24,0.542,1,0.565,10.1,16,3,13,0.188,35,0.457,1,0.471,10.8,2018-19,Playoffs
1629057,Robert Williams III,1610612738,BOS,2,1,1,10.0,1,1,0,1.0,2,0.5,0,0.5,3.2,6,1,5,0.167,6,1.0,0,1.0,10.2,7,2,5,0.286,8,0.875,0,0.875,9.2,2018-19,Playoffs
1629066,Rodions Kurucs,1610612751,BKN,4,1,3,68.0,6,2,4,0.333,11,0.545,0,0.545,4.3,14,1,13,0.071,21,0.667,1,0.7,5.3,20,3,17,0.15,32,0.625,1,0.645,5.0,2018-19,Playoffs
203918,Rodney Hood,1610612757,POR,14,7,7,330.0,9,2,7,0.222,20,0.45,2,0.5,18.4,27,4,23,0.148,52,0.519,1,0.529,10.3,36,6,30,0.167,69,0.522,3,0.545,12.4,2018-19,Playoffs
1626178,Rondae Hollis-Jefferson,1610612751,BKN,4,0,4,62.0,3,0,3,0.0,14,0.214,0,0.214,13.5,9,2,7,0.222,15,0.6,0,0.6,3.7,12,2,10,0.167,28,0.429,0,0.429,6.2,2018-19,Playoffs
1626220,Royce O'Neale,1610612762,UTA,5,1,4,137.0,2,1,1,0.5,6,0.333,0,0.333,6.4,21,3,18,0.143,40,0.525,6,0.618,9.0,23,4,19,0.174,45,0.511,6,0.59,8.8,2018-19,Playoffs
200752,Rudy Gay,1610612759,SAS,7,3,4,178.0,13,5,8,0.385,31,0.419,3,0.464,9.7,37,19,18,0.514,73,0.507,7,0.561,3.6,50,24,26,0.48,103,0.485,10,0.538,5.2,2018-19,Playoffs
203497,Rudy Gobert,1610612762,UTA,5,1,4,152.0,23,14,8,0.609,54,0.426,1,0.434,5.5,28,8,21,0.286,62,0.452,5,0.491,3.0,51,22,29,0.431,110,0.464,6,0.49,4.0,2018-19,Playoffs
201566,Russell Westbrook,1610612760,OKC,5,1,4,197.0,7,4,3,0.571,28,0.25,3,0.28,10.9,38,9,28,0.237,56,0.679,4,0.731,9.4,45,13,31,0.289,80,0.563,7,0.616,9.6,2018-19,Playoffs
1628400,Semi Ojeleye,1610612738,BOS,2,0,2,15.0,1,0,1,0.0,3,0.333,0,0.333,10.2,1,0,1,0.0,1,1.0,0,1.0,4.8,2,0,2,0.0,4,0.5,0,0.5,7.5,2018-19,Playoffs
201586,Serge Ibaka,1610612761,TOR,24,16,8,500.0,35,23,11,0.657,89,0.393,5,0.417,4.5,108,35,72,0.324,195,0.554,17,0.607,4.3,143,58,83,0.406,278,0.514,22,0.559,4.4,2018-19,Playoffs
203552,Seth Curry,1610612757,POR,11,3,8,235.0,5,2,3,0.4,14,0.357,1,0.385,21.7,20,2,18,0.1,29,0.69,3,0.769,13.4,25,4,21,0.16,42,0.595,4,0.658,15.1,2018-19,Playoffs
203894,Shabazz Napier,1610612751,BKN,2,0,2,26.0,2,2,0,1.0,4,0.5,0,0.5,4.6,5,1,4,0.2,6,0.833,0,0.833,5.8,7,3,4,0.429,10,0.7,0,0.7,5.5,2018-19,Playoffs
1628983,Shai Gilgeous-Alexander,1610612746,LAC,5,1,4,141.0,4,2,2,0.5,14,0.286,0,0.286,9.0,12,1,11,0.083,24,0.5,0,0.5,11.0,16,3,13,0.188,35,0.457,0,0.457,10.5,2018-19,Playoffs
2733,Shaun Livingston,1610612744,GSW,15,8,7,216.0,11,6,5,0.545,25,0.44,1,0.458,9.2,20,4,15,0.2,35,0.571,1,0.588,10.4,31,10,20,0.323,60,0.517,2,0.534,10.0,2018-19,Playoffs
1628414,Sindarius Thornwell,1610612746,LAC,2,0,2,10.0,0,0,0,0.0,3,0.0,1,0.0,0.0,4,1,3,0.25,5,0.8,0,0.8,6.9,4,1,3,0.25,7,0.571,1,0.667,6.9,2018-19,Playoffs
203915,Spencer Dinwiddie,1610612751,BKN,5,1,4,131.0,4,1,3,0.25,14,0.286,2,0.333,12.8,9,1,8,0.111,14,0.643,0,0.643,8.1,13,2,11,0.154,25,0.52,2,0.565,9.5,2018-19,Playoffs
201939,Stephen Curry,1610612744,GSW,22,14,8,846.0,17,9,8,0.529,54,0.315,4,0.34,10.1,115,20,94,0.174,207,0.556,23,0.625,8.1,132,29,102,0.22,259,0.51,27,0.569,8.4,2018-19,Playoffs
1628425,Sterling Brown,1610612749,MIL,8,7,1,151.0,4,3,1,0.75,11,0.364,1,0.4,7.4,26,4,22,0.154,38,0.684,7,0.839,8.3,30,7,23,0.233,49,0.612,8,0.732,8.2,2018-19,Playoffs
203500,Steven Adams,1610612760,OKC,5,1,4,159.0,12,6,6,0.5,30,0.4,0,0.4,9.1,24,10,14,0.417,50,0.48,5,0.533,3.6,36,16,20,0.444,79,0.456,5,0.486,5.4,2018-19,Playoffs
1628388,T.J. Leaf,1610612754,IND,1,0,1,10.0,1,1,0,1.0,2,0.5,0,0.5,3.1,2,1,1,0.5,3,0.667,1,1.0,4.5,3,2,1,0.667,5,0.6,1,0.75,4.0,2018-19,Playoffs
204456,T.J. McConnell,1610612755,PHI,3,3,0,32.0,1,0,1,0.0,2,0.5,0,0.5,14.5,5,0,5,0.0,9,0.556,0,0.556,7.9,6,0,6,0.0,10,0.6,0,0.6,9.0,2018-19,Playoffs
1628390,Terrance Ferguson,1610612760,OKC,5,1,4,128.0,2,1,1,0.5,7,0.286,1,0.333,12.2,10,3,7,0.3,18,0.556,0,0.556,13.6,12,4,8,0.333,25,0.48,1,0.5,13.3,2018-19,Playoffs
203082,Terrence Ross,1610612753,ORL,5,1,4,146.0,1,0,0,0.0,3,0.333,0,0.333,0.0,17,1,16,0.059,24,0.708,0,0.708,5.6,18,1,16,0.056,26,0.692,0,0.692,5.6,2018-19,Playoffs
1626179,Terry Rozier,1610612738,BOS,9,5,4,162.0,4,2,2,0.5,7,0.571,1,0.667,5.0,35,3,32,0.086,62,0.565,7,0.636,7.0,39,5,34,0.128,69,0.565,8,0.639,6.8,2018-19,Playoffs
200757,Thabo Sefolosha,1610612762,UTA,4,1,3,42.0,1,1,0,1.0,3,0.333,1,0.5,3.5,7,1,6,0.143,9,0.778,1,0.875,4.3,8,2,6,0.25,11,0.727,2,0.889,4.2,2018-19,Playoffs
201152,Thaddeus Young,1610612754,IND,4,0,4,130.0,9,5,4,0.556,17,0.529,1,0.563,4.7,19,7,12,0.368,36,0.528,3,0.576,5.1,28,12,16,0.429,52,0.538,4,0.583,5.0,2018-19,Playoffs
1629033,Theo Pinson,1610612751,BKN,2,0,2,19.0,0,0,0,0.0,0,0.0,0,0.0,0.0,3,1,2,0.333,3,1.0,0,1.0,3.4,3,1,2,0.333,3,1.0,0,1.0,3.4,2018-19,Playoffs
1627748,Thon Maker,1610612765,DET,3,0,3,58.0,4,3,1,0.75,11,0.364,1,0.4,6.2,5,2,3,0.4,10,0.5,1,0.556,3.4,9,5,4,0.556,20,0.45,2,0.5,4.7,2018-19,Playoffs
204025,Tim Frazier,1610612749,MIL,6,4,2,30.0,0,0,0,0.0,2,0.0,0,0.0,0.0,9,1,8,0.111,10,0.9,1,1.0,9.4,9,1,8,0.111,12,0.75,1,0.818,9.4,2018-19,Playoffs
202699,Tobias Harris,1610612755,PHI,12,7,5,443.0,12,2,10,0.167,35,0.343,3,0.375,18.5,98,20,77,0.204,151,0.649,10,0.695,5.5,110,22,87,0.2,182,0.604,13,0.651,6.9,2018-19,Playoffs
203503,Tony Snell,1610612749,MIL,2,1,1,6.0,1,0,1,0.0,1,1.0,0,1.0,5.2,1,0,1,0.0,3,0.333,0,0.333,3.3,2,0,2,0.0,3,0.667,0,0.667,4.2,2018-19,Playoffs
1628470,Torrey Craig,1610612743,DEN,13,6,7,324.0,21,17,4,0.81,56,0.375,0,0.375,5.5,51,5,46,0.098,73,0.699,6,0.761,7.2,72,22,50,0.306,119,0.605,6,0.637,6.7,2018-19,Playoffs
1626203,Treveon Graham,1610612751,BKN,5,1,4,79.0,2,1,2,0.5,6,0.333,0,0.333,12.5,8,3,5,0.375,19,0.421,3,0.5,4.2,10,4,7,0.4,24,0.417,3,0.476,6.5,2018-19,Playoffs
1626168,Trey Lyles,1610612743,DEN,1,0,1,2.0,1,1,0,1.0,1,1.0,0,1.0,3.7,0,0,0,0.0,0,0.0,0,0.0,0.0,1,1,0,1.0,1,1.0,0,1.0,3.7,2018-19,Playoffs
201936,Tyreke Evans,1610612754,IND,4,0,4,84.0,0,0,0,0.0,6,0.0,0,0.0,0.0,17,2,15,0.118,21,0.81,0,0.81,5.7,17,2,15,0.118,27,0.63,0,0.63,5.7,2018-19,Playoffs
1627820,Tyrone Wallace,1610612746,LAC,1,0,1,9.0,0,0,0,0.0,0,0.0,0,0.0,0.0,1,0,1,0.0,2,0.5,1,1.0,12.3,1,0,1,0.0,2,0.5,1,1.0,12.3,2018-19,Playoffs
201961,Wayne Ellington,1610612765,DET,4,0,4,131.0,3,0,3,0.0,6,0.5,0,0.5,16.2,12,4,8,0.333,23,0.522,5,0.667,6.2,15,4,11,0.267,29,0.517,5,0.625,8.2,2018-19,Playoffs
1628411,Wes Iwundu,1610612753,ORL,4,0,4,51.0,0,0,0,0.0,1,0.0,0,0.0,0.0,7,0,7,0.0,13,0.538,1,0.583,4.5,7,0,7,0.0,14,0.5,1,0.538,4.5,2018-19,Playoffs
202083,Wesley Matthews,1610612754,IND,4,0,4,119.0,0,0,0,0.0,1,0.0,0,0.0,0.0,10,2,8,0.2,18,0.556,1,0.588,8.1,10,2,8,0.2,19,0.526,1,0.556,8.1,2018-19,Playoffs
203115,Will Barton,1610612743,DEN,14,7,7,328.0,15,9,6,0.6,36,0.417,0,0.417,5.9,52,10,42,0.192,84,0.619,5,0.658,5.1,67,19,48,0.284,115,0.583,5,0.609,5.3,2018-19,Playoffs
201163,Wilson Chandler,1610612746,LAC,4,1,3,52.0,0,0,0,0.0,1,0.0,0,0.0,0.0,6,2,4,0.333,10,0.6,1,0.667,5.5,6,2,4,0.333,11,0.545,1,0.6,5.5,2018-19,Playoffs
1628380,Zach Collins,1610612757,POR,15,8,7,267.0,17,11,5,0.647,53,0.321,3,0.34,5.5,41,14,27,0.341,95,0.432,11,0.488,5.2,58,25,32,0.431,141,0.411,14,0.457,5.3,2018-19,Playoffs
2585,Zaza Pachulia,1610612765,DET,1,0,1,18.0,1,0,1,0.0,4,0.25,0,0.25,6.5,8,1,7,0.125,11,0.727,0,0.727,6.3,9,1,8,0.111,13,0.692,0,0.692,6.3,2018-19,Playoffs
203932,Aaron Gordon,1610612753,ORL,61,30,31,1988.0,107,72,34,0.673,199,0.538,2,0.543,6.1,368,83,284,0.226,526,0.7,40,0.757,5.9,475,155,318,0.326,701,0.678,42,0.721,5.9,2019-20,Regular%20Season
1628988,Aaron Holiday,1610612754,IND,57,39,18,1472.0,22,7,15,0.318,61,0.361,0,0.361,15.7,134,13,120,0.097,237,0.565,19,0.615,9.8,156,20,135,0.128,292,0.534,19,0.571,10.7,2019-20,Regular%20Season
1627846,Abdel Nader,1610612760,OKC,43,26,17,741.0,14,5,9,0.357,25,0.56,3,0.636,16.1,86,14,72,0.163,142,0.606,11,0.656,6.5,100,19,81,0.19,165,0.606,14,0.662,7.8,2019-20,Regular%20Season
1629690,Adam Mokoka,1610612741,CHI,6,2,4,79.0,7,5,2,0.714,11,0.636,0,0.636,4.0,3,2,1,0.667,7,0.429,2,0.6,3.3,10,7,3,0.7,16,0.625,2,0.714,3.8,2019-20,Regular%20Season
1629678,Admiral Schofield,1610612764,WAS,20,5,15,291.0,7,3,4,0.429,27,0.259,1,0.269,10.2,40,11,29,0.275,64,0.625,6,0.69,5.0,47,14,33,0.298,85,0.553,7,0.603,5.8,2019-20,Regular%20Season
201143,Al Horford,1610612755,PHI,67,39,28,2026.0,103,62,40,0.602,236,0.436,10,0.456,7.9,353,86,264,0.244,532,0.664,39,0.716,6.2,456,148,304,0.325,737,0.619,49,0.663,6.6,2019-20,Regular%20Season
202329,Al-Farouq Aminu,1610612753,ORL,17,6,11,379.0,24,16,8,0.667,55,0.436,4,0.471,4.8,63,12,51,0.19,103,0.612,5,0.643,6.4,87,28,59,0.322,152,0.572,9,0.608,5.9,2019-20,Regular%20Season
202692,Alec Burks,1610612755,PHI,64,20,44,1714.0,48,15,34,0.313,125,0.384,9,0.414,11.4,234,46,187,0.197,369,0.634,39,0.709,6.6,282,61,221,0.216,483,0.584,48,0.648,7.4,2019-20,Regular%20Season
1629346,Alen Smailagic,1610612744,GSW,11,1,10,116.0,10,6,4,0.6,24,0.417,1,0.435,6.8,17,5,12,0.294,29,0.586,2,0.63,3.2,27,11,16,0.407,52,0.519,3,0.551,4.6,2019-20,Regular%20Season
1627936,Alex Caruso,1610612747,LAL,47,36,11,909.0,17,7,9,0.412,51,0.333,4,0.362,10.4,106,22,83,0.208,173,0.613,16,0.675,9.4,123,29,92,0.236,217,0.567,20,0.624,9.5,2019-20,Regular%20Season
203458,Alex Len,1610612758,SAC,53,18,35,952.0,97,74,24,0.763,234,0.415,9,0.431,4.5,217,64,153,0.295,372,0.583,44,0.662,4.2,314,138,177,0.439,574,0.547,53,0.603,4.3,2019-20,Regular%20Season
1628035,Alfonzo McKinnie,1610612739,CLE,35,8,27,567.0,37,20,17,0.541,62,0.597,1,0.607,7.9,76,16,59,0.211,129,0.589,9,0.633,5.1,113,36,76,0.319,180,0.628,10,0.665,6.0,2019-20,Regular%20Season
1628993,Alize Johnson,1610612754,IND,13,7,6,110.0,16,10,6,0.625,33,0.485,0,0.485,5.7,32,9,24,0.281,52,0.615,4,0.667,4.1,48,19,30,0.396,82,0.585,4,0.615,4.6,2019-20,Regular%20Season
203459,Allen Crabbe,1610612750,MIN,35,4,31,625.0,11,2,8,0.182,24,0.458,1,0.478,12.8,66,2,64,0.03,116,0.569,8,0.611,7.6,77,4,72,0.052,132,0.583,9,0.626,8.3,2019-20,Regular%20Season
1629019,Allonzo Trier,1610612752,NYK,20,2,18,250.0,6,3,4,0.5,18,0.333,2,0.375,12.7,23,2,22,0.087,43,0.535,2,0.561,7.7,29,5,26,0.172,60,0.483,4,0.518,8.8,2019-20,Regular%20Season
1628518,Amile Jefferson,1610612753,ORL,11,4,7,59.0,10,9,1,0.9,13,0.769,0,0.769,3.1,13,6,7,0.462,21,0.619,2,0.684,4.1,23,15,8,0.652,34,0.676,2,0.719,3.7,2019-20,Regular%20Season
1629599,Amir Coffey,1610612746,LAC,8,5,3,131.0,4,3,1,0.75,9,0.444,0,0.444,3.9,12,1,11,0.083,14,0.857,0,0.857,9.3,16,4,12,0.25,22,0.727,0,0.727,8.0,2019-20,Regular%20Season
203083,Andre Drummond,1610612739,CLE,56,21,35,1844.0,248,184,64,0.742,489,0.507,7,0.515,4.5,601,187,410,0.311,841,0.715,58,0.768,3.9,849,371,474,0.437,1279,0.664,65,0.699,4.1,2019-20,Regular%20Season
2738,Andre Iguodala,1610612748,MIA,19,9,10,381.0,14,5,9,0.357,31,0.452,2,0.483,11.5,58,13,45,0.224,87,0.667,6,0.716,7.4,72,18,54,0.25,115,0.626,8,0.673,8.2,2019-20,Regular%20Season
203460,Andre Roberson,1610612760,OKC,7,3,4,87.0,7,5,2,0.714,13,0.538,1,0.583,7.9,20,7,13,0.35,28,0.714,2,0.769,5.4,27,12,15,0.444,40,0.675,3,0.73,6.1,2019-20,Regular%20Season
203952,Andrew Wiggins,1610612744,GSW,53,15,38,1828.0,66,45,20,0.682,169,0.391,1,0.393,7.5,208,42,167,0.202,355,0.586,32,0.644,6.6,274,87,187,0.318,517,0.53,33,0.566,6.8,2019-20,Regular%20Season
1629014,Anfernee Simons,1610612757,POR,57,23,34,1256.0,25,7,18,0.28,73,0.342,2,0.352,14.9,127,21,108,0.165,204,0.623,16,0.676,7.9,152,28,126,0.184,272,0.559,18,0.598,9.0,2019-20,Regular%20Season
1627790,Ante Zizic,1610612739,CLE,18,3,15,203.0,18,13,4,0.722,44,0.409,0,0.409,5.2,48,18,30,0.375,79,0.608,6,0.658,4.4,66,31,34,0.47,118,0.559,6,0.589,4.6,2019-20,Regular%20Season
203076,Anthony Davis,1610612747,LAL,62,46,16,2131.0,142,100,40,0.704,302,0.47,10,0.486,5.5,435,135,300,0.31,663,0.656,43,0.702,5.4,577,235,340,0.407,945,0.611,53,0.647,5.4,2019-20,Regular%20Season
201229,Anthony Tolliver,1610612763,MEM,49,21,28,831.0,34,19,15,0.559,89,0.382,3,0.395,6.6,120,27,91,0.225,217,0.553,22,0.615,5.9,154,46,106,0.299,293,0.526,25,0.575,6.0,2019-20,Regular%20Season
1628499,Antonius Cleveland,1610612742,DAL,5,3,2,30.0,2,1,1,0.5,6,0.333,0,0.333,10.8,5,0,5,0.0,9,0.556,3,0.833,5.0,7,1,6,0.143,14,0.5,3,0.636,6.7,2019-20,Regular%20Season
1628394,Anzejs Pasecniks,1610612764,WAS,21,7,14,413.0,42,27,15,0.643,104,0.404,1,0.408,5.0,65,23,42,0.354,108,0.602,5,0.631,4.7,107,50,57,0.467,201,0.532,6,0.549,4.8,2019-20,Regular%20Season
203382,Aron Baynes,1610612756,PHX,40,18,22,901.0,68,41,26,0.603,162,0.42,5,0.433,6.0,161,47,116,0.292,303,0.531,35,0.601,5.1,229,88,142,0.384,451,0.508,40,0.557,5.4,2019-20,Regular%20Season
203085,Austin Rivers,1610612745,HOU,62,37,25,1511.0,27,9,18,0.333,72,0.375,3,0.391,14.1,148,30,118,0.203,272,0.544,30,0.612,8.2,175,39,136,0.223,343,0.51,33,0.565,9.1,2019-20,Regular%20Season
202340,Avery Bradley,1610612747,LAL,43,30,13,1065.0,18,10,8,0.556,48,0.375,2,0.391,10.4,96,12,84,0.125,175,0.549,19,0.615,7.4,114,22,92,0.193,220,0.518,21,0.573,7.9,2019-20,Regular%20Season
1629168,BJ Johnson,1610612753,ORL,5,2,3,68.0,3,2,1,0.667,4,0.75,0,0.75,5.6,12,3,9,0.25,17,0.706,1,0.75,7.5,15,5,10,0.333,21,0.714,1,0.75,7.1,2019-20,Regular%20Season
1628389,Bam Adebayo,1610612748,MIA,71,44,27,2382.0,171,96,74,0.561,401,0.426,9,0.436,7.4,552,140,411,0.254,788,0.701,62,0.76,5.4,723,236,485,0.326,1136,0.636,71,0.679,5.9,2019-20,Regular%20Season
203463,Ben McLemore,1610612745,HOU,58,37,21,1399.0,21,5,16,0.238,75,0.28,5,0.3,15.5,136,24,111,0.176,267,0.509,27,0.567,7.0,157,29,127,0.185,339,0.463,32,0.511,8.1,2019-20,Regular%20Season
1627732,Ben Simmons,1610612755,PHI,57,35,22,2017.0,113,59,54,0.522,264,0.428,3,0.433,8.5,331,42,289,0.127,458,0.723,28,0.77,7.4,444,101,343,0.227,679,0.654,31,0.685,7.7,2019-20,Regular%20Season
202687,Bismack Biyombo,1610612766,CHA,50,17,33,1004.0,118,89,29,0.754,268,0.44,3,0.445,5.1,186,66,119,0.355,347,0.536,50,0.626,4.5,304,155,148,0.51,598,0.508,53,0.558,4.7,2019-20,Regular%20Season
201933,Blake Griffin,1610612765,DET,17,8,9,483.0,17,10,7,0.588,42,0.405,2,0.425,6.4,64,21,43,0.328,107,0.598,12,0.674,6.4,81,31,50,0.383,145,0.559,14,0.618,6.4,2019-20,Regular%20Season
1626246,Boban Marjanovic,1610612742,DAL,37,18,19,407.0,66,58,7,0.879,124,0.532,4,0.55,3.6,131,40,90,0.305,182,0.72,17,0.794,3.9,197,98,97,0.497,295,0.668,21,0.719,3.8,2019-20,Regular%20Season
1626171,Bobby Portis,1610612752,NYK,66,21,45,1393.0,80,47,32,0.588,228,0.351,11,0.369,6.6,258,58,199,0.225,380,0.679,34,0.746,5.2,338,105,231,0.311,564,0.599,45,0.651,5.5,2019-20,Regular%20Season
203992,Bogdan Bogdanovic,1610612758,SAC,58,28,30,1678.0,26,17,10,0.654,75,0.347,1,0.351,10.4,177,38,139,0.215,317,0.558,39,0.637,7.1,203,55,149,0.271,382,0.531,40,0.594,7.6,2019-20,Regular%20Season
202711,Bojan Bogdanovic,1610612762,UTA,62,40,22,2050.0,39,22,16,0.564,129,0.302,0,0.302,11.1,220,27,193,0.123,344,0.64,23,0.685,7.7,259,49,209,0.189,454,0.57,23,0.601,8.2,2019-20,Regular%20Season
1629626,Bol Bol,1610612743,DEN,5,0,5,83.0,5,5,0,1.0,8,0.625,0,0.625,3.8,14,4,10,0.286,21,0.667,2,0.737,3.4,19,9,10,0.474,29,0.655,2,0.704,3.5,2019-20,Regular%20Season
202954,Brad Wanamaker,1610612738,BOS,61,43,18,1247.0,22,7,15,0.318,65,0.338,5,0.367,13.8,122,14,108,0.115,201,0.607,23,0.685,8.4,144,21,123,0.146,265,0.543,28,0.608,9.2,2019-20,Regular%20Season
203078,Bradley Beal,1610612764,WAS,56,20,36,2025.0,52,21,32,0.404,128,0.406,2,0.413,11.3,190,40,152,0.211,320,0.594,22,0.638,8.6,242,61,184,0.252,440,0.55,24,0.582,9.2,2019-20,Regular%20Season
1629634,Brandon Clarke,1610612763,MEM,58,29,29,1300.0,92,61,30,0.663,201,0.458,4,0.467,5.5,253,66,187,0.261,431,0.587,40,0.647,5.6,345,127,217,0.368,610,0.566,44,0.61,5.6,2019-20,Regular%20Season
1629164,Brandon Goodwin,1610612737,ATL,25,9,16,364.0,11,8,3,0.727,39,0.282,0,0.282,9.6,61,8,53,0.131,107,0.57,12,0.642,7.9,72,16,56,0.222,143,0.503,12,0.55,8.2,2019-20,Regular%20Season
1627742,Brandon Ingram,1610612740,NOP,61,25,36,2062.0,50,29,22,0.58,151,0.331,7,0.347,8.6,325,79,244,0.243,510,0.637,42,0.694,5.6,375,108,266,0.288,627,0.598,49,0.649,6.0,2019-20,Regular%20Season
202688,Brandon Knight,1610612765,DET,19,3,16,417.0,4,0,4,0.0,13,0.308,1,0.333,14.9,37,5,32,0.135,66,0.561,8,0.638,7.5,41,5,36,0.122,78,0.526,9,0.594,8.2,2019-20,Regular%20Season
1628968,Brian Bowen II,1610612754,IND,3,2,1,24.0,1,0,1,0.0,2,0.5,0,0.5,0.6,6,1,5,0.167,7,0.857,0,0.857,3.5,7,1,6,0.143,9,0.778,0,0.778,3.1,2019-20,Regular%20Season
201572,Brook Lopez,1610612749,MIL,64,50,14,1711.0,58,30,28,0.517,124,0.468,4,0.483,8.9,251,93,156,0.371,466,0.539,59,0.617,5.8,309,123,184,0.398,572,0.54,63,0.607,6.4,2019-20,Regular%20Season
1628971,Bruce Brown,1610612765,DET,56,18,38,1598.0,59,29,30,0.492,156,0.378,8,0.399,6.7,213,43,172,0.202,371,0.574,38,0.64,6.7,272,72,202,0.265,519,0.524,46,0.575,6.7,2019-20,Regular%20Season
203998,Bruno Caboclo,1610612745,HOU,21,8,13,208.0,23,16,7,0.696,47,0.489,1,0.5,5.9,37,8,29,0.216,69,0.536,11,0.638,4.5,60,24,36,0.4,112,0.536,12,0.6,5.1,2019-20,Regular%20Season
1628981,Bruno Fernando,1610612737,ATL,52,17,35,696.0,67,48,19,0.716,179,0.374,8,0.392,4.2,131,38,93,0.29,226,0.58,19,0.633,4.5,198,86,112,0.434,392,0.505,27,0.542,4.4,2019-20,Regular%20Season
1627854,Bryn Forbes,1610612759,SAS,54,24,30,1382.0,11,1,10,0.091,32,0.344,0,0.344,19.7,112,13,99,0.116,203,0.552,21,0.615,10.8,123,14,109,0.114,232,0.53,21,0.583,11.6,2019-20,Regular%20Season
1627741,Buddy Hield,1610612758,SAC,71,31,40,2192.0,56,22,35,0.393,158,0.354,7,0.371,11.2,267,37,230,0.139,446,0.599,43,0.663,7.6,323,59,265,0.183,597,0.541,50,0.59,8.2,2019-20,Regular%20Season
203468,CJ McCollum,1610612757,POR,69,33,36,2518.0,46,22,24,0.478,135,0.341,2,0.346,10.2,247,34,214,0.138,387,0.638,27,0.686,9.1,293,56,238,0.191,506,0.579,29,0.614,9.2,2019-20,Regular%20Season
101139,CJ Miles,1610612764,WAS,6,1,5,98.0,4,3,1,0.75,8,0.5,0,0.5,8.5,8,1,7,0.125,16,0.5,1,0.533,6.1,12,4,8,0.333,24,0.5,1,0.522,6.9,2019-20,Regular%20Season
1628997,Caleb Martin,1610612766,CHA,13,5,8,234.0,10,9,1,0.9,17,0.588,0,0.588,8.9,27,4,23,0.148,46,0.587,6,0.675,7.0,37,13,24,0.351,63,0.587,6,0.649,7.5,2019-20,Regular%20Season
1628403,Caleb Swanigan,1610612757,POR,23,10,13,270.0,27,20,7,0.741,71,0.38,2,0.391,4.4,71,28,43,0.394,122,0.582,11,0.64,4.3,98,48,50,0.49,183,0.536,13,0.576,4.4,2019-20,Regular%20Season
1629629,Cam Reddish,1610612737,ATL,55,16,39,1491.0,35,12,24,0.343,93,0.376,2,0.385,13.6,181,28,152,0.155,267,0.678,16,0.721,8.1,216,40,176,0.185,354,0.61,18,0.643,9.0,2019-20,Regular%20Season
1629661,Cameron Johnson,1610612756,PHX,51,26,25,1130.0,49,23,25,0.469,89,0.551,3,0.57,9.8,134,25,110,0.187,227,0.59,21,0.65,7.3,183,48,135,0.262,309,0.592,24,0.642,8.0,2019-20,Regular%20Season
1626166,Cameron Payne,1610612756,PHX,8,8,0,183.0,4,3,1,0.75,9,0.444,1,0.5,12.2,27,1,26,0.037,42,0.643,4,0.711,8.1,31,4,27,0.129,49,0.633,5,0.705,8.7,2019-20,Regular%20Season
1627747,Caris LeVert,1610612751,BKN,42,19,23,1271.0,49,24,25,0.49,131,0.374,10,0.405,8.3,140,25,114,0.179,247,0.567,29,0.642,6.9,189,49,139,0.259,374,0.505,39,0.564,7.3,2019-20,Regular%20Season
2546,Carmelo Anthony,1610612757,POR,57,27,30,1869.0,71,49,22,0.69,162,0.438,2,0.444,7.2,291,64,227,0.22,434,0.671,31,0.722,5.9,362,113,249,0.312,575,0.63,33,0.668,6.2,2019-20,Regular%20Season
1629035,Carsen Edwards,1610612738,BOS,25,16,9,278.0,6,2,4,0.333,16,0.375,1,0.4,10.6,41,6,35,0.146,55,0.745,3,0.788,6.9,47,8,39,0.17,70,0.671,4,0.712,7.4,2019-20,Regular%20Season
1626224,Cedi Osman,1610612739,CLE,61,19,42,1811.0,39,19,20,0.487,101,0.386,3,0.398,11.0,192,28,165,0.146,286,0.671,26,0.738,6.9,231,47,185,0.203,373,0.619,29,0.672,7.6,2019-20,Regular%20Season
1628990,Chandler Hutchison,1610612741,CHI,25,7,18,507.0,18,9,9,0.5,57,0.316,3,0.333,9.7,90,16,72,0.178,119,0.756,7,0.804,5.4,108,25,81,0.231,163,0.663,10,0.706,6.2,2019-20,Regular%20Season
202718,Chandler Parsons,1610612737,ATL,4,0,4,52.0,1,1,0,1.0,4,0.25,0,0.25,4.6,6,0,6,0.0,9,0.667,1,0.75,6.1,7,1,6,0.143,11,0.636,1,0.7,5.9,2019-20,Regular%20Season
1629718,Charlie Brown Jr.,1610612737,ATL,4,0,4,26.0,2,0,2,0.0,3,0.667,1,1.0,1.3,2,0,2,0.0,6,0.333,0,0.333,9.7,4,0,4,0.0,8,0.5,1,0.571,5.5,2019-20,Regular%20Season
1626184,Chasson Randle,1610612744,GSW,2,2,0,26.0,0,0,0,0.0,0,0.0,0,0.0,0.0,2,0,2,0.0,2,1.0,0,1.0,7.2,2,0,2,0.0,2,1.0,0,1.0,7.2,2019-20,Regular%20Season
1627767,Cheick Diallo,1610612756,PHX,37,17,20,456.0,30,20,11,0.667,90,0.333,2,0.341,5.9,101,33,66,0.327,161,0.627,13,0.682,4.1,131,53,77,0.405,242,0.541,15,0.577,4.5,2019-20,Regular%20Season
1629002,Chimezie Metu,1610612759,SAS,13,5,8,92.0,12,8,3,0.667,23,0.522,2,0.571,5.6,21,7,14,0.333,30,0.7,2,0.75,4.2,33,15,17,0.455,49,0.673,4,0.733,4.7,2019-20,Regular%20Season
1628449,Chris Boucher,1610612761,TOR,55,40,15,787.0,107,77,30,0.72,223,0.48,10,0.502,4.9,170,49,121,0.288,292,0.582,28,0.644,3.9,277,126,151,0.455,495,0.56,38,0.606,4.3,2019-20,Regular%20Season
1629185,Chris Chiozza,1610612751,BKN,24,13,11,387.0,9,2,7,0.222,23,0.391,2,0.429,14.4,44,4,40,0.091,81,0.543,7,0.595,10.2,53,6,47,0.113,103,0.515,9,0.564,10.9,2019-20,Regular%20Season
1629598,Chris Clemons,1610612745,HOU,16,6,10,201.0,4,1,3,0.25,7,0.571,0,0.571,16.0,26,4,22,0.154,46,0.565,2,0.591,6.4,30,5,25,0.167,53,0.566,2,0.588,7.7,2019-20,Regular%20Season
101108,Chris Paul,1610612760,OKC,70,44,26,2208.0,26,7,19,0.269,71,0.366,2,0.377,11.7,323,40,286,0.124,510,0.633,43,0.692,7.9,349,47,305,0.135,574,0.608,45,0.66,8.2,2019-20,Regular%20Season
1629735,Chris Silva,1610612748,MIA,31,19,12,317.0,58,40,18,0.69,130,0.446,4,0.46,4.8,63,16,47,0.254,137,0.46,23,0.553,4.2,121,56,65,0.463,257,0.471,27,0.526,4.5,2019-20,Regular%20Season
1626174,Christian Wood,1610612765,DET,58,18,40,1296.0,103,71,31,0.689,217,0.475,9,0.495,5.2,279,77,202,0.276,462,0.604,55,0.686,4.9,382,148,233,0.387,650,0.588,64,0.652,5.0,2019-20,Regular%20Season
203991,Clint Capela,1610612737,ATL,39,22,17,1279.0,168,128,41,0.762,346,0.486,8,0.497,5.7,369,123,246,0.333,550,0.671,36,0.718,4.9,537,251,287,0.467,875,0.614,44,0.646,5.2,2019-20,Regular%20Season
1629632,Coby White,1610612741,CHI,63,22,41,1623.0,28,9,19,0.321,95,0.295,4,0.308,15.3,202,29,174,0.144,317,0.637,24,0.689,7.0,230,38,193,0.165,405,0.568,28,0.61,8.0,2019-20,Regular%20Season
1628998,Cody Martin,1610612766,CHA,38,12,26,854.0,38,14,24,0.368,80,0.475,3,0.494,10.0,120,25,95,0.208,178,0.674,9,0.71,7.2,158,39,119,0.247,254,0.622,12,0.653,7.8,2019-20,Regular%20Season
203469,Cody Zeller,1610612766,CHA,57,18,39,1320.0,160,119,41,0.744,386,0.415,11,0.427,4.8,249,76,173,0.305,441,0.565,47,0.632,4.5,409,195,214,0.477,809,0.506,58,0.545,4.6,2019-20,Regular%20Season
1629012,Collin Sexton,1610612739,CLE,64,19,45,2118.0,61,25,35,0.41,191,0.319,13,0.343,10.7,143,17,126,0.119,233,0.614,21,0.675,10.7,204,42,161,0.206,423,0.482,34,0.524,10.7,2019-20,Regular%20Season
201147,Corey Brewer,1610612758,SAC,3,0,3,30.0,2,0,2,0.0,4,0.5,0,0.5,12.8,6,1,5,0.167,7,0.857,0,0.857,8.8,8,1,7,0.125,11,0.727,0,0.727,9.8,2019-20,Regular%20Season
202709,Cory Joseph,1610612758,SAC,62,24,38,1569.0,44,16,28,0.364,99,0.444,4,0.463,12.6,141,19,122,0.135,265,0.532,27,0.592,8.7,185,35,150,0.189,360,0.514,31,0.562,9.6,2019-20,Regular%20Season
201584,Courtney Lee,1610612742,DAL,14,8,6,228.0,6,1,5,0.167,12,0.5,0,0.5,17.8,25,2,23,0.08,34,0.735,4,0.833,9.2,31,3,28,0.097,46,0.674,4,0.738,10.8,2019-20,Regular%20Season
1626245,Cristiano Felicio,1610612741,CHI,19,5,14,367.0,55,37,17,0.673,100,0.55,5,0.579,5.6,47,14,34,0.298,93,0.505,8,0.553,5.1,102,51,51,0.5,189,0.54,13,0.58,5.4,2019-20,Regular%20Season
1626156,D'Angelo Russell,1610612750,MIN,42,11,31,1360.0,17,7,8,0.412,54,0.315,6,0.354,10.9,160,17,143,0.106,244,0.656,23,0.724,7.9,177,24,151,0.136,296,0.598,29,0.663,8.1,2019-20,Regular%20Season
201571,D.J. Augustin,1610612753,ORL,49,27,22,1235.0,22,8,14,0.364,66,0.333,2,0.344,14.7,100,12,90,0.12,168,0.595,16,0.658,10.9,122,20,104,0.164,232,0.526,18,0.57,11.7,2019-20,Regular%20Season
1628391,D.J. Wilson,1610612749,MIL,27,22,5,337.0,12,6,6,0.5,32,0.375,1,0.387,8.3,80,17,63,0.213,116,0.69,8,0.741,5.0,92,23,69,0.25,143,0.643,9,0.687,5.4,2019-20,Regular%20Season
1629610,DaQuan Jeffries,1610612758,SAC,8,3,5,131.0,3,1,2,0.333,3,1.0,0,1.0,10.7,15,6,9,0.4,26,0.577,5,0.714,8.7,18,7,11,0.389,29,0.621,5,0.75,9.0,2019-20,Regular%20Season
1627745,Damian Jones,1610612737,ATL,51,13,38,865.0,74,54,20,0.73,202,0.366,2,0.37,5.2,132,38,94,0.288,258,0.512,30,0.579,5.0,206,92,114,0.447,439,0.469,32,0.506,5.0,2019-20,Regular%20Season
203081,Damian Lillard,1610612757,POR,64,32,32,2400.0,32,13,18,0.406,131,0.244,7,0.258,9.5,248,39,209,0.157,418,0.593,42,0.66,8.8,280,52,227,0.186,546,0.513,49,0.563,8.8,2019-20,Regular%20Season
1627814,Damion Lee,1610612744,GSW,48,12,36,1401.0,32,9,23,0.281,79,0.405,3,0.421,11.5,207,36,171,0.174,332,0.623,32,0.69,7.3,239,45,194,0.188,407,0.587,35,0.642,7.8,2019-20,Regular%20Season
1628422,Damyean Dotson,1610612752,NYK,36,14,22,684.0,10,0,10,0.0,17,0.588,1,0.625,17.3,81,9,72,0.111,125,0.648,7,0.686,6.1,91,9,82,0.099,140,0.65,8,0.689,7.3,2019-20,Regular%20Season
1629655,Daniel Gafford,1610612741,CHI,34,11,23,550.0,52,37,15,0.712,138,0.377,4,0.388,3.9,54,18,34,0.333,150,0.36,29,0.446,4.0,106,55,49,0.519,287,0.369,33,0.417,3.9,2019-20,Regular%20Season
1628464,Daniel Theis,1610612738,BOS,65,42,23,1566.0,140,87,53,0.621,303,0.462,3,0.467,5.5,286,76,208,0.266,552,0.518,81,0.607,4.8,426,163,261,0.383,839,0.508,84,0.564,5.1,2019-20,Regular%20Season
201568,Danilo Gallinari,1610612760,OKC,62,37,25,1834.0,34,18,16,0.529,94,0.362,5,0.382,10.8,288,47,239,0.163,441,0.653,42,0.722,5.8,322,65,255,0.202,532,0.605,47,0.664,6.3,2019-20,Regular%20Season
201980,Danny Green,1610612747,LAL,65,48,17,1628.0,51,20,31,0.392,134,0.381,5,0.395,10.7,174,36,138,0.207,301,0.578,43,0.674,6.3,225,56,169,0.249,424,0.531,48,0.598,7.3,2019-20,Regular%20Season
203957,Dante Exum,1610612739,CLE,26,7,19,401.0,12,3,10,0.25,29,0.414,1,0.429,12.4,55,6,50,0.109,80,0.688,6,0.743,7.5,67,9,60,0.134,105,0.638,7,0.684,8.4,2019-20,Regular%20Season
1627863,Danuel House Jr.,1610612745,HOU,62,40,22,1883.0,57,16,39,0.281,128,0.445,2,0.452,12.6,210,39,171,0.186,355,0.592,35,0.656,6.9,267,55,210,0.206,475,0.562,37,0.61,8.0,2019-20,Regular%20Season
203967,Dario Saric,1610612756,PHX,65,32,33,1594.0,99,61,38,0.616,257,0.385,10,0.401,6.7,290,79,212,0.272,492,0.589,49,0.655,4.3,389,140,250,0.36,722,0.539,59,0.587,4.9,2019-20,Regular%20Season
1629647,Darius Bazley,1610612760,OKC,58,36,22,1103.0,30,16,14,0.533,75,0.4,1,0.405,8.1,216,60,155,0.278,324,0.667,27,0.727,5.3,246,76,169,0.309,386,0.637,28,0.687,5.7,2019-20,Regular%20Season
1629636,Darius Garland,1610612739,CLE,48,13,35,1487.0,27,7,19,0.259,70,0.386,2,0.397,15.6,84,11,73,0.131,148,0.568,11,0.613,10.0,111,18,92,0.162,217,0.512,13,0.544,11.3,2019-20,Regular%20Season
1628021,David Nwaba,1610612745,HOU,18,7,11,259.0,8,4,4,0.5,24,0.333,1,0.348,5.1,37,9,28,0.243,53,0.698,5,0.771,6.1,45,13,32,0.289,76,0.592,6,0.643,5.9,2019-20,Regular%20Season
202722,Davis Bertans,1610612764,WAS,54,20,34,1583.0,35,13,22,0.371,91,0.385,3,0.398,9.1,210,53,156,0.252,309,0.68,30,0.753,6.4,245,66,178,0.269,377,0.65,33,0.712,6.8,2019-20,Regular%20Season
1628368,De'Aaron Fox,1610612758,SAC,50,20,30,1604.0,34,14,19,0.412,91,0.374,1,0.378,10.7,158,24,133,0.152,245,0.645,16,0.69,9.1,192,38,152,0.198,331,0.58,17,0.611,9.4,2019-20,Regular%20Season
1629631,De'Andre Hunter,1610612737,ATL,62,19,43,1995.0,44,22,22,0.5,127,0.346,2,0.352,9.9,242,64,178,0.264,408,0.593,32,0.644,6.5,286,86,200,0.301,520,0.55,34,0.588,7.0,2019-20,Regular%20Season
1629001,De'Anthony Melton,1610612763,MEM,54,26,28,1119.0,43,24,18,0.558,117,0.368,4,0.381,7.2,177,30,147,0.169,274,0.646,23,0.705,6.5,220,54,165,0.245,376,0.585,27,0.63,6.6,2019-20,Regular%20Season
201599,DeAndre Jordan,1610612751,BKN,56,27,29,1234.0,141,97,42,0.688,304,0.464,7,0.475,4.9,420,107,313,0.255,550,0.764,25,0.8,4.6,561,204,355,0.364,814,0.689,32,0.717,4.7,2019-20,Regular%20Season
1627761,DeAndre' Bembry,1610612737,ATL,41,10,31,906.0,34,17,17,0.5,84,0.405,3,0.42,10.6,118,26,92,0.22,203,0.581,24,0.659,6.7,152,43,109,0.283,285,0.533,27,0.589,7.6,2019-20,Regular%20Season
201942,DeMar DeRozan,1610612759,SAS,67,30,37,2282.0,42,17,25,0.405,150,0.28,10,0.3,9.6,327,42,287,0.128,474,0.69,24,0.727,7.7,369,59,312,0.16,591,0.624,34,0.662,7.9,2019-20,Regular%20Season
201960,DeMarre Carroll,1610612745,HOU,22,9,13,280.0,12,7,4,0.583,27,0.444,0,0.444,6.4,43,8,35,0.186,71,0.606,9,0.694,6.6,55,15,39,0.273,95,0.579,9,0.64,6.5,2019-20,Regular%20Season
1629731,Dean Wade,1610612739,CLE,8,0,8,55.0,3,2,1,0.667,10,0.3,0,0.3,3.8,16,4,12,0.25,24,0.667,1,0.696,4.3,19,6,13,0.316,32,0.594,1,0.613,4.2,2019-20,Regular%20Season
1629028,Deandre Ayton,1610612756,PHX,38,20,18,1236.0,147,107,39,0.728,308,0.477,6,0.487,4.8,289,81,208,0.28,419,0.69,31,0.745,4.6,436,188,247,0.431,695,0.627,37,0.663,4.7,2019-20,Regular%20Season
1627749,Dejounte Murray,1610612759,SAS,65,28,37,1656.0,69,37,32,0.536,183,0.377,8,0.394,8.7,307,36,271,0.117,477,0.644,42,0.706,5.8,376,73,303,0.194,645,0.583,50,0.632,6.3,2019-20,Regular%20Season
1626153,Delon Wright,1610612742,DAL,66,37,29,1470.0,70,30,41,0.429,162,0.432,6,0.449,8.9,207,41,166,0.198,341,0.607,34,0.674,7.7,277,71,207,0.256,498,0.556,40,0.605,8.0,2019-20,Regular%20Season
203471,Dennis Schroder,1610612760,OKC,64,40,24,1967.0,19,6,13,0.316,77,0.247,4,0.26,14.6,217,19,196,0.088,330,0.658,24,0.709,10.3,236,25,209,0.106,403,0.586,28,0.629,10.6,2019-20,Regular%20Season
1628372,Dennis Smith Jr.,1610612752,NYK,26,7,19,432.0,21,9,13,0.429,39,0.538,1,0.553,11.2,57,12,45,0.211,86,0.663,7,0.722,7.5,78,21,58,0.269,125,0.624,8,0.667,8.5,2019-20,Regular%20Season
1627756,Denzel Valentine,1610612741,CHI,31,11,20,453.0,9,2,7,0.222,20,0.45,0,0.45,15.4,65,6,59,0.092,108,0.602,12,0.677,7.8,74,8,66,0.108,122,0.607,12,0.673,8.8,2019-20,Regular%20Season
1629126,Deonte Burton,1610612760,OKC,21,11,10,250.0,7,4,3,0.571,19,0.368,1,0.389,7.5,50,11,39,0.22,76,0.658,5,0.704,7.4,57,15,42,0.263,91,0.626,6,0.671,7.4,2019-20,Regular%20Season
202324,Derrick Favors,1610612740,NOP,50,24,26,1211.0,157,117,39,0.745,314,0.5,9,0.515,4.3,330,122,204,0.37,511,0.646,43,0.705,4.3,487,239,243,0.491,802,0.607,52,0.649,4.3,2019-20,Regular%20Season
1627884,Derrick Jones Jr.,1610612748,MIA,56,33,23,1349.0,65,38,26,0.585,135,0.481,3,0.492,8.1,165,47,118,0.285,246,0.671,21,0.733,6.7,230,85,144,0.37,367,0.627,24,0.671,7.1,2019-20,Regular%20Season
201565,Derrick Rose,1610612765,DET,41,16,25,1087.0,26,9,17,0.346,61,0.426,3,0.448,12.0,94,8,86,0.085,180,0.522,11,0.556,10.7,120,17,103,0.142,240,0.5,14,0.531,11.0,2019-20,Regular%20Season
1628476,Derrick Walton Jr.,1610612765,DET,12,8,4,182.0,2,0,2,0.0,3,0.667,0,0.667,10.2,14,2,12,0.143,26,0.538,1,0.56,9.7,16,2,14,0.125,29,0.552,1,0.571,9.7,2019-20,Regular%20Season
1628401,Derrick White,1610612759,SAS,63,31,32,1562.0,35,14,21,0.4,97,0.361,0,0.361,10.3,186,43,142,0.231,319,0.583,24,0.631,9.0,221,57,163,0.258,405,0.546,24,0.58,9.2,2019-20,Regular%20Season
1626164,Devin Booker,1610612756,PHX,68,34,34,2434.0,29,10,18,0.345,107,0.271,7,0.29,15.4,268,31,235,0.116,408,0.657,29,0.707,7.8,297,41,253,0.138,503,0.59,36,0.636,8.5,2019-20,Regular%20Season
1628985,Devon Hall,1610612760,OKC,5,1,4,65.0,2,1,1,0.5,5,0.4,0,0.4,6.7,5,1,4,0.2,7,0.714,2,1.0,6.8,7,2,5,0.286,12,0.583,2,0.7,6.8,2019-20,Regular%20Season
1629719,Devontae Cacok,1610612747,LAL,1,0,1,9.0,2,1,1,0.5,4,0.5,0,0.5,2.3,3,1,2,0.333,4,0.75,0,0.75,4.3,5,2,3,0.4,8,0.625,0,0.625,3.5,2019-20,Regular%20Season
1628984,Devonte' Graham,1610612766,CHA,59,21,38,2079.0,42,14,27,0.333,102,0.412,3,0.424,13.6,163,27,135,0.166,298,0.547,32,0.613,9.1,205,41,162,0.2,394,0.52,35,0.571,10.0,2019-20,Regular%20Season
1629608,Dewan Hernandez,1610612761,TOR,3,3,0,21.0,5,2,3,0.4,7,0.714,0,0.714,4.1,9,4,5,0.444,10,0.9,0,0.9,5.7,14,6,8,0.429,17,0.824,0,0.824,5.1,2019-20,Regular%20Season
203473,Dewayne Dedmon,1610612737,ATL,43,16,27,762.0,60,42,18,0.7,149,0.403,3,0.411,4.5,189,62,127,0.328,293,0.645,18,0.687,4.5,249,104,145,0.418,418,0.596,21,0.627,4.5,2019-20,Regular%20Season
1628415,Dillon Brooks,1610612763,MEM,68,32,36,1987.0,68,33,35,0.485,145,0.469,5,0.486,11.3,175,33,142,0.189,313,0.559,27,0.612,9.4,243,66,177,0.272,451,0.539,32,0.58,9.9,2019-20,Regular%20Season
203079,Dion Waiters,1610612747,LAL,8,2,6,161.0,2,1,1,0.5,6,0.333,0,0.333,12.2,22,3,19,0.136,36,0.611,3,0.667,9.4,24,4,20,0.167,42,0.571,3,0.615,9.7,2019-20,Regular%20Season
1627734,Domantas Sabonis,1610612754,IND,62,37,25,2159.0,189,153,37,0.81,432,0.438,13,0.451,4.0,582,140,441,0.241,879,0.662,58,0.709,3.9,771,293,478,0.38,1267,0.609,71,0.645,3.9,2019-20,Regular%20Season
1628378,Donovan Mitchell,1610612762,UTA,67,42,25,2297.0,53,28,25,0.528,115,0.461,4,0.477,10.7,251,49,203,0.195,391,0.642,29,0.693,8.4,304,77,228,0.253,503,0.604,33,0.647,8.8,2019-20,Regular%20Season
1629743,Donta Hall,1610612751,BKN,8,3,5,128.0,14,7,7,0.5,34,0.412,1,0.424,7.2,24,5,19,0.208,33,0.727,1,0.75,3.9,38,12,26,0.316,64,0.594,2,0.613,5.1,2019-20,Regular%20Season
1628978,Donte DiVincenzo,1610612749,MIL,64,51,13,1493.0,63,40,23,0.635,148,0.426,1,0.429,9.0,248,45,201,0.181,403,0.615,43,0.689,5.9,311,85,224,0.273,548,0.568,44,0.617,6.6,2019-20,Regular%20Season
1627827,Dorian Finney-Smith,1610612742,DAL,68,38,30,2068.0,143,80,61,0.559,280,0.511,18,0.546,7.7,257,67,189,0.261,423,0.608,51,0.691,6.3,400,147,250,0.368,688,0.581,69,0.646,6.8,2019-20,Regular%20Season
203926,Doug McDermott,1610612754,IND,60,38,22,1239.0,26,13,13,0.5,73,0.356,3,0.371,6.5,148,32,116,0.216,268,0.552,28,0.617,5.9,174,45,129,0.259,330,0.527,31,0.582,6.0,2019-20,Regular%20Season
1627733,Dragan Bender,1610612744,GSW,14,8,6,278.0,16,10,6,0.625,40,0.4,0,0.4,6.0,55,17,38,0.309,86,0.64,7,0.696,4.2,71,27,44,0.38,119,0.597,7,0.634,4.6,2019-20,Regular%20Season
203110,Draymond Green,1610612744,GSW,43,10,33,1222.0,23,12,12,0.522,78,0.295,2,0.303,9.4,243,80,163,0.329,378,0.643,38,0.715,5.7,266,92,175,0.346,432,0.616,40,0.679,6.0,2019-20,Regular%20Season
1629234,Drew Eubanks,1610612759,SAS,18,10,8,265.0,28,14,14,0.5,59,0.475,1,0.483,5.8,57,14,43,0.246,93,0.613,11,0.695,4.9,85,28,57,0.329,145,0.586,12,0.639,5.2,2019-20,Regular%20Season
1629130,Duncan Robinson,1610612748,MIA,70,42,28,2082.0,10,0,10,0.0,40,0.25,3,0.27,20.1,216,35,179,0.162,355,0.608,45,0.697,7.7,226,35,189,0.155,384,0.589,48,0.673,8.2,2019-20,Regular%20Season
1628605,Dusty Hannahs,1610612763,MEM,1,0,1,7.0,0,0,0,0.0,0,0.0,0,0.0,0.0,1,0,1,0.0,1,1.0,0,1.0,3.0,1,0,1,0.0,1,1.0,0,1.0,3.0,2019-20,Regular%20Season
1628407,Dwayne Bacon,1610612766,CHA,34,9,25,656.0,15,10,5,0.667,47,0.319,1,0.326,6.1,85,11,75,0.129,131,0.649,10,0.702,6.4,100,21,80,0.21,169,0.592,11,0.633,6.4,2019-20,Regular%20Season
2730,Dwight Howard,1610612747,LAL,69,52,17,1306.0,172,121,49,0.703,374,0.46,6,0.467,4.2,335,74,263,0.221,546,0.614,46,0.67,4.1,507,195,312,0.385,882,0.575,52,0.611,4.1,2019-20,Regular%20Season
203939,Dwight Powell,1610612742,DAL,39,24,15,1029.0,73,44,29,0.603,183,0.399,8,0.417,6.8,144,36,109,0.25,250,0.576,18,0.621,6.2,217,80,138,0.369,423,0.513,26,0.547,6.4,2019-20,Regular%20Season
1629058,Dzanan Musa,1610612751,BKN,27,18,9,397.0,21,12,9,0.571,54,0.389,3,0.412,8.6,65,8,56,0.123,99,0.657,8,0.714,7.3,86,20,65,0.233,153,0.562,11,0.606,7.6,2019-20,Regular%20Season
202734,E'Twaun Moore,1610612740,NOP,44,24,20,897.0,31,13,17,0.419,63,0.492,2,0.508,8.7,100,19,81,0.19,148,0.676,8,0.714,9.2,131,32,98,0.244,203,0.645,10,0.679,9.1,2019-20,Regular%20Season
202334,Ed Davis,1610612762,UTA,28,16,12,303.0,35,22,13,0.629,89,0.393,3,0.407,6.2,70,20,51,0.286,117,0.598,7,0.636,4.5,105,42,64,0.4,197,0.533,10,0.561,5.1,2019-20,Regular%20Season
1628410,Edmond Sumner,1610612754,IND,22,10,12,377.0,11,6,5,0.545,23,0.478,0,0.478,10.2,34,5,29,0.147,67,0.507,8,0.576,10.8,45,11,34,0.244,90,0.5,8,0.549,10.6,2019-20,Regular%20Season
203901,Elfrid Payton,1610612752,NYK,44,16,28,1226.0,52,22,27,0.423,96,0.542,5,0.571,10.2,160,22,139,0.138,241,0.664,15,0.708,7.8,212,44,166,0.208,336,0.631,20,0.671,8.3,2019-20,Regular%20Season
1629059,Elie Okobo,1610612756,PHX,36,15,21,594.0,16,9,7,0.563,28,0.571,0,0.571,12.7,73,9,64,0.123,113,0.646,6,0.682,8.4,89,18,71,0.202,139,0.64,6,0.669,9.2,2019-20,Regular%20Season
1626144,Emmanuel Mudiay,1610612762,UTA,49,32,17,812.0,18,6,12,0.333,47,0.383,1,0.391,14.8,108,11,97,0.102,177,0.61,16,0.671,7.8,126,17,109,0.135,223,0.565,17,0.612,8.8,2019-20,Regular%20Season
202683,Enes Freedom,1610612738,BOS,57,35,22,979.0,163,136,26,0.834,364,0.448,7,0.457,3.2,268,71,196,0.265,434,0.618,39,0.678,4.5,431,207,222,0.48,774,0.557,46,0.592,4.0,2019-20,Regular%20Season
202339,Eric Bledsoe,1610612749,MIL,59,47,12,1594.0,42,27,17,0.643,127,0.331,5,0.344,9.6,237,38,201,0.16,368,0.644,33,0.707,8.3,279,65,218,0.233,484,0.576,38,0.626,8.5,2019-20,Regular%20Season
201569,Eric Gordon,1610612745,HOU,32,19,13,907.0,8,0,8,0.0,42,0.19,4,0.211,27.6,62,12,50,0.194,114,0.544,6,0.574,10.5,70,12,58,0.171,152,0.461,10,0.493,12.5,2019-20,Regular%20Season
1628450,Eric Mika,1610612758,SAC,1,0,1,19.0,2,1,1,0.5,6,0.333,1,0.4,1.8,5,2,3,0.4,7,0.714,1,0.833,5.0,7,3,4,0.429,13,0.538,2,0.636,4.1,2019-20,Regular%20Season
1629672,Eric Paschall,1610612744,GSW,59,14,45,1636.0,82,51,31,0.622,185,0.443,8,0.463,7.4,193,49,144,0.254,306,0.631,19,0.672,7.0,275,100,175,0.364,480,0.573,27,0.607,7.1,2019-20,Regular%20Season
101141,Ersan Ilyasova,1610612749,MIL,57,45,12,918.0,62,45,16,0.726,155,0.4,6,0.416,5.6,237,55,181,0.232,341,0.695,26,0.752,4.9,299,100,197,0.334,469,0.638,32,0.684,5.0,2019-20,Regular%20Season
203095,Evan Fournier,1610612753,ORL,63,27,36,1980.0,18,5,12,0.278,59,0.305,0,0.305,18.3,153,24,130,0.157,253,0.605,23,0.665,9.4,171,29,142,0.17,304,0.563,23,0.609,10.3,2019-20,Regular%20Season
202323,Evan Turner,1610612750,MIN,15,2,13,206.0,8,2,6,0.25,19,0.421,0,0.421,11.6,30,7,22,0.233,52,0.577,7,0.667,7.1,38,9,28,0.237,69,0.551,7,0.613,8.1,2019-20,Regular%20Season
1628402,Frank Jackson,1610612740,NOP,37,17,20,572.0,22,5,17,0.227,43,0.512,1,0.524,13.6,59,12,47,0.203,91,0.648,6,0.694,7.1,81,17,64,0.21,133,0.609,7,0.643,8.9,2019-20,Regular%20Season
1626163,Frank Kaminsky,1610612756,PHX,37,18,19,738.0,34,24,8,0.706,91,0.374,4,0.391,5.1,135,50,85,0.37,220,0.614,24,0.689,4.5,169,74,93,0.438,298,0.567,28,0.626,4.6,2019-20,Regular%20Season
1628412,Frank Mason III,1610612749,MIL,7,4,3,108.0,5,3,2,0.6,11,0.455,0,0.455,9.2,14,3,11,0.214,20,0.7,2,0.778,9.5,19,6,13,0.316,31,0.613,2,0.655,9.4,2019-20,Regular%20Season
1628373,Frank Ntilikina,1610612752,NYK,45,16,29,1025.0,23,8,14,0.348,41,0.561,3,0.605,15.6,98,18,80,0.184,173,0.566,17,0.628,9.7,121,26,94,0.215,207,0.585,20,0.647,10.8,2019-20,Regular%20Season
1627832,Fred VanVleet,1610612761,TOR,53,39,14,1889.0,18,4,15,0.222,84,0.214,4,0.225,15.4,185,29,155,0.157,305,0.607,19,0.647,9.5,203,33,170,0.163,387,0.525,23,0.558,10.1,2019-20,Regular%20Season
1627788,Furkan Korkmaz,1610612755,PHI,62,36,26,1354.0,18,8,10,0.444,46,0.391,4,0.429,12.4,150,16,134,0.107,211,0.711,15,0.765,8.9,168,24,144,0.143,251,0.669,19,0.724,9.3,2019-20,Regular%20Season
1629216,Gabe Vincent,1610612748,MIA,4,1,3,61.0,0,0,0,0.0,3,0.0,0,0.0,0.0,5,1,4,0.2,8,0.625,1,0.714,6.8,5,1,4,0.2,10,0.5,1,0.556,6.8,2019-20,Regular%20Season
202066,Garrett Temple,1610612751,BKN,58,28,30,1642.0,29,14,15,0.483,99,0.293,3,0.302,12.5,189,26,162,0.138,319,0.592,33,0.661,8.4,218,40,177,0.183,405,0.538,36,0.591,9.0,2019-20,Regular%20Season
1629726,Garrison Mathews,1610612764,WAS,12,4,8,191.0,6,3,3,0.5,11,0.545,0,0.545,11.2,18,4,14,0.222,29,0.621,2,0.667,8.2,24,7,17,0.292,40,0.6,2,0.632,9.0,2019-20,Regular%20Season
1629109,Gary Clark,1610612753,ORL,33,17,16,519.0,37,15,22,0.405,77,0.481,1,0.487,9.5,73,20,53,0.274,126,0.579,10,0.629,6.2,110,35,75,0.318,197,0.558,11,0.591,7.3,2019-20,Regular%20Season
203914,Gary Harris,1610612743,DEN,52,34,18,1662.0,26,13,13,0.5,82,0.317,4,0.333,11.4,137,26,110,0.19,198,0.692,9,0.725,9.8,163,39,123,0.239,277,0.588,13,0.617,10.1,2019-20,Regular%20Season
1627780,Gary Payton II,1610612764,WAS,21,10,11,400.0,26,18,8,0.692,53,0.491,2,0.51,6.2,54,11,43,0.204,91,0.593,7,0.643,4.8,80,29,51,0.363,143,0.559,9,0.597,5.3,2019-20,Regular%20Season
1629018,Gary Trent Jr.,1610612757,POR,44,22,22,1046.0,24,5,19,0.208,44,0.545,3,0.585,12.9,72,8,64,0.111,137,0.526,13,0.581,8.3,96,13,83,0.135,178,0.539,16,0.593,9.5,2019-20,Regular%20Season
201588,George Hill,1610612749,MIL,55,43,12,1184.0,50,22,27,0.44,95,0.526,4,0.549,7.8,124,28,96,0.226,198,0.626,13,0.67,8.6,174,50,123,0.287,292,0.596,17,0.633,8.3,2019-20,Regular%20Season
1627777,Georges Niang,1610612762,UTA,53,31,22,788.0,15,4,11,0.267,37,0.405,3,0.441,16.6,112,27,85,0.241,180,0.622,14,0.675,6.4,127,31,96,0.244,207,0.614,17,0.668,7.6,2019-20,Regular%20Season
203507,Giannis Antetokounmpo,1610612749,MIL,62,50,12,1885.0,136,93,43,0.684,314,0.433,7,0.443,5.8,704,155,550,0.22,976,0.721,63,0.771,4.8,840,248,593,0.295,1238,0.679,70,0.719,4.9,2019-20,Regular%20Season
203922,Glenn Robinson III,1610612755,PHI,62,17,45,1786.0,81,40,40,0.494,195,0.415,7,0.431,9.5,189,32,156,0.169,331,0.571,42,0.654,7.7,270,72,196,0.267,504,0.536,49,0.593,8.2,2019-20,Regular%20Season
1629048,Goga Bitadze,1610612754,IND,43,28,15,436.0,25,15,9,0.6,62,0.403,0,0.403,3.9,81,26,54,0.321,154,0.526,17,0.591,4.4,106,41,63,0.387,209,0.507,17,0.552,4.3,2019-20,Regular%20Season
201609,Goran Dragic,1610612748,MIA,56,35,21,1582.0,28,9,19,0.321,78,0.359,10,0.412,12.6,154,21,133,0.136,256,0.602,22,0.658,8.9,182,30,152,0.165,330,0.552,32,0.611,9.5,2019-20,Regular%20Season
202330,Gordon Hayward,1610612738,BOS,52,34,18,1740.0,55,24,31,0.436,146,0.377,3,0.385,8.3,293,49,244,0.167,417,0.703,29,0.755,7.0,348,73,275,0.21,535,0.65,32,0.692,7.3,2019-20,Regular%20Season
203476,Gorgui Dieng,1610612763,MEM,60,20,40,1073.0,91,47,43,0.516,196,0.464,4,0.474,6.7,263,75,187,0.285,398,0.661,30,0.715,5.1,354,122,230,0.345,570,0.621,34,0.66,5.5,2019-20,Regular%20Season
1629684,Grant Williams,1610612738,BOS,63,44,19,987.0,59,40,19,0.678,158,0.373,4,0.383,5.8,119,36,81,0.303,224,0.531,30,0.613,6.1,178,76,100,0.427,373,0.477,34,0.525,6.0,2019-20,Regular%20Season
1628960,Grayson Allen,1610612763,MEM,33,14,19,662.0,8,2,6,0.25,34,0.235,3,0.258,20.9,77,9,68,0.117,122,0.631,10,0.688,8.6,85,11,74,0.129,153,0.556,13,0.607,9.8,2019-20,Regular%20Season
1628977,Hamidou Diallo,1610612760,OKC,43,24,19,853.0,44,28,16,0.636,90,0.489,1,0.494,5.2,123,26,97,0.211,190,0.647,20,0.724,5.4,167,54,113,0.323,271,0.616,21,0.668,5.4,2019-20,Regular%20Season
203084,Harrison Barnes,1610612758,SAC,71,31,40,2448.0,74,41,33,0.554,189,0.392,12,0.418,8.9,276,48,228,0.174,458,0.603,39,0.659,6.7,350,89,261,0.254,634,0.552,51,0.6,7.1,2019-20,Regular%20Season
1628385,Harry Giles III,1610612758,SAC,41,21,20,641.0,43,24,19,0.558,110,0.391,3,0.402,6.6,142,37,105,0.261,229,0.62,25,0.696,4.8,185,61,124,0.33,317,0.584,28,0.64,5.2,2019-20,Regular%20Season
202355,Hassan Whiteside,1610612757,POR,66,33,33,1973.0,255,201,53,0.788,511,0.499,8,0.507,4.5,633,213,417,0.336,987,0.641,79,0.697,3.9,888,414,470,0.466,1456,0.61,87,0.649,4.0,2019-20,Regular%20Season
1627740,Henry Ellenson,1610612751,BKN,3,1,2,8.0,2,1,1,0.5,4,0.5,0,0.5,3.9,4,1,3,0.25,7,0.571,2,0.8,4.0,6,2,4,0.333,11,0.545,2,0.667,4.0,2019-20,Regular%20Season
101133,Ian Mahinmi,1610612764,WAS,37,15,22,800.0,78,51,28,0.654,172,0.453,7,0.473,5.9,140,39,101,0.279,266,0.526,35,0.606,5.2,218,90,129,0.413,420,0.519,42,0.577,5.4,2019-20,Regular%20Season
1629649,Ignas Brazdeikis,1610612752,NYK,3,0,3,33.0,2,0,2,0.0,5,0.4,0,0.4,9.0,3,0,3,0.0,3,1.0,0,1.0,8.7,5,0,5,0.0,7,0.714,0,0.714,8.8,2019-20,Regular%20Season
202697,Iman Shumpert,1610612751,BKN,11,8,3,205.0,9,4,5,0.444,18,0.5,2,0.563,14.3,25,1,24,0.04,51,0.49,3,0.521,7.8,34,5,29,0.147,67,0.507,5,0.548,9.5,2019-20,Regular%20Season
1629067,Isaac Bonga,1610612764,WAS,57,18,39,1158.0,71,43,27,0.606,168,0.423,6,0.438,7.5,151,30,122,0.199,285,0.53,32,0.597,6.7,222,73,149,0.329,439,0.506,38,0.554,6.9,2019-20,Regular%20Season
1628392,Isaiah Hartenstein,1610612745,HOU,16,12,4,232.0,29,20,9,0.69,63,0.46,3,0.483,5.1,61,18,43,0.295,93,0.656,8,0.718,5.2,90,38,52,0.422,152,0.592,11,0.638,5.1,2019-20,Regular%20Season
1629676,Isaiah Roby,1610612760,OKC,2,1,1,10.0,0,0,0,0.0,0,0.0,0,0.0,0.0,2,1,1,0.5,2,1.0,0,1.0,1.9,2,1,1,0.5,2,1.0,0,1.0,1.9,2019-20,Regular%20Season
202738,Isaiah Thomas,1610612764,WAS,27,10,17,669.0,11,4,7,0.364,29,0.379,0,0.379,12.7,57,5,52,0.088,79,0.722,3,0.75,10.2,68,9,59,0.132,107,0.636,3,0.654,10.6,2019-20,Regular%20Season
202397,Ish Smith,1610612764,WAS,65,23,42,1706.0,30,7,23,0.233,75,0.4,5,0.429,12.7,189,29,159,0.153,339,0.558,31,0.614,8.5,219,36,182,0.164,408,0.537,36,0.589,9.0,2019-20,Regular%20Season
1627826,Ivica Zubac,1610612746,LAC,72,49,23,1326.0,197,160,37,0.812,392,0.503,4,0.508,3.7,346,105,239,0.303,570,0.607,60,0.678,4.2,543,265,276,0.488,934,0.581,64,0.624,4.0,2019-20,Regular%20Season
200826,J.J. Barea,1610612742,DAL,24,14,10,399.0,10,1,9,0.1,19,0.526,0,0.526,16.4,43,2,41,0.047,65,0.662,5,0.717,10.7,53,3,50,0.057,82,0.646,5,0.688,11.8,2019-20,Regular%20Season
200755,JJ Redick,1610612740,NOP,52,24,28,1398.0,10,2,8,0.2,37,0.27,1,0.278,14.8,141,14,127,0.099,236,0.597,22,0.659,8.7,151,16,135,0.106,269,0.561,23,0.614,9.1,2019-20,Regular%20Season
2747,JR Smith,1610612747,LAL,4,0,4,57.0,0,0,0,0.0,0,0.0,0,0.0,0.0,5,1,4,0.2,9,0.556,1,0.625,7.3,5,1,4,0.2,9,0.556,1,0.625,7.3,2019-20,Regular%20Season
1629630,Ja Morant,1610612763,MEM,66,33,33,2047.0,51,26,23,0.51,190,0.268,10,0.283,9.9,208,28,181,0.135,363,0.573,40,0.644,7.9,259,54,204,0.208,547,0.473,50,0.521,8.3,2019-20,Regular%20Season
203960,JaKarr Sampson,1610612754,IND,29,17,12,433.0,20,14,6,0.7,58,0.345,2,0.357,8.0,68,21,46,0.309,121,0.562,14,0.636,4.8,88,35,52,0.398,172,0.512,16,0.564,5.5,2019-20,Regular%20Season
203210,JaMychal Green,1610612746,LAC,63,43,20,1307.0,77,49,28,0.636,192,0.401,8,0.418,7.7,311,66,245,0.212,477,0.652,28,0.693,4.6,388,115,273,0.296,634,0.612,36,0.649,5.2,2019-20,Regular%20Season
201580,JaVale McGee,1610612747,LAL,68,51,17,1130.0,125,88,37,0.704,266,0.47,6,0.481,4.5,265,80,185,0.302,435,0.609,30,0.654,4.4,390,168,222,0.431,677,0.576,36,0.608,4.4,2019-20,Regular%20Season
203953,Jabari Parker,1610612758,SAC,37,9,28,903.0,61,38,22,0.623,161,0.379,4,0.389,6.4,153,34,119,0.222,238,0.643,12,0.677,5.5,214,72,141,0.336,384,0.557,16,0.582,5.8,2019-20,Regular%20Season
1628980,Jacob Evans,1610612750,MIN,22,7,15,344.0,9,6,3,0.667,22,0.409,2,0.45,10.6,32,10,22,0.313,58,0.552,4,0.593,7.0,41,16,25,0.39,80,0.513,6,0.554,7.8,2019-20,Regular%20Season
203109,Jae Crowder,1610612748,MIA,62,29,33,1822.0,51,23,29,0.451,125,0.408,4,0.421,11.3,322,56,265,0.174,465,0.692,43,0.763,6.2,373,79,294,0.212,566,0.659,47,0.719,6.9,2019-20,Regular%20Season
1626143,Jahlil Okafor,1610612740,NOP,28,7,21,453.0,48,36,12,0.75,123,0.39,3,0.4,5.4,79,29,50,0.367,147,0.537,13,0.59,4.6,127,65,62,0.512,263,0.483,16,0.514,4.9,2019-20,Regular%20Season
1627774,Jake Layman,1610612750,MIN,20,10,10,455.0,17,9,8,0.529,42,0.405,3,0.436,9.7,40,7,33,0.175,71,0.563,7,0.625,8.3,57,16,41,0.281,110,0.518,10,0.57,8.7,2019-20,Regular%20Season
1627751,Jakob Poeltl,1610612759,SAS,64,28,36,1151.0,127,92,33,0.724,253,0.502,4,0.51,5.1,237,94,142,0.397,410,0.578,41,0.642,4.2,364,186,175,0.511,643,0.566,45,0.609,4.5,2019-20,Regular%20Season
1628973,Jalen Brunson,1610612742,DAL,49,29,20,955.0,22,10,12,0.455,61,0.361,1,0.367,12.2,111,21,90,0.189,184,0.603,21,0.681,8.0,133,31,102,0.233,243,0.547,22,0.602,8.7,2019-20,Regular%20Season
1629665,Jalen Lecque,1610612756,PHX,1,1,0,5.0,0,0,0,0.0,0,0.0,0,0.0,0.0,2,2,0,1.0,2,1.0,0,1.0,4.2,2,2,0,1.0,2,1.0,0,1.0,4.2,2019-20,Regular%20Season
1629667,Jalen McDaniels,1610612766,CHA,15,7,8,290.0,15,10,5,0.667,28,0.536,1,0.556,5.5,50,7,43,0.14,78,0.641,7,0.704,5.4,65,17,48,0.262,103,0.631,8,0.684,5.4,2019-20,Regular%20Season
1627750,Jamal Murray,1610612743,DEN,57,38,19,1863.0,45,20,25,0.444,110,0.409,6,0.433,11.0,191,31,160,0.162,301,0.635,28,0.7,8.4,236,51,185,0.216,405,0.583,34,0.636,8.9,2019-20,Regular%20Season
203516,James Ennis III,1610612753,ORL,65,40,25,1227.0,71,48,23,0.676,194,0.366,6,0.378,5.8,174,21,153,0.121,271,0.642,33,0.731,5.8,245,69,176,0.282,455,0.538,39,0.589,5.8,2019-20,Regular%20Season
201935,James Harden,1610612745,HOU,68,43,25,2483.0,70,33,36,0.471,225,0.311,3,0.315,9.9,376,76,300,0.202,599,0.628,36,0.668,7.4,446,109,336,0.244,795,0.561,39,0.59,7.8,2019-20,Regular%20Season
201949,James Johnson,1610612750,MIN,31,13,18,617.0,25,12,13,0.48,52,0.481,0,0.481,7.5,93,16,77,0.172,152,0.612,15,0.679,6.0,118,28,90,0.237,193,0.611,15,0.663,6.3,2019-20,Regular%20Season
201162,Jared Dudley,1610612747,LAL,27,18,9,261.0,6,3,3,0.5,17,0.353,0,0.353,9.4,45,8,37,0.178,80,0.563,8,0.625,7.3,51,11,40,0.216,91,0.56,8,0.614,7.5,2019-20,Regular%20Season
1628991,Jaren Jackson Jr.,1610612763,MEM,56,28,28,1603.0,55,36,19,0.655,150,0.367,6,0.382,7.5,207,79,127,0.382,380,0.545,32,0.595,6.2,262,115,146,0.439,520,0.504,38,0.544,6.5,2019-20,Regular%20Season
1629020,Jarred Vanderbilt,1610612750,MIN,7,3,4,36.0,3,3,0,1.0,9,0.333,1,0.375,3.2,6,0,6,0.0,9,0.667,1,0.75,5.3,9,3,6,0.333,17,0.529,2,0.6,4.6,2019-20,Regular%20Season
1629714,Jarrell Brantley,1610612762,UTA,7,1,6,94.0,2,1,1,0.5,4,0.5,0,0.5,7.2,18,5,13,0.278,27,0.667,1,0.692,4.7,20,6,14,0.3,30,0.667,1,0.69,5.0,2019-20,Regular%20Season
1628386,Jarrett Allen,1610612751,BKN,70,33,37,1852.0,216,160,54,0.741,482,0.448,14,0.462,5.0,455,134,318,0.295,707,0.644,64,0.708,4.5,671,294,372,0.438,1150,0.583,78,0.626,4.6,2019-20,Regular%20Season
1629633,Jarrett Culver,1610612750,MIN,62,19,43,1490.0,70,38,32,0.543,153,0.458,4,0.47,9.2,142,26,117,0.183,237,0.599,19,0.651,7.8,212,64,149,0.302,384,0.552,23,0.587,8.3,2019-20,Regular%20Season
1627784,Jarrod Uthoff,1610612764,WAS,3,1,2,40.0,2,1,1,0.5,8,0.25,0,0.25,3.1,4,0,4,0.0,10,0.4,2,0.5,5.2,6,1,5,0.167,17,0.353,2,0.4,4.5,2019-20,Regular%20Season
1629750,Javonte Green,1610612738,BOS,38,26,12,418.0,24,18,6,0.75,51,0.471,1,0.48,4.9,69,17,53,0.246,106,0.651,8,0.704,6.9,93,35,59,0.376,151,0.616,9,0.655,6.4,2019-20,Regular%20Season
1629637,Jaxson Hayes,1610612740,NOP,60,26,34,1064.0,97,72,27,0.742,202,0.48,2,0.485,5.0,162,55,107,0.34,327,0.495,42,0.568,5.0,259,127,134,0.49,509,0.509,44,0.557,5.0,2019-20,Regular%20Season
1627759,Jaylen Brown,1610612738,BOS,56,37,19,1903.0,62,30,32,0.484,161,0.385,8,0.405,10.9,302,61,241,0.202,505,0.598,41,0.651,6.0,364,91,273,0.25,645,0.564,49,0.611,6.8,2019-20,Regular%20Season
1629658,Jaylen Hoard,1610612757,POR,12,6,6,101.0,14,11,2,0.786,25,0.56,1,0.583,7.2,18,3,15,0.167,29,0.621,4,0.72,4.6,32,14,17,0.438,52,0.615,5,0.681,5.7,2019-20,Regular%20Season
1629669,Jaylen Nowell,1610612750,MIN,9,2,7,96.0,3,2,1,0.667,9,0.333,0,0.333,11.6,10,1,9,0.1,19,0.526,4,0.667,10.0,13,3,10,0.231,28,0.464,4,0.542,10.4,2019-20,Regular%20Season
1628369,Jayson Tatum,1610612738,BOS,66,46,20,2265.0,64,36,26,0.563,201,0.318,2,0.322,8.6,396,59,339,0.149,556,0.712,36,0.762,6.4,460,95,365,0.207,703,0.654,38,0.692,6.7,2019-20,Regular%20Season
201145,Jeff Green,1610612745,HOU,44,27,17,882.0,24,14,10,0.583,57,0.421,2,0.436,8.0,108,25,82,0.231,177,0.61,12,0.655,8.2,132,39,92,0.295,228,0.579,14,0.617,8.1,2019-20,Regular%20Season
201952,Jeff Teague,1610612737,ATL,54,19,35,1352.0,27,10,17,0.37,69,0.391,4,0.415,14.8,115,11,104,0.096,189,0.608,17,0.669,9.3,142,21,121,0.148,256,0.555,21,0.604,10.3,2019-20,Regular%20Season
203924,Jerami Grant,1610612743,DEN,68,43,25,1843.0,58,35,21,0.603,136,0.426,6,0.446,7.3,190,57,134,0.3,333,0.571,28,0.623,6.2,248,92,155,0.371,459,0.54,34,0.584,6.5,2019-20,Regular%20Season
1629725,Jeremiah Martin,1610612751,BKN,6,4,2,79.0,1,0,1,0.0,3,0.333,0,0.333,26.9,9,1,8,0.111,16,0.563,0,0.563,12.2,10,1,9,0.1,19,0.526,0,0.526,13.7,2019-20,Regular%20Season
203087,Jeremy Lamb,1610612754,IND,44,26,18,1261.0,24,10,14,0.417,62,0.387,3,0.407,7.4,176,35,141,0.199,278,0.633,28,0.704,6.2,200,45,155,0.225,334,0.599,31,0.66,6.3,2019-20,Regular%20Season
202951,Jeremy Pargo,1610612744,GSW,2,0,2,35.0,1,0,1,0.0,2,0.5,0,0.5,16.7,2,0,2,0.0,4,0.5,1,0.667,7.3,3,0,3,0.0,6,0.5,1,0.6,10.5,2019-20,Regular%20Season
1626170,Jerian Grant,1610612764,WAS,4,1,3,47.0,2,0,2,0.0,3,0.667,0,0.667,15.0,4,0,4,0.0,8,0.5,0,0.5,8.0,6,0,6,0.0,9,0.667,0,0.667,10.4,2019-20,Regular%20Season
1629010,Jerome Robinson,1610612764,WAS,46,25,21,897.0,13,2,11,0.154,37,0.351,1,0.361,13.9,116,13,103,0.112,181,0.641,15,0.699,6.8,129,15,114,0.116,216,0.597,16,0.645,7.5,2019-20,Regular%20Season
1628975,Jevon Carter,1610612756,PHX,49,24,25,873.0,30,8,22,0.267,64,0.469,2,0.484,15.1,88,10,78,0.114,134,0.657,14,0.733,8.4,118,18,100,0.153,188,0.628,16,0.686,10.1,2019-20,Regular%20Season
202710,Jimmy Butler,1610612748,MIA,57,37,20,1935.0,106,66,38,0.623,244,0.434,7,0.447,7.7,280,54,224,0.193,415,0.675,36,0.739,7.2,386,120,262,0.311,657,0.588,43,0.629,7.3,2019-20,Regular%20Season
201149,Joakim Noah,1610612746,LAC,4,3,1,48.0,5,3,2,0.6,12,0.417,0,0.417,4.2,11,2,9,0.182,22,0.5,3,0.579,5.0,16,5,11,0.313,30,0.533,3,0.593,4.7,2019-20,Regular%20Season
203925,Joe Harris,1610612751,BKN,69,33,36,2123.0,64,31,32,0.484,176,0.364,6,0.376,11.2,234,39,195,0.167,430,0.544,50,0.616,7.8,298,70,227,0.235,598,0.498,56,0.55,8.5,2019-20,Regular%20Season
204060,Joe Ingles,1610612762,UTA,70,43,27,2086.0,27,11,16,0.407,65,0.415,2,0.429,16.2,251,33,218,0.131,377,0.666,29,0.721,7.6,278,44,234,0.158,436,0.638,31,0.686,8.4,2019-20,Regular%20Season
203954,Joel Embiid,1610612755,PHI,50,32,18,1498.0,141,92,49,0.652,305,0.462,11,0.48,5.7,452,115,336,0.254,709,0.638,65,0.702,4.3,593,207,385,0.349,975,0.608,76,0.66,4.6,2019-20,Regular%20Season
1628381,John Collins,1610612737,ATL,41,15,26,1363.0,116,72,44,0.621,296,0.392,5,0.399,6.0,300,86,210,0.287,473,0.634,38,0.69,4.4,416,158,254,0.38,732,0.568,43,0.604,4.9,2019-20,Regular%20Season
203089,John Henson,1610612765,DET,37,7,30,577.0,46,31,15,0.674,108,0.426,1,0.43,5.6,116,38,78,0.328,187,0.62,26,0.72,4.5,162,69,93,0.426,285,0.568,27,0.628,4.8,2019-20,Regular%20Season
1629723,John Konchar,1610612763,MEM,11,6,5,139.0,18,10,8,0.556,31,0.581,0,0.581,7.9,29,8,21,0.276,40,0.725,3,0.784,6.1,47,18,29,0.383,71,0.662,3,0.691,6.8,2019-20,Regular%20Season
1628405,Johnathan Motley,1610612746,LAC,6,3,3,27.0,3,2,1,0.667,5,0.6,0,0.6,1.3,6,0,6,0.0,7,0.857,1,1.0,4.2,9,2,7,0.222,10,0.9,1,1.0,3.2,2019-20,Regular%20Season
1629140,Johnathan Williams,1610612764,WAS,14,6,8,179.0,24,16,7,0.667,52,0.462,3,0.49,5.0,40,11,28,0.275,60,0.667,6,0.741,4.9,64,27,35,0.422,110,0.582,9,0.634,4.9,2019-20,Regular%20Season
1628413,Jonah Bolden,1610612756,PHX,3,3,0,40.0,3,3,0,1.0,6,0.5,0,0.5,2.4,6,5,1,0.833,10,0.6,0,0.6,4.8,9,8,1,0.889,16,0.563,0,0.563,4.0,2019-20,Regular%20Season
202685,Jonas Valanciunas,1610612763,MEM,70,32,38,1845.0,213,162,50,0.761,469,0.454,10,0.464,4.3,575,184,390,0.32,900,0.639,81,0.702,4.0,788,346,440,0.439,1329,0.593,91,0.637,4.1,2019-20,Regular%20Season
1628371,Jonathan Isaac,1610612753,ORL,34,15,19,980.0,58,39,18,0.672,133,0.436,2,0.443,4.9,173,47,127,0.272,300,0.577,31,0.643,5.1,231,86,145,0.372,414,0.558,33,0.606,5.1,2019-20,Regular%20Season
1628395,Jordan Bell,1610612739,CLE,26,5,21,248.0,30,19,11,0.633,59,0.508,1,0.517,5.7,51,13,39,0.255,73,0.699,7,0.773,4.2,81,32,50,0.395,126,0.643,8,0.686,4.7,2019-20,Regular%20Season
1629648,Jordan Bone,1610612765,DET,2,1,1,12.0,0,0,0,0.0,0,0.0,0,0.0,0.0,4,1,3,0.25,1,4.0,0,4.0,2.8,4,1,3,0.25,1,4.0,0,4.0,2.8,2019-20,Regular%20Season
203903,Jordan Clarkson,1610612762,UTA,64,30,34,1550.0,50,23,27,0.46,114,0.439,6,0.463,9.8,137,23,114,0.168,246,0.557,26,0.623,8.2,187,46,141,0.246,356,0.525,32,0.577,8.7,2019-20,Regular%20Season
1629162,Jordan McLaughlin,1610612750,MIN,25,6,19,499.0,7,2,5,0.286,26,0.269,0,0.269,20.6,42,11,30,0.262,71,0.592,8,0.667,9.5,49,13,35,0.265,95,0.516,8,0.563,11.1,2019-20,Regular%20Season
203895,Jordan McRae,1610612765,DET,33,10,23,751.0,18,8,10,0.444,42,0.429,0,0.429,13.2,106,17,87,0.16,149,0.711,6,0.741,7.4,124,25,97,0.202,185,0.67,6,0.693,8.2,2019-20,Regular%20Season
1629673,Jordan Poole,1610612744,GSW,46,10,36,1111.0,9,3,6,0.333,45,0.2,1,0.205,16.4,109,11,97,0.101,167,0.653,9,0.69,9.0,118,14,103,0.119,207,0.57,10,0.599,9.5,2019-20,Regular%20Season
1627982,Josh Gray,1610612740,NOP,1,0,1,15.0,1,0,1,0.0,2,0.5,0,0.5,5.8,1,0,1,0.0,1,1.0,0,1.0,8.4,2,0,2,0.0,3,0.667,0,0.667,7.1,2019-20,Regular%20Season
1628404,Josh Hart,1610612740,NOP,64,26,38,1742.0,61,29,32,0.475,161,0.379,5,0.391,12.1,360,81,280,0.225,559,0.644,53,0.711,5.4,421,110,312,0.261,696,0.605,58,0.66,6.4,2019-20,Regular%20Season
1628367,Josh Jackson,1610612763,MEM,18,8,10,342.0,11,6,5,0.545,35,0.314,0,0.314,9.5,55,13,42,0.236,83,0.663,3,0.688,5.8,66,19,47,0.288,116,0.569,3,0.584,6.4,2019-20,Regular%20Season
203705,Josh Magette,1610612753,ORL,5,2,3,33.0,1,0,1,0.0,1,1.0,0,1.0,0.0,5,0,5,0.0,6,0.833,0,0.833,7.0,6,0,6,0.0,6,1.0,0,1.0,5.8,2019-20,Regular%20Season
1629006,Josh Okogie,1610612750,MIN,60,18,42,1483.0,87,53,33,0.609,185,0.47,9,0.494,7.9,181,41,140,0.227,266,0.68,9,0.704,7.9,268,94,173,0.351,447,0.6,18,0.625,7.9,2019-20,Regular%20Season
1629729,Josh Reaves,1610612742,DAL,2,1,1,27.0,1,1,0,1.0,3,0.333,0,0.333,3.6,2,1,1,0.5,3,0.667,1,1.0,6.0,3,2,1,0.667,6,0.5,1,0.6,5.2,2019-20,Regular%20Season
1626196,Josh Richardson,1610612755,PHI,47,29,18,1483.0,41,20,21,0.488,114,0.36,12,0.402,10.1,133,26,108,0.195,217,0.613,18,0.668,9.6,174,46,129,0.264,325,0.535,30,0.59,9.7,2019-20,Regular%20Season
201950,Jrue Holiday,1610612740,NOP,60,26,34,2080.0,75,36,40,0.48,181,0.414,7,0.431,9.1,212,35,177,0.165,361,0.587,35,0.65,8.6,287,71,217,0.247,531,0.54,42,0.587,8.7,2019-20,Regular%20Season
1629308,Juan Toscano-Anderson,1610612744,GSW,12,3,9,271.0,9,5,4,0.556,21,0.429,1,0.45,6.4,43,10,33,0.233,77,0.558,10,0.642,5.7,52,15,37,0.288,94,0.553,11,0.627,5.8,2019-20,Regular%20Season
1627823,Juancho Hernangomez,1610612750,MIN,41,21,20,787.0,43,29,12,0.674,120,0.358,2,0.364,4.8,154,33,121,0.214,227,0.678,17,0.733,4.8,197,62,133,0.315,327,0.602,19,0.64,4.8,2019-20,Regular%20Season
203944,Julius Randle,1610612752,NYK,64,21,43,2080.0,151,103,47,0.682,348,0.434,9,0.445,5.8,471,97,374,0.206,693,0.68,69,0.755,5.3,622,200,421,0.322,997,0.624,78,0.677,5.4,2019-20,Regular%20Season
1626147,Justin Anderson,1610612751,BKN,8,5,3,104.0,1,0,1,0.0,4,0.25,1,0.333,34.2,20,4,16,0.2,22,0.909,0,0.909,5.8,21,4,17,0.19,24,0.875,1,0.913,7.1,2019-20,Regular%20Season
203200,Justin Holiday,1610612754,IND,70,44,26,1769.0,32,9,23,0.281,82,0.39,0,0.39,13.6,206,43,164,0.209,346,0.595,31,0.654,7.3,238,52,187,0.218,413,0.576,31,0.623,8.1,2019-20,Regular%20Season
1628382,Justin Jackson,1610612742,DAL,56,34,22,955.0,26,13,13,0.5,78,0.333,4,0.351,8.7,126,26,99,0.206,176,0.716,9,0.754,6.6,152,39,112,0.257,234,0.65,13,0.688,6.9,2019-20,Regular%20Season
1629713,Justin James,1610612758,SAC,16,4,12,195.0,6,3,3,0.5,15,0.4,1,0.429,9.9,26,5,21,0.192,44,0.591,4,0.65,4.7,32,8,24,0.25,54,0.593,5,0.653,5.7,2019-20,Regular%20Season
1628383,Justin Patton,1610612765,DET,3,2,1,19.0,1,1,0,1.0,3,0.333,0,0.333,4.7,4,2,2,0.5,5,0.8,0,0.8,5.2,5,3,2,0.6,7,0.714,0,0.714,5.1,2019-20,Regular%20Season
1629620,Justin Robinson,1610612764,WAS,3,1,2,34.0,1,0,1,0.0,0,0.0,0,0.0,0.0,4,0,4,0.0,5,0.8,0,0.8,7.0,5,0,5,0.0,5,1.0,0,1.0,5.6,2019-20,Regular%20Season
1629625,Justin Wright-Foreman,1610612762,UTA,3,1,2,44.0,0,0,0,0.0,1,0.0,0,0.0,0.0,5,1,4,0.2,6,0.833,0,0.833,12.5,5,1,4,0.2,6,0.833,0,0.833,12.5,2019-20,Regular%20Season
1626159,Justise Winslow,1610612763,MEM,11,7,4,352.0,16,9,7,0.563,33,0.485,1,0.5,10.7,57,12,45,0.211,89,0.64,11,0.731,5.4,73,21,52,0.288,120,0.608,12,0.676,6.6,2019-20,Regular%20Season
203994,Jusuf Nurkic,1610612757,POR,8,6,2,253.0,23,19,4,0.826,56,0.411,0,0.411,3.3,59,19,40,0.322,96,0.615,12,0.702,3.9,82,38,44,0.463,149,0.55,12,0.599,3.8,2019-20,Regular%20Season
1629752,Juwan Morgan,1610612762,UTA,13,8,5,108.0,10,8,2,0.8,26,0.385,0,0.385,5.4,19,7,12,0.368,33,0.576,2,0.613,6.3,29,15,14,0.517,56,0.518,2,0.537,6.0,2019-20,Regular%20Season
1629644,KZ Okpala,1610612748,MIA,2,1,1,23.0,1,1,0,1.0,4,0.25,0,0.25,1.3,4,1,3,0.25,3,1.333,0,1.333,4.4,5,2,3,0.4,7,0.714,0,0.714,3.7,2019-20,Regular%20Season
1628443,Kadeem Allen,1610612752,NYK,4,2,2,81.0,2,0,2,0.0,3,0.667,0,0.667,23.2,7,1,6,0.143,16,0.438,3,0.538,6.3,9,1,8,0.111,19,0.474,3,0.563,10.0,2019-20,Regular%20Season
1626157,Karl-Anthony Towns,1610612750,MIN,35,10,25,1187.0,95,76,16,0.8,206,0.461,4,0.47,5.6,283,100,183,0.353,418,0.677,25,0.72,4.7,378,176,199,0.466,603,0.627,29,0.659,4.9,2019-20,Regular%20Season
202695,Kawhi Leonard,1610612746,LAC,57,41,16,1848.0,54,27,25,0.5,163,0.331,3,0.338,8.7,348,78,270,0.224,490,0.71,34,0.763,6.7,402,105,295,0.261,614,0.655,37,0.697,6.9,2019-20,Regular%20Season
1628966,Keita Bates-Diop,1610612743,DEN,39,9,30,717.0,25,14,11,0.56,55,0.455,2,0.472,8.4,102,26,76,0.255,151,0.675,14,0.745,6.5,127,40,87,0.315,201,0.632,16,0.686,6.9,2019-20,Regular%20Season
1629103,Kelan Martin,1610612750,MIN,29,11,18,476.0,12,5,7,0.417,39,0.308,1,0.316,11.4,84,11,73,0.131,125,0.672,4,0.694,6.6,96,16,80,0.167,158,0.608,5,0.627,7.2,2019-20,Regular%20Season
1629640,Keldon Johnson,1610612759,SAS,14,7,7,280.0,10,6,4,0.6,30,0.333,2,0.357,6.8,47,9,38,0.191,79,0.595,5,0.635,7.6,57,15,42,0.263,104,0.548,7,0.588,7.5,2019-20,Regular%20Season
203482,Kelly Olynyk,1610612748,MIA,63,40,23,1268.0,44,28,16,0.636,156,0.282,5,0.291,7.2,258,50,207,0.194,451,0.572,50,0.643,5.1,302,78,223,0.258,569,0.531,55,0.588,5.4,2019-20,Regular%20Season
1626162,Kelly Oubre Jr.,1610612756,PHX,54,22,32,1856.0,67,38,29,0.567,179,0.374,4,0.383,8.0,286,47,239,0.164,440,0.65,30,0.698,5.6,353,85,268,0.241,587,0.601,34,0.638,6.1,2019-20,Regular%20Season
202689,Kemba Walker,1610612738,BOS,56,37,19,1742.0,36,21,14,0.583,98,0.367,3,0.379,9.3,181,35,146,0.193,335,0.54,34,0.601,7.9,217,56,160,0.258,432,0.502,37,0.549,8.2,2019-20,Regular%20Season
1629134,Kendrick Nunn,1610612748,MIA,61,39,22,1814.0,21,13,8,0.619,86,0.244,8,0.269,10.5,159,27,132,0.17,282,0.564,43,0.665,7.9,180,40,140,0.222,368,0.489,51,0.568,8.2,2019-20,Regular%20Season
1629026,Kenrich Williams,1610612740,NOP,37,11,26,819.0,51,31,20,0.608,127,0.402,11,0.44,7.1,135,25,111,0.185,221,0.611,19,0.668,5.5,186,56,131,0.301,334,0.557,30,0.612,6.0,2019-20,Regular%20Season
203145,Kent Bazemore,1610612758,SAC,66,32,34,1649.0,27,12,15,0.444,103,0.262,2,0.267,14.3,261,48,212,0.184,422,0.618,40,0.683,6.4,288,60,227,0.208,504,0.571,42,0.623,7.1,2019-20,Regular%20Season
203484,Kentavious Caldwell-Pope,1610612747,LAL,62,44,18,1614.0,38,12,26,0.316,68,0.559,2,0.576,12.4,104,23,81,0.221,209,0.498,24,0.562,8.4,142,35,107,0.246,270,0.526,26,0.582,9.5,2019-20,Regular%20Season
1628987,Kevin Hervey,1610612760,OKC,4,1,3,40.0,1,1,0,1.0,1,1.0,0,1.0,9.0,11,2,9,0.182,13,0.846,1,0.917,9.2,12,3,9,0.25,14,0.857,1,0.923,9.1,2019-20,Regular%20Season
1628989,Kevin Huerter,1610612737,ATL,56,19,37,1760.0,35,19,17,0.543,94,0.372,4,0.389,10.2,193,19,174,0.098,305,0.633,13,0.661,7.7,228,38,191,0.167,392,0.582,17,0.608,8.1,2019-20,Regular%20Season
1628995,Kevin Knox II,1610612752,NYK,59,20,39,1095.0,28,8,21,0.286,67,0.418,1,0.424,10.6,156,19,135,0.122,226,0.69,13,0.732,6.0,184,27,156,0.147,281,0.655,14,0.689,6.8,2019-20,Regular%20Season
201567,Kevin Love,1610612739,CLE,56,16,40,1780.0,54,35,18,0.648,163,0.331,8,0.348,6.2,493,144,349,0.292,703,0.701,43,0.747,4.3,547,179,367,0.327,840,0.651,51,0.693,4.5,2019-20,Regular%20Season
1629645,Kevin Porter Jr.,1610612739,CLE,47,14,33,1092.0,22,13,9,0.591,74,0.297,6,0.324,10.9,140,34,106,0.243,208,0.673,21,0.749,6.6,162,47,115,0.29,278,0.583,27,0.645,7.2,2019-20,Regular%20Season
1626172,Kevon Looney,1610612744,GSW,20,6,14,262.0,28,18,10,0.643,55,0.509,4,0.549,5.0,38,15,23,0.395,66,0.576,5,0.623,5.6,66,33,33,0.5,116,0.569,9,0.617,5.4,2019-20,Regular%20Season
203920,Khem Birch,1610612753,ORL,44,17,27,912.0,91,60,32,0.659,203,0.448,3,0.455,5.5,129,41,88,0.318,224,0.576,22,0.639,5.8,220,101,120,0.459,419,0.525,25,0.558,5.7,2019-20,Regular%20Season
203114,Khris Middleton,1610612749,MIL,61,45,16,1818.0,42,16,26,0.381,99,0.424,3,0.438,12.1,331,50,282,0.151,484,0.684,35,0.737,6.9,373,66,308,0.177,568,0.657,38,0.704,7.5,2019-20,Regular%20Season
1629017,Khyri Thomas,1610612765,DET,1,0,1,13.0,1,0,1,0.0,1,1.0,0,1.0,23.7,0,0,0,0.0,0,0.0,0,0.0,0.0,1,0,1,0.0,1,1.0,0,1.0,23.7,2019-20,Regular%20Season
1628961,Kostas Antetokounmpo,1610612747,LAL,2,1,1,14.0,2,1,1,0.5,2,1.0,0,1.0,4.7,1,0,1,0.0,1,1.0,0,1.0,0.0,3,1,2,0.333,3,1.0,0,1.0,3.1,2019-20,Regular%20Season
1627739,Kris Dunn,1610612741,CHI,49,19,30,1258.0,23,10,13,0.435,62,0.371,3,0.39,12.4,163,28,137,0.172,266,0.613,30,0.691,6.6,186,38,150,0.204,322,0.578,33,0.644,7.3,2019-20,Regular%20Season
204001,Kristaps Porzingis,1610612742,DAL,55,30,25,1739.0,95,54,42,0.568,203,0.468,1,0.47,7.5,425,124,300,0.292,627,0.678,59,0.748,4.6,520,178,342,0.342,797,0.652,60,0.706,5.2,2019-20,Regular%20Season
1629065,Ky Bowman,1610612744,GSW,38,7,31,915.0,24,9,15,0.375,59,0.407,3,0.429,15.3,97,12,83,0.124,181,0.536,26,0.626,8.5,121,21,98,0.174,239,0.506,29,0.576,9.9,2019-20,Regular%20Season
1629734,Kyle Alexander,1610612748,MIA,2,0,2,13.0,2,1,1,0.5,4,0.5,0,0.5,3.2,1,0,1,0.0,6,0.167,1,0.2,3.8,3,1,2,0.333,9,0.333,1,0.375,3.4,2019-20,Regular%20Season
203937,Kyle Anderson,1610612763,MEM,65,32,33,1306.0,58,33,25,0.569,133,0.436,5,0.453,8.2,227,37,190,0.163,337,0.674,21,0.718,6.9,285,70,215,0.246,440,0.648,26,0.688,7.2,2019-20,Regular%20Season
1629657,Kyle Guy,1610612758,SAC,1,1,0,6.0,0,0,0,0.0,0,0.0,0,0.0,0.0,1,1,0,1.0,2,0.5,1,1.0,2.7,1,1,0,1.0,2,0.5,1,1.0,2.7,2019-20,Regular%20Season
2594,Kyle Korver,1610612749,MIL,48,37,11,820.0,14,3,11,0.214,26,0.538,3,0.609,18.3,103,18,85,0.175,182,0.566,15,0.617,7.7,117,21,96,0.179,204,0.574,18,0.629,8.9,2019-20,Regular%20Season
1628398,Kyle Kuzma,1610612747,LAL,60,45,15,1517.0,52,21,30,0.404,100,0.52,1,0.525,8.2,221,53,166,0.24,352,0.628,30,0.686,6.7,273,74,196,0.271,430,0.635,31,0.684,7.0,2019-20,Regular%20Season
200768,Kyle Lowry,1610612761,TOR,57,40,17,2063.0,32,9,23,0.281,128,0.25,4,0.258,13.1,255,47,208,0.184,475,0.537,49,0.599,7.8,287,56,231,0.195,598,0.48,53,0.527,8.4,2019-20,Regular%20Season
203124,Kyle O'Quinn,1610612755,PHI,27,18,9,307.0,34,22,12,0.647,66,0.515,1,0.523,6.2,82,25,57,0.305,130,0.631,9,0.678,4.7,116,47,69,0.405,186,0.624,10,0.659,5.1,2019-20,Regular%20Season
202681,Kyrie Irving,1610612751,BKN,20,8,12,658.0,22,10,12,0.455,46,0.478,2,0.5,10.6,81,7,74,0.086,128,0.633,9,0.681,8.6,103,17,86,0.165,174,0.592,11,0.632,9.0,2019-20,Regular%20Season
200746,LaMarcus Aldridge,1610612759,SAS,52,22,30,1717.0,101,67,35,0.663,210,0.481,4,0.49,5.9,284,76,207,0.268,486,0.584,51,0.653,6.4,385,143,242,0.371,680,0.566,55,0.616,6.3,2019-20,Regular%20Season
202498,Lance Thomas,1610612751,BKN,6,3,3,96.0,2,0,2,0.0,8,0.25,1,0.286,18.2,11,0,11,0.0,14,0.786,0,0.786,6.4,13,0,13,0.0,19,0.684,1,0.722,8.2,2019-20,Regular%20Season
1629013,Landry Shamet,1610612746,LAC,45,30,15,1229.0,6,4,2,0.667,29,0.207,1,0.214,6.8,94,13,81,0.138,158,0.595,12,0.644,9.9,100,17,83,0.17,181,0.552,13,0.595,9.7,2019-20,Regular%20Season
204038,Langston Galloway,1610612765,DET,59,18,41,1554.0,33,5,27,0.152,68,0.485,1,0.493,14.6,115,18,96,0.157,202,0.569,20,0.632,10.6,148,23,123,0.155,266,0.556,21,0.604,11.5,2019-20,Regular%20Season
1626204,Larry Nance Jr.,1610612739,CLE,55,16,39,1452.0,106,82,23,0.774,239,0.444,5,0.453,4.7,303,74,228,0.244,454,0.667,28,0.711,4.9,409,156,251,0.381,657,0.623,33,0.655,4.9,2019-20,Regular%20Season
1628374,Lauri Markkanen,1610612741,CHI,50,18,32,1492.0,60,38,20,0.633,148,0.405,1,0.408,5.2,253,60,194,0.237,386,0.655,21,0.693,5.5,313,98,214,0.313,505,0.62,22,0.648,5.5,2019-20,Regular%20Season
2544,LeBron James,1610612747,LAL,67,50,17,2316.0,66,39,25,0.591,178,0.371,7,0.386,7.5,459,78,381,0.17,642,0.715,31,0.751,6.9,525,117,406,0.223,783,0.67,38,0.705,6.9,2019-20,Regular%20Season
1629022,Lonnie Walker IV,1610612759,SAS,50,23,27,890.0,23,10,14,0.435,57,0.404,3,0.426,10.8,113,12,100,0.106,168,0.673,13,0.729,6.5,136,22,114,0.162,220,0.618,16,0.667,7.3,2019-20,Regular%20Season
1628366,Lonzo Ball,1610612740,NOP,62,26,36,1985.0,68,32,36,0.471,171,0.398,4,0.407,9.1,304,52,250,0.171,454,0.67,34,0.724,7.0,372,84,286,0.226,611,0.609,38,0.649,7.4,2019-20,Regular%20Season
101150,Lou Williams,1610612746,LAC,63,43,20,1810.0,31,16,15,0.516,84,0.369,3,0.383,13.0,170,21,149,0.124,252,0.675,10,0.702,9.4,201,37,164,0.184,330,0.609,13,0.634,10.0,2019-20,Regular%20Season
1629663,Louis King,1610612765,DET,6,2,4,41.0,1,1,0,1.0,4,0.25,0,0.25,5.9,9,2,7,0.222,11,0.818,2,1.0,6.0,10,3,7,0.3,14,0.714,2,0.833,6.0,2019-20,Regular%20Season
201601,Luc Mbah a Moute,1610612745,HOU,2,1,1,19.0,1,1,0,1.0,2,0.5,0,0.5,2.3,1,0,1,0.0,1,1.0,0,1.0,9.7,2,1,1,0.5,2,1.0,0,1.0,6.0,2019-20,Regular%20Season
1629652,Luguentz Dort,1610612760,OKC,31,22,9,722.0,24,11,13,0.458,50,0.48,2,0.5,7.9,57,13,44,0.228,103,0.553,6,0.588,10.6,81,24,57,0.296,148,0.547,8,0.579,9.8,2019-20,Regular%20Season
1629029,Luka Doncic,1610612742,DAL,59,34,25,1973.0,76,43,30,0.566,187,0.406,2,0.411,8.3,468,71,398,0.152,681,0.687,62,0.756,5.5,544,114,428,0.21,848,0.642,64,0.694,5.9,2019-20,Regular%20Season
1629677,Luka Samanic,1610612759,SAS,3,1,2,48.0,1,1,0,1.0,5,0.2,0,0.2,5.8,9,1,8,0.111,14,0.643,3,0.818,7.1,10,2,8,0.2,19,0.526,3,0.625,7.0,2019-20,Regular%20Season
1628379,Luke Kennard,1610612765,DET,27,11,16,888.0,9,6,3,0.667,28,0.321,0,0.321,9.7,89,6,83,0.067,156,0.571,17,0.64,8.3,98,12,86,0.122,183,0.536,17,0.59,8.5,2019-20,Regular%20Season
1628436,Luke Kornet,1610612741,CHI,30,11,19,521.0,22,13,8,0.591,49,0.449,5,0.5,5.0,62,25,37,0.403,119,0.521,12,0.579,5.0,84,38,45,0.452,164,0.512,17,0.571,5.0,2019-20,Regular%20Season
1627763,Malcolm Brogdon,1610612754,IND,51,32,19,1612.0,46,24,23,0.522,111,0.414,4,0.43,12.8,216,44,172,0.204,357,0.605,30,0.661,8.2,262,68,195,0.26,466,0.562,34,0.606,9.1,2019-20,Regular%20Season
1626259,Malcolm Miller,1610612761,TOR,8,8,0,89.0,2,2,0,1.0,6,0.333,0,0.333,2.8,14,3,11,0.214,23,0.609,1,0.636,7.0,16,5,11,0.313,28,0.571,1,0.593,6.5,2019-20,Regular%20Season
1627736,Malik Beasley,1610612750,MIN,46,26,20,1083.0,18,13,5,0.722,59,0.305,2,0.316,10.5,130,16,114,0.123,197,0.66,20,0.734,8.0,148,29,119,0.196,247,0.599,22,0.658,8.3,2019-20,Regular%20Season
1628370,Malik Monk,1610612766,CHA,49,17,32,1065.0,27,11,16,0.407,58,0.466,1,0.474,10.9,125,11,113,0.088,195,0.641,17,0.702,6.6,152,22,129,0.145,250,0.608,18,0.655,7.3,2019-20,Regular%20Season
201188,Marc Gasol,1610612761,TOR,43,34,9,1145.0,31,12,19,0.387,79,0.392,3,0.408,8.1,242,56,185,0.231,409,0.592,37,0.651,5.5,273,68,204,0.249,470,0.581,40,0.635,5.8,2019-20,Regular%20Season
201158,Marco Belinelli,1610612759,SAS,44,20,24,738.0,7,3,4,0.429,21,0.333,1,0.35,10.1,90,6,84,0.067,132,0.682,12,0.75,7.7,97,9,88,0.093,149,0.651,13,0.713,7.9,2019-20,Regular%20Season
202694,Marcus Morris Sr.,1610612746,LAC,62,26,36,1936.0,59,27,33,0.458,147,0.401,6,0.418,10.2,252,49,203,0.194,407,0.619,36,0.679,6.9,311,76,236,0.244,535,0.581,42,0.631,7.5,2019-20,Regular%20Season
203935,Marcus Smart,1610612738,BOS,57,37,20,1839.0,42,22,20,0.524,110,0.382,7,0.408,10.9,183,49,132,0.268,298,0.614,30,0.683,8.6,225,71,152,0.316,401,0.561,37,0.618,9.0,2019-20,Regular%20Season
1629621,Marial Shayok,1610612755,PHI,4,2,2,28.0,1,1,0,1.0,1,1.0,0,1.0,10.9,6,3,3,0.5,9,0.667,1,0.75,13.4,7,4,3,0.571,10,0.7,1,0.778,13.0,2019-20,Regular%20Season
1626209,Mario Hezonja,1610612757,POR,46,20,26,789.0,30,11,18,0.367,72,0.417,0,0.417,10.4,154,25,128,0.162,239,0.644,19,0.7,5.7,184,36,146,0.196,291,0.632,19,0.676,6.4,2019-20,Regular%20Season
1628365,Markelle Fultz,1610612753,ORL,69,31,38,1927.0,41,24,16,0.585,114,0.36,6,0.38,9.3,197,41,157,0.208,365,0.54,41,0.608,7.3,238,65,173,0.273,477,0.499,47,0.553,7.7,2019-20,Regular%20Season
202693,Markieff Morris,1610612747,LAL,55,20,35,1155.0,40,17,21,0.425,91,0.44,3,0.455,7.5,175,38,137,0.217,286,0.612,27,0.676,6.5,215,55,158,0.256,363,0.592,30,0.646,6.7,2019-20,Regular%20Season
1629741,Marko Guduric,1610612763,MEM,33,13,20,420.0,14,7,6,0.5,29,0.483,0,0.483,12.1,59,15,44,0.254,78,0.756,6,0.819,7.2,73,22,50,0.301,106,0.689,6,0.73,8.1,2019-20,Regular%20Season
1629716,Marques Bolden,1610612739,CLE,1,0,1,3.0,0,0,0,0.0,0,0.0,0,0.0,0.0,2,2,0,1.0,2,1.0,0,1.0,3.1,2,2,0,1.0,2,1.0,0,1.0,3.1,2019-20,Regular%20Season
1627737,Marquese Chriss,1610612744,GSW,59,15,44,1196.0,114,83,31,0.728,260,0.438,4,0.445,5.3,251,82,168,0.327,447,0.562,42,0.62,4.7,365,165,199,0.452,671,0.544,46,0.584,4.9,2019-20,Regular%20Season
1628963,Marvin Bagley III,1610612758,SAC,13,2,11,334.0,29,22,7,0.759,77,0.377,1,0.382,5.5,68,18,49,0.265,102,0.667,9,0.731,4.2,97,40,56,0.412,175,0.554,10,0.588,4.6,2019-20,Regular%20Season
101107,Marvin Williams,1610612749,MIL,55,21,34,1060.0,29,17,13,0.586,69,0.42,4,0.446,8.8,148,31,118,0.209,245,0.604,24,0.67,6.3,177,48,131,0.271,308,0.575,28,0.632,6.7,2019-20,Regular%20Season
203486,Mason Plumlee,1610612743,DEN,60,38,22,1045.0,98,72,26,0.735,232,0.422,9,0.439,4.8,219,66,152,0.301,366,0.598,31,0.654,4.5,317,138,178,0.435,578,0.548,40,0.589,4.6,2019-20,Regular%20Season
1629680,Matisse Thybulle,1610612755,PHI,51,33,18,1102.0,44,17,27,0.386,74,0.595,4,0.629,10.3,63,7,56,0.111,111,0.568,12,0.636,10.6,107,24,83,0.224,183,0.585,16,0.641,10.5,2019-20,Regular%20Season
1629760,Matt Mooney,1610612739,CLE,2,0,2,16.0,0,0,0,0.0,0,0.0,0,0.0,0.0,3,1,2,0.333,4,0.75,0,0.75,4.7,3,1,2,0.333,4,0.75,0,0.75,4.7,2019-20,Regular%20Season
1629744,Matt Thomas,1610612761,TOR,29,21,8,382.0,9,4,5,0.444,24,0.375,1,0.391,15.7,51,9,42,0.176,88,0.58,12,0.671,8.9,60,13,47,0.217,111,0.541,13,0.612,10.0,2019-20,Regular%20Season
203521,Matthew Dellavedova,1610612739,CLE,40,15,25,667.0,18,5,13,0.278,39,0.462,2,0.486,14.6,57,9,47,0.158,104,0.548,14,0.633,9.4,75,14,60,0.187,143,0.524,16,0.591,10.6,2019-20,Regular%20Season
203090,Maurice Harkless,1610612752,NYK,61,39,22,1408.0,55,29,26,0.527,117,0.47,5,0.491,6.4,185,36,147,0.195,264,0.701,17,0.749,7.0,240,65,173,0.271,366,0.656,22,0.698,6.8,2019-20,Regular%20Season
1629622,Max Strus,1610612741,CHI,1,0,1,5.0,1,1,0,1.0,1,1.0,0,1.0,4.8,0,0,0,0.0,0,0.0,0,0.0,0.0,1,1,0,1.0,1,1.0,0,1.0,4.8,2019-20,Regular%20Season
1628467,Maxi Kleber,1610612742,DAL,72,40,32,1832.0,111,73,37,0.658,253,0.439,5,0.448,6.9,269,82,187,0.305,460,0.585,52,0.659,5.6,380,155,224,0.408,671,0.566,57,0.619,6.0,2019-20,Regular%20Season
1628982,Melvin Frazier Jr.,1610612753,ORL,8,3,5,93.0,2,1,1,0.5,3,0.667,1,1.0,1.4,8,2,6,0.25,15,0.533,1,0.571,8.9,10,3,7,0.3,18,0.556,2,0.625,7.4,2019-20,Regular%20Season
203086,Meyers Leonard,1610612748,MIA,48,33,15,989.0,30,19,11,0.633,101,0.297,2,0.303,10.1,230,49,181,0.213,344,0.669,19,0.708,4.7,260,68,192,0.262,425,0.612,21,0.644,5.3,2019-20,Regular%20Season
1629662,Mfiondu Kabengele,1610612746,LAC,8,6,2,53.0,1,0,1,0.0,7,0.143,1,0.167,8.2,10,2,8,0.2,16,0.625,0,0.625,3.5,11,2,9,0.182,23,0.478,1,0.5,3.9,2019-20,Regular%20Season
203487,Michael Carter-Williams,1610612753,ORL,41,18,23,771.0,46,23,21,0.5,96,0.479,4,0.5,7.7,101,17,86,0.168,169,0.598,14,0.652,7.7,147,40,107,0.272,261,0.563,18,0.605,7.7,2019-20,Regular%20Season
1626187,Michael Frazier II,1610612745,HOU,4,2,2,62.0,1,1,0,1.0,2,0.5,0,0.5,4.2,9,0,9,0.0,15,0.6,2,0.692,9.3,10,1,9,0.1,17,0.588,2,0.667,8.7,2019-20,Regular%20Season
203077,Michael Kidd-Gilchrist,1610612742,DAL,21,9,12,255.0,14,10,4,0.714,35,0.4,1,0.412,6.2,53,15,38,0.283,86,0.616,5,0.654,6.0,67,25,42,0.373,119,0.563,6,0.593,6.0,2019-20,Regular%20Season
1629008,Michael Porter Jr.,1610612743,DEN,51,33,18,880.0,66,50,16,0.758,152,0.434,1,0.437,5.6,193,39,154,0.202,284,0.68,23,0.739,4.3,259,89,170,0.344,417,0.621,24,0.659,4.7,2019-20,Regular%20Season
1628969,Mikal Bridges,1610612756,PHX,71,34,37,1978.0,65,30,35,0.462,128,0.508,4,0.524,10.6,217,57,159,0.263,355,0.611,27,0.662,7.4,282,87,194,0.309,471,0.599,31,0.641,8.1,2019-20,Regular%20Season
201144,Mike Conley,1610612762,UTA,43,24,19,1274.0,33,10,20,0.303,85,0.388,6,0.418,14.5,118,17,102,0.144,190,0.621,16,0.678,9.4,151,27,122,0.179,272,0.555,22,0.604,10.4,2019-20,Regular%20Season
203488,Mike Muscala,1610612760,OKC,39,19,20,554.0,16,11,5,0.688,48,0.333,2,0.348,7.2,92,29,63,0.315,174,0.529,24,0.613,5.6,108,40,68,0.37,219,0.493,26,0.56,5.8,2019-20,Regular%20Season
203118,Mike Scott,1610612755,PHI,66,37,29,1185.0,65,40,26,0.615,174,0.374,8,0.392,5.6,183,45,138,0.246,281,0.651,26,0.718,6.9,248,85,164,0.343,438,0.566,34,0.614,6.6,2019-20,Regular%20Season
1628970,Miles Bridges,1610612766,CHA,64,23,41,1976.0,88,39,47,0.443,203,0.433,4,0.442,8.8,272,60,212,0.221,409,0.665,29,0.716,6.1,360,99,259,0.275,581,0.62,33,0.657,6.7,2019-20,Regular%20Season
1629011,Mitchell Robinson,1610612752,NYK,61,20,41,1412.0,186,147,39,0.79,369,0.504,13,0.522,4.6,242,89,152,0.368,439,0.551,48,0.619,5.9,428,236,191,0.551,787,0.544,61,0.59,5.3,2019-20,Regular%20Season
1629671,Miye Oni,1610612762,UTA,7,3,4,103.0,5,2,3,0.4,9,0.556,1,0.625,12.5,12,3,9,0.25,20,0.6,1,0.632,5.3,17,5,12,0.294,29,0.586,2,0.63,7.4,2019-20,Regular%20Season
1628964,Mo Bamba,1610612753,ORL,62,30,32,878.0,100,74,27,0.74,231,0.433,5,0.442,3.8,202,57,145,0.282,365,0.553,34,0.61,3.5,302,131,172,0.434,568,0.532,39,0.571,3.6,2019-20,Regular%20Season
1628420,Monte Morris,1610612743,DEN,56,34,22,1347.0,24,5,19,0.208,72,0.333,6,0.364,16.7,113,18,95,0.159,173,0.653,10,0.693,10.9,137,23,114,0.168,244,0.561,16,0.601,11.9,2019-20,Regular%20Season
1626149,Montrezl Harrell,1610612746,LAC,63,44,19,1749.0,163,123,40,0.755,367,0.444,9,0.455,4.2,282,89,192,0.316,528,0.534,42,0.58,5.8,445,212,232,0.476,870,0.511,51,0.543,5.2,2019-20,Regular%20Season
1629021,Moritz Wagner,1610612764,WAS,44,15,29,828.0,56,43,13,0.768,146,0.384,4,0.394,5.1,163,45,119,0.276,269,0.606,23,0.663,4.5,219,88,132,0.402,395,0.554,27,0.595,4.7,2019-20,Regular%20Season
1629650,Moses Brown,1610612757,POR,6,3,3,31.0,3,3,0,1.0,12,0.25,1,0.273,2.8,11,2,9,0.182,16,0.688,1,0.733,3.7,14,5,9,0.357,25,0.56,2,0.609,3.5,2019-20,Regular%20Season
1628539,Mychal Mulder,1610612744,GSW,7,3,4,204.0,3,1,2,0.333,3,1.0,0,1.0,26.5,20,3,17,0.15,43,0.465,8,0.571,6.8,23,4,19,0.174,46,0.5,8,0.605,9.4,2019-20,Regular%20Season
1626167,Myles Turner,1610612754,IND,62,37,25,1826.0,86,52,34,0.605,185,0.465,5,0.478,6.2,321,99,224,0.308,628,0.511,76,0.582,4.6,407,151,258,0.371,795,0.512,81,0.57,5.0,2019-20,Regular%20Season
1629642,Nassir Little,1610612757,POR,36,17,19,470.0,31,21,10,0.677,82,0.378,0,0.378,6.6,77,19,58,0.247,119,0.647,9,0.7,5.4,108,40,68,0.37,191,0.565,9,0.593,5.8,2019-20,Regular%20Season
1628513,Naz Mitrou-Long,1610612754,IND,3,1,2,42.0,0,0,0,0.0,1,0.0,0,0.0,0.0,7,3,4,0.429,12,0.583,3,0.778,8.7,7,3,4,0.429,13,0.538,3,0.7,8.7,2019-20,Regular%20Season
1629675,Naz Reid,1610612750,MIN,26,8,18,487.0,34,24,10,0.706,95,0.358,2,0.366,4.3,90,27,63,0.3,170,0.529,29,0.638,4.3,124,51,73,0.411,250,0.496,31,0.566,4.3,2019-20,Regular%20Season
202357,Nemanja Bjelica,1610612758,SAC,69,30,39,1938.0,109,77,29,0.706,224,0.487,6,0.5,5.8,339,100,239,0.295,549,0.617,42,0.669,5.0,448,177,268,0.395,742,0.604,48,0.646,5.2,2019-20,Regular%20Season
203457,Nerlens Noel,1610612760,OKC,60,37,23,1107.0,91,61,30,0.67,233,0.391,5,0.399,6.3,209,70,139,0.335,389,0.537,35,0.59,5.2,300,131,169,0.437,602,0.498,40,0.534,5.6,2019-20,Regular%20Season
1629651,Nic Claxton,1610612751,BKN,14,5,9,185.0,19,13,6,0.684,49,0.388,3,0.413,4.8,25,8,17,0.32,45,0.556,5,0.625,3.3,44,21,23,0.477,89,0.494,8,0.543,3.9,2019-20,Regular%20Season
1629638,Nickeil Alexander-Walker,1610612740,NOP,38,16,22,527.0,9,3,6,0.333,33,0.273,0,0.273,11.1,75,12,63,0.16,139,0.54,20,0.63,5.6,84,15,69,0.179,171,0.491,20,0.556,6.2,2019-20,Regular%20Season
201587,Nicolas Batum,1610612766,CHA,21,6,15,471.0,22,10,11,0.455,39,0.564,2,0.595,10.8,72,19,53,0.264,109,0.661,7,0.706,6.1,94,29,64,0.309,140,0.671,9,0.718,7.1,2019-20,Regular%20Season
1629740,Nicolo Melli,1610612740,NOP,51,24,27,930.0,37,20,17,0.541,95,0.389,4,0.407,8.8,139,44,95,0.317,239,0.582,21,0.638,5.3,176,64,112,0.364,324,0.543,25,0.589,6.0,2019-20,Regular%20Season
1628430,Nigel Williams-Goss,1610612762,UTA,4,3,1,35.0,2,1,1,0.5,2,1.0,0,1.0,16.9,4,2,2,0.5,9,0.444,2,0.571,6.5,6,3,3,0.5,10,0.6,2,0.75,9.9,2019-20,Regular%20Season
203999,Nikola Jokic,1610612743,DEN,73,46,27,2335.0,166,124,41,0.747,361,0.46,9,0.472,5.5,545,180,365,0.33,867,0.629,84,0.696,4.3,711,304,406,0.428,1184,0.601,93,0.652,4.6,2019-20,Regular%20Season
202696,Nikola Vucevic,1610612753,ORL,62,28,34,1998.0,140,93,45,0.664,275,0.509,1,0.511,5.0,533,175,353,0.328,768,0.694,67,0.76,4.3,673,268,398,0.398,1018,0.661,68,0.708,4.4,2019-20,Regular%20Season
203943,Noah Vonleh,1610612743,DEN,32,13,19,358.0,37,23,13,0.622,71,0.521,2,0.536,4.9,87,28,59,0.322,151,0.576,18,0.654,3.5,124,51,72,0.411,216,0.574,20,0.633,3.9,2019-20,Regular%20Season
1626181,Norman Powell,1610612761,TOR,48,36,12,1372.0,26,8,17,0.308,66,0.394,2,0.406,11.0,162,33,128,0.204,271,0.598,20,0.645,7.7,188,41,145,0.218,329,0.571,22,0.612,8.2,2019-20,Regular%20Season
203658,Norvel Pelle,1610612755,PHI,19,8,11,222.0,20,18,2,0.9,60,0.333,2,0.345,3.1,52,23,29,0.442,91,0.571,5,0.605,4.3,72,41,31,0.569,147,0.49,7,0.514,4.0,2019-20,Regular%20Season
1628384,OG Anunoby,1610612761,TOR,67,49,18,2025.0,80,42,35,0.525,196,0.408,4,0.417,8.5,282,65,217,0.23,449,0.628,42,0.693,6.0,362,107,252,0.296,615,0.589,46,0.636,6.5,2019-20,Regular%20Season
1629016,Omari Spellman,1610612750,MIN,48,10,38,884.0,77,47,29,0.61,145,0.531,3,0.542,6.8,142,43,98,0.303,233,0.609,21,0.67,5.5,219,90,127,0.411,364,0.602,24,0.644,6.0,2019-20,Regular%20Season
1629052,Oshae Brissett,1610612761,TOR,12,10,2,115.0,9,6,3,0.667,22,0.409,0,0.409,10.1,17,3,14,0.176,24,0.708,1,0.739,6.2,26,9,17,0.346,44,0.591,1,0.605,7.6,2019-20,Regular%20Season
203490,Otto Porter Jr.,1610612741,CHI,14,5,9,331.0,13,8,5,0.615,30,0.433,2,0.464,7.7,35,5,30,0.143,67,0.522,8,0.593,9.4,48,13,35,0.271,94,0.511,10,0.571,8.9,2019-20,Regular%20Season
200782,P.J. Tucker,1610612745,HOU,72,44,28,2467.0,112,47,64,0.42,309,0.362,10,0.375,10.1,364,100,262,0.275,649,0.561,67,0.625,6.0,476,147,326,0.309,915,0.52,77,0.568,7.0,2019-20,Regular%20Season
1629023,P.J. Washington,1610612766,CHA,56,22,34,1722.0,58,31,27,0.534,168,0.345,6,0.358,8.1,258,82,177,0.318,414,0.623,37,0.684,5.5,316,113,204,0.358,555,0.569,43,0.617,6.0,2019-20,Regular%20Season
1628408,PJ Dozier,1610612743,DEN,19,10,9,352.0,10,3,7,0.3,28,0.357,2,0.385,13.3,45,10,35,0.222,72,0.625,7,0.692,7.7,55,13,42,0.236,95,0.579,9,0.64,8.7,2019-20,Regular%20Season
1627783,Pascal Siakam,1610612761,TOR,59,45,14,2072.0,64,38,26,0.594,181,0.354,9,0.372,8.3,367,72,293,0.196,573,0.64,51,0.703,6.0,431,110,319,0.255,722,0.597,60,0.651,6.3,2019-20,Regular%20Season
1626192,Pat Connaughton,1610612749,MIL,62,49,13,1194.0,59,35,23,0.593,122,0.484,6,0.509,7.5,223,51,172,0.229,343,0.65,35,0.724,5.6,282,86,195,0.305,462,0.61,41,0.67,6.0,2019-20,Regular%20Season
201976,Patrick Beverley,1610612746,LAC,51,38,13,1342.0,57,18,38,0.316,105,0.543,3,0.559,11.5,209,24,183,0.115,346,0.604,35,0.672,7.5,266,42,221,0.158,444,0.599,38,0.655,8.4,2019-20,Regular%20Season
1627775,Patrick McCaw,1610612761,TOR,30,21,9,796.0,19,9,10,0.474,42,0.452,2,0.475,12.4,65,15,50,0.231,117,0.556,13,0.625,8.3,84,24,60,0.286,155,0.542,15,0.6,9.2,2019-20,Regular%20Season
202335,Patrick Patterson,1610612746,LAC,45,31,14,692.0,35,13,20,0.371,59,0.593,2,0.614,8.9,116,23,93,0.198,166,0.699,15,0.768,6.2,151,36,113,0.238,220,0.686,17,0.744,6.8,2019-20,Regular%20Season
201988,Patty Mills,1610612759,SAS,51,20,31,1140.0,21,3,18,0.143,40,0.525,1,0.538,22.9,82,8,74,0.098,131,0.626,12,0.689,12.0,103,11,92,0.107,171,0.602,13,0.652,14.2,2019-20,Regular%20Season
202331,Paul George,1610612746,LAC,48,34,14,1419.0,24,11,13,0.458,84,0.286,5,0.304,12.2,248,55,194,0.222,391,0.634,34,0.695,6.2,272,66,207,0.243,466,0.584,39,0.637,6.7,2019-20,Regular%20Season
200794,Paul Millsap,1610612743,DEN,51,30,21,1240.0,98,63,34,0.643,223,0.439,8,0.456,5.7,195,43,152,0.221,323,0.604,23,0.65,5.9,293,106,186,0.362,523,0.56,31,0.596,5.8,2019-20,Regular%20Season
1628778,Paul Watson,1610612761,TOR,8,5,3,84.0,2,1,1,0.5,6,0.333,0,0.333,25.6,15,6,9,0.4,17,0.882,0,0.882,6.9,17,7,10,0.412,20,0.85,0,0.85,9.1,2019-20,Regular%20Season
1626188,Quinn Cook,1610612747,LAL,26,15,11,404.0,11,3,9,0.273,29,0.379,1,0.393,17.2,40,5,36,0.125,53,0.755,6,0.851,9.6,51,8,45,0.157,79,0.646,7,0.708,11.6,2019-20,Regular%20Season
1629683,Quinndary Weatherspoon,1610612759,SAS,6,2,4,55.0,1,1,0,1.0,3,0.333,1,0.5,9.6,6,2,4,0.333,14,0.429,1,0.462,6.9,7,3,4,0.429,17,0.412,2,0.467,7.3,2019-20,Regular%20Season
1629628,RJ Barrett,1610612752,NYK,55,17,38,1684.0,50,21,29,0.42,134,0.373,6,0.391,9.4,229,36,194,0.157,366,0.626,35,0.692,6.2,279,57,223,0.204,477,0.585,41,0.64,6.8,2019-20,Regular%20Season
200765,Rajon Rondo,1610612747,LAL,44,35,9,921.0,23,9,14,0.391,63,0.365,3,0.383,10.1,119,9,110,0.076,176,0.676,6,0.7,9.0,142,18,124,0.127,232,0.612,9,0.637,9.2,2019-20,Regular%20Season
203526,Raul Neto,1610612755,PHI,37,21,16,525.0,11,2,9,0.182,27,0.407,2,0.44,13.3,50,7,43,0.14,90,0.556,11,0.633,9.0,61,9,52,0.148,116,0.526,13,0.592,9.8,2019-20,Regular%20Season
1629730,Rayjon Tucker,1610612762,UTA,12,7,5,117.0,3,0,3,0.0,11,0.273,1,0.3,5.7,17,1,16,0.059,25,0.68,3,0.773,6.7,20,1,19,0.05,34,0.588,4,0.667,6.5,2019-20,Regular%20Season
203493,Reggie Bullock Jr.,1610612752,NYK,27,9,18,647.0,13,3,10,0.231,32,0.406,0,0.406,13.5,55,9,46,0.164,91,0.604,12,0.696,8.3,68,12,56,0.176,115,0.591,12,0.66,9.3,2019-20,Regular%20Season
202704,Reggie Jackson,1610612746,LAC,29,14,15,709.0,17,6,11,0.353,42,0.405,0,0.405,10.8,75,9,66,0.12,125,0.6,12,0.664,8.1,92,15,77,0.163,166,0.554,12,0.597,8.6,2019-20,Regular%20Season
1626158,Richaun Holmes,1610612758,SAC,43,16,27,1223.0,127,89,38,0.701,266,0.477,8,0.492,4.8,228,87,141,0.382,417,0.547,46,0.615,4.4,355,176,179,0.496,669,0.531,54,0.577,4.5,2019-20,Regular%20Season
201937,Ricky Rubio,1610612756,PHX,64,32,32,1979.0,46,8,38,0.174,108,0.426,0,0.426,16.7,255,36,218,0.141,407,0.627,37,0.689,7.6,301,44,256,0.146,508,0.593,37,0.639,9.0,2019-20,Regular%20Season
203496,Robert Covington,1610612745,HOU,70,27,43,2137.0,63,29,35,0.46,164,0.384,5,0.396,12.2,400,103,297,0.258,647,0.618,72,0.696,5.2,463,132,332,0.285,772,0.6,77,0.666,6.2,2019-20,Regular%20Season
1629057,Robert Williams III,1610612738,BOS,28,19,9,388.0,40,34,6,0.85,72,0.556,1,0.563,5.8,88,27,61,0.307,140,0.629,11,0.682,6.5,128,61,67,0.477,206,0.621,12,0.66,6.3,2019-20,Regular%20Season
201577,Robin Lopez,1610612749,MIL,57,46,11,859.0,56,43,13,0.768,134,0.418,5,0.434,4.4,105,40,65,0.381,188,0.559,23,0.636,5.9,161,83,78,0.516,313,0.514,28,0.565,5.4,2019-20,Regular%20Season
1629066,Rodions Kurucs,1610612751,BKN,40,16,24,642.0,25,15,9,0.6,65,0.385,2,0.397,7.1,112,19,94,0.17,197,0.569,15,0.615,5.9,137,34,103,0.248,252,0.544,17,0.583,6.1,2019-20,Regular%20Season
203918,Rodney Hood,1610612757,POR,20,8,12,586.0,10,6,3,0.6,20,0.5,0,0.5,6.9,62,11,51,0.177,102,0.608,9,0.667,8.9,72,17,54,0.236,120,0.6,9,0.649,8.6,2019-20,Regular%20Season
203585,Rodney McGruder,1610612746,LAC,45,32,13,795.0,29,13,16,0.448,75,0.387,1,0.392,9.8,122,29,91,0.238,195,0.626,19,0.693,6.8,151,42,107,0.278,268,0.563,20,0.609,7.4,2019-20,Regular%20Season
1629641,Romeo Langford,1610612738,BOS,18,13,5,290.0,15,11,4,0.733,41,0.366,0,0.366,6.6,26,10,16,0.385,45,0.578,4,0.634,8.2,41,21,20,0.512,84,0.488,4,0.513,7.6,2019-20,Regular%20Season
1626178,Rondae Hollis-Jefferson,1610612761,TOR,58,41,17,1112.0,110,72,38,0.655,262,0.42,13,0.442,4.7,172,46,128,0.267,289,0.595,20,0.639,5.8,282,118,166,0.418,536,0.526,33,0.561,5.4,2019-20,Regular%20Season
1626220,Royce O'Neale,1610612762,UTA,71,44,27,2049.0,27,9,17,0.333,79,0.342,4,0.36,12.1,362,77,285,0.213,585,0.619,55,0.683,5.8,389,86,302,0.221,643,0.605,59,0.666,6.3,2019-20,Regular%20Season
200752,Rudy Gay,1610612759,SAS,66,29,37,1429.0,61,36,24,0.59,127,0.48,3,0.492,7.7,291,57,235,0.196,424,0.686,41,0.76,5.2,352,93,259,0.264,522,0.674,44,0.736,5.6,2019-20,Regular%20Season
203497,Rudy Gobert,1610612762,UTA,68,42,26,2333.0,230,155,77,0.674,518,0.444,8,0.451,4.5,686,166,520,0.242,1072,0.64,88,0.697,3.9,916,321,597,0.35,1554,0.589,96,0.628,4.0,2019-20,Regular%20Season
1629060,Rui Hachimura,1610612764,WAS,48,15,33,1444.0,78,42,36,0.538,193,0.404,7,0.419,7.1,216,45,170,0.208,371,0.582,26,0.626,5.2,294,87,206,0.296,538,0.546,33,0.582,5.7,2019-20,Regular%20Season
201566,Russell Westbrook,1610612745,HOU,57,36,21,2049.0,100,57,42,0.57,283,0.353,5,0.36,7.4,351,65,287,0.185,503,0.698,24,0.733,7.6,451,122,329,0.271,749,0.602,29,0.626,7.6,2019-20,Regular%20Season
201583,Ryan Anderson,1610612745,HOU,2,1,1,14.0,0,0,0,0.0,0,0.0,0,0.0,0.0,7,1,6,0.143,2,3.5,0,3.5,0.5,7,1,6,0.143,2,3.5,0,3.5,0.5,2019-20,Regular%20Season
1627853,Ryan Arcidiacono,1610612741,CHI,43,14,29,765.0,20,2,18,0.1,40,0.5,1,0.513,15.6,90,8,82,0.089,140,0.643,12,0.703,7.8,110,10,100,0.091,177,0.621,13,0.671,9.2,2019-20,Regular%20Season
1629151,Ryan Broekhoff,1610612755,PHI,13,7,6,173.0,5,2,3,0.4,13,0.385,1,0.417,3.8,37,10,27,0.27,55,0.673,6,0.755,6.2,42,12,30,0.286,66,0.636,7,0.712,5.9,2019-20,Regular%20Season
1629635,Sekou Doumbouya,1610612765,DET,32,9,23,718.0,20,12,8,0.6,70,0.286,4,0.303,9.7,98,12,86,0.122,174,0.563,17,0.624,5.2,118,24,94,0.203,238,0.496,21,0.544,6.0,2019-20,Regular%20Season
1628400,Semi Ojeleye,1610612738,BOS,51,35,16,881.0,26,11,15,0.423,76,0.342,4,0.361,13.3,119,28,91,0.235,173,0.688,12,0.739,8.5,145,39,106,0.269,235,0.617,16,0.662,9.4,2019-20,Regular%20Season
201586,Serge Ibaka,1610612761,TOR,53,38,15,1429.0,112,79,33,0.705,248,0.452,7,0.465,5.3,330,105,225,0.318,562,0.587,61,0.659,4.4,442,184,258,0.416,786,0.562,68,0.616,4.6,2019-20,Regular%20Season
203552,Seth Curry,1610612742,DAL,54,32,22,1365.0,24,6,16,0.25,44,0.545,0,0.545,18.1,111,10,101,0.09,187,0.594,13,0.638,9.6,135,16,117,0.119,230,0.587,13,0.622,11.0,2019-20,Regular%20Season
203894,Shabazz Napier,1610612764,WAS,53,16,37,1290.0,26,10,16,0.385,61,0.426,2,0.441,10.2,132,17,116,0.129,211,0.626,21,0.695,8.4,158,27,132,0.171,270,0.585,23,0.64,8.7,2019-20,Regular%20Season
1628983,Shai Gilgeous-Alexander,1610612760,OKC,70,43,27,2428.0,47,18,29,0.383,155,0.303,6,0.315,13.4,365,76,288,0.208,546,0.668,42,0.724,6.6,412,94,317,0.228,662,0.622,48,0.671,7.4,2019-20,Regular%20Season
1629003,Shake Milton,1610612755,PHI,28,15,13,666.0,15,7,8,0.467,32,0.469,2,0.5,9.2,73,13,60,0.178,109,0.67,7,0.716,8.0,88,20,68,0.227,138,0.638,9,0.682,8.2,2019-20,Regular%20Season
1629044,Shamorie Ponds,1610612761,TOR,1,1,0,6.0,0,0,0,0.0,0,0.0,0,0.0,0.0,1,0,1,0.0,1,1.0,0,1.0,7.3,1,0,1,0.0,1,1.0,0,1.0,7.3,2019-20,Regular%20Season
1627885,Shaquille Harrison,1610612741,CHI,32,9,23,435.0,22,7,15,0.318,44,0.5,0,0.5,11.2,64,14,49,0.219,92,0.696,10,0.78,8.1,86,21,64,0.244,132,0.652,10,0.705,8.9,2019-20,Regular%20Season
1628414,Sindarius Thornwell,1610612740,NOP,2,0,2,35.0,0,0,0,0.0,1,0.0,0,0.0,0.0,4,1,3,0.25,6,0.667,1,0.8,7.3,4,1,3,0.25,6,0.667,1,0.8,7.3,2019-20,Regular%20Season
1627746,Skal Labissiere,1610612737,ATL,32,13,19,561.0,65,45,20,0.692,149,0.436,5,0.451,4.7,104,25,78,0.24,213,0.488,31,0.571,4.8,169,70,98,0.414,354,0.477,36,0.531,4.7,2019-20,Regular%20Season
203524,Solomon Hill,1610612748,MIA,52,25,27,1013.0,29,16,13,0.552,75,0.387,2,0.397,11.2,136,27,109,0.199,218,0.624,20,0.687,6.2,165,43,122,0.261,284,0.581,22,0.63,7.1,2019-20,Regular%20Season
203915,Spencer Dinwiddie,1610612751,BKN,62,28,34,1938.0,32,13,20,0.406,89,0.36,3,0.372,12.2,189,34,154,0.18,318,0.594,30,0.656,8.8,221,47,174,0.213,407,0.543,33,0.591,9.3,2019-20,Regular%20Season
1626169,Stanley Johnson,1610612761,TOR,13,10,3,113.0,7,3,4,0.429,18,0.389,2,0.438,11.5,30,6,24,0.2,41,0.732,1,0.75,7.4,37,9,28,0.243,56,0.661,3,0.698,8.2,2019-20,Regular%20Season
1629742,Stanton Kidd,1610612762,UTA,2,2,0,9.0,0,0,0,0.0,1,0.0,0,0.0,0.0,3,0,3,0.0,3,1.0,0,1.0,2.2,3,0,3,0.0,4,0.75,0,0.75,2.2,2019-20,Regular%20Season
201939,Stephen Curry,1610612744,GSW,5,1,4,139.0,4,3,1,0.75,7,0.571,0,0.571,10.7,22,5,17,0.227,34,0.647,2,0.688,8.9,26,8,18,0.308,41,0.634,2,0.667,9.2,2019-20,Regular%20Season
1628425,Sterling Brown,1610612749,MIL,40,31,9,702.0,31,14,17,0.452,82,0.378,1,0.383,8.7,152,18,134,0.118,237,0.641,29,0.731,5.5,183,32,151,0.175,304,0.602,30,0.668,6.0,2019-20,Regular%20Season
203500,Steven Adams,1610612760,OKC,62,39,23,1679.0,207,153,53,0.739,426,0.486,6,0.493,4.7,376,146,228,0.388,621,0.605,62,0.673,4.9,583,299,281,0.513,1026,0.568,68,0.609,4.8,2019-20,Regular%20Season
1629004,Svi Mykhailiuk,1610612765,DET,47,15,32,1112.0,17,2,15,0.118,45,0.378,1,0.386,16.2,86,13,73,0.151,138,0.623,8,0.662,10.3,103,15,88,0.146,180,0.572,9,0.602,11.3,2019-20,Regular%20Season
1628388,T.J. Leaf,1610612754,IND,22,14,8,206.0,23,15,9,0.652,39,0.59,1,0.605,4.6,48,12,34,0.25,72,0.667,5,0.716,4.8,71,27,43,0.38,107,0.664,6,0.703,4.8,2019-20,Regular%20Season
204456,T.J. McConnell,1610612754,IND,65,41,24,1234.0,38,11,25,0.289,80,0.475,2,0.487,12.2,151,14,140,0.093,241,0.627,18,0.677,9.0,189,25,165,0.132,317,0.596,20,0.636,9.6,2019-20,Regular%20Season
203933,T.J. Warren,1610612754,IND,66,41,25,2170.0,68,46,21,0.676,162,0.42,2,0.425,6.6,212,45,166,0.212,332,0.639,19,0.677,8.2,280,91,187,0.325,480,0.583,21,0.61,7.8,2019-20,Regular%20Season
1629605,Tacko Fall,1610612738,BOS,6,4,2,30.0,1,1,0,1.0,6,0.167,0,0.167,2.8,14,4,10,0.286,17,0.824,1,0.875,4.3,15,5,10,0.333,22,0.682,1,0.714,4.2,2019-20,Regular%20Season
201959,Taj Gibson,1610612752,NYK,58,20,38,988.0,111,74,36,0.667,223,0.498,6,0.512,5.7,156,44,112,0.282,281,0.555,31,0.624,6.1,267,118,148,0.442,485,0.551,37,0.596,5.9,2019-20,Regular%20Season
1629659,Talen Horton-Tucker,1610612747,LAL,3,0,3,70.0,2,0,2,0.0,4,0.5,1,0.667,15.5,5,1,4,0.2,11,0.455,1,0.5,5.2,7,1,6,0.143,14,0.5,2,0.583,8.1,2019-20,Regular%20Season
1629745,Tariq Owens,1610612756,PHX,2,0,2,12.0,2,0,2,0.0,2,1.0,0,1.0,6.5,1,0,1,0.0,2,0.5,0,0.5,5.9,3,0,3,0.0,4,0.75,0,0.75,6.3,2019-20,Regular%20Season
1627752,Taurean Prince,1610612751,BKN,64,30,34,1857.0,50,16,33,0.32,123,0.407,2,0.413,12.3,331,72,258,0.218,527,0.628,39,0.678,5.6,381,88,291,0.231,611,0.624,41,0.668,6.5,2019-20,Regular%20Season
1629611,Terance Mann,1610612746,LAC,24,16,8,309.0,10,5,5,0.5,28,0.357,3,0.4,7.3,45,5,40,0.111,76,0.592,5,0.634,6.2,55,10,45,0.182,99,0.556,8,0.604,6.4,2019-20,Regular%20Season
1629056,Terence Davis,1610612761,TOR,67,48,19,1184.0,50,19,30,0.38,105,0.476,2,0.485,10.2,184,30,152,0.163,272,0.676,20,0.73,7.5,234,49,182,0.209,371,0.631,22,0.67,8.1,2019-20,Regular%20Season
1628390,Terrance Ferguson,1610612760,OKC,39,23,16,958.0,23,6,17,0.261,44,0.523,3,0.561,10.6,51,12,40,0.235,101,0.505,10,0.56,7.4,74,18,57,0.243,144,0.514,13,0.565,8.4,2019-20,Regular%20Season
203082,Terrence Ross,1610612753,ORL,67,30,37,1831.0,13,4,8,0.308,48,0.271,4,0.295,14.6,209,30,179,0.144,318,0.657,23,0.708,7.6,222,34,187,0.153,358,0.62,27,0.671,8.0,2019-20,Regular%20Season
1626179,Terry Rozier,1610612766,CHA,60,21,39,2047.0,49,17,32,0.347,124,0.395,8,0.422,12.8,221,35,185,0.158,338,0.654,22,0.699,8.3,270,52,217,0.193,459,0.588,30,0.629,9.1,2019-20,Regular%20Season
200757,Thabo Sefolosha,1610612745,HOU,36,24,12,409.0,21,9,12,0.429,51,0.412,5,0.457,8.9,71,12,58,0.169,96,0.74,8,0.807,5.1,92,21,70,0.228,140,0.657,13,0.724,6.0,2019-20,Regular%20Season
201152,Thaddeus Young,1610612741,CHI,64,22,42,1591.0,94,56,38,0.596,219,0.429,2,0.433,7.6,221,50,171,0.226,336,0.658,22,0.704,6.3,315,106,209,0.337,521,0.605,24,0.634,6.7,2019-20,Regular%20Season
203648,Thanasis Antetokounmpo,1610612749,MIL,10,8,2,105.0,12,9,3,0.75,21,0.571,0,0.571,6.0,12,1,11,0.083,18,0.667,2,0.75,9.5,24,10,14,0.417,39,0.615,2,0.649,7.7,2019-20,Regular%20Season
1629033,Theo Pinson,1610612752,NYK,23,13,10,295.0,10,3,7,0.3,24,0.417,1,0.435,15.3,44,11,31,0.25,84,0.524,7,0.571,6.0,54,14,38,0.259,107,0.505,8,0.545,7.8,2019-20,Regular%20Season
1628418,Thomas Bryant,1610612764,WAS,46,15,31,1147.0,98,64,33,0.653,181,0.541,6,0.56,6.6,233,67,166,0.288,371,0.628,28,0.679,5.2,331,131,199,0.396,540,0.613,34,0.654,5.6,2019-20,Regular%20Season
1627748,Thon Maker,1610612765,DET,45,14,31,689.0,54,31,23,0.574,129,0.419,4,0.432,6.5,113,22,91,0.195,209,0.541,23,0.608,6.0,167,53,114,0.317,324,0.515,27,0.562,6.2,2019-20,Regular%20Season
204025,Tim Frazier,1610612765,DET,18,7,11,290.0,9,4,5,0.444,19,0.474,0,0.474,9.3,24,1,23,0.042,50,0.48,2,0.5,8.9,33,5,28,0.152,69,0.478,2,0.493,9.0,2019-20,Regular%20Season
203501,Tim Hardaway Jr.,1610612742,DAL,64,35,29,1914.0,25,11,15,0.44,75,0.333,1,0.338,16.3,201,30,169,0.149,320,0.628,22,0.674,7.3,226,41,184,0.181,389,0.581,23,0.617,8.4,2019-20,Regular%20Season
1627789,Timothe Luwawu-Cabarrot,1610612751,BKN,40,18,22,786.0,29,11,18,0.379,64,0.453,2,0.468,10.4,98,23,75,0.235,170,0.576,20,0.653,7.8,127,34,93,0.268,229,0.555,22,0.614,8.4,2019-20,Regular%20Season
202699,Tobias Harris,1610612755,PHI,72,43,29,2469.0,69,49,18,0.71,239,0.289,11,0.303,6.1,426,89,338,0.209,666,0.64,65,0.709,5.3,495,138,356,0.279,871,0.568,76,0.623,5.4,2019-20,Regular%20Season
203107,Tomas Satoransky,1610612741,CHI,62,21,41,1793.0,76,33,43,0.434,177,0.429,3,0.437,9.9,178,30,148,0.169,275,0.647,17,0.69,8.2,254,63,191,0.248,439,0.579,20,0.606,8.7,2019-20,Regular%20Season
1628396,Tony Bradley,1610612762,UTA,54,34,20,634.0,111,72,37,0.649,219,0.507,2,0.512,4.2,156,43,112,0.276,231,0.675,19,0.736,4.3,267,115,149,0.431,426,0.627,21,0.659,4.3,2019-20,Regular%20Season
203503,Tony Snell,1610612765,DET,51,16,35,1429.0,9,5,4,0.556,31,0.29,4,0.333,15.9,101,19,82,0.188,188,0.537,23,0.612,8.4,110,24,86,0.218,214,0.514,27,0.588,9.1,2019-20,Regular%20Season
1628470,Torrey Craig,1610612743,DEN,50,33,17,1033.0,63,41,22,0.651,142,0.444,8,0.47,6.9,126,21,105,0.167,198,0.636,22,0.716,5.8,189,62,127,0.328,326,0.58,30,0.639,6.2,2019-20,Regular%20Season
1629027,Trae Young,1610612737,ATL,59,18,41,2105.0,32,11,20,0.344,131,0.244,6,0.256,11.8,223,30,193,0.135,360,0.619,30,0.676,9.2,255,41,213,0.161,484,0.527,36,0.569,9.5,2019-20,Regular%20Season
1629682,Tremont Waters,1610612738,BOS,6,4,2,100.0,0,0,0,0.0,3,0.0,0,0.0,0.0,12,3,9,0.25,17,0.706,0,0.706,11.7,12,3,9,0.25,20,0.6,0,0.6,11.7,2019-20,Regular%20Season
1626203,Treveon Graham,1610612737,ATL,48,20,28,887.0,51,30,21,0.588,120,0.425,2,0.432,6.0,99,28,71,0.283,189,0.524,26,0.607,6.1,150,58,92,0.387,302,0.497,28,0.547,6.1,2019-20,Regular%20Season
2772,Trevor Ariza,1610612757,POR,51,21,30,1443.0,34,13,19,0.382,86,0.395,3,0.41,9.9,208,38,170,0.183,301,0.691,26,0.756,7.0,242,51,189,0.211,366,0.661,29,0.718,7.4,2019-20,Regular%20Season
203504,Trey Burke,1610612742,DAL,21,10,11,387.0,16,1,13,0.063,32,0.5,1,0.516,17.5,34,3,31,0.088,49,0.694,5,0.773,9.6,50,4,44,0.08,80,0.625,6,0.676,11.9,2019-20,Regular%20Season
1626168,Trey Lyles,1610612759,SAS,60,26,34,1238.0,71,46,25,0.648,154,0.461,6,0.48,6.7,283,48,235,0.17,434,0.652,38,0.715,4.7,354,94,260,0.266,569,0.622,44,0.674,5.1,2019-20,Regular%20Season
202684,Tristan Thompson,1610612739,CLE,57,19,38,1722.0,226,161,65,0.712,511,0.442,15,0.456,5.4,351,92,260,0.262,537,0.654,41,0.708,5.6,577,253,325,0.438,1030,0.56,56,0.592,5.5,2019-20,Regular%20Season
1628972,Troy Brown Jr.,1610612764,WAS,69,24,45,1782.0,76,37,39,0.487,187,0.406,5,0.418,8.8,307,73,234,0.238,492,0.624,50,0.695,6.0,383,110,273,0.287,650,0.589,55,0.644,6.6,2019-20,Regular%20Season
203584,Troy Daniels,1610612743,DEN,25,19,6,351.0,12,5,7,0.417,18,0.667,0,0.667,7.7,40,5,35,0.125,52,0.769,5,0.851,5.9,52,10,42,0.192,69,0.754,5,0.813,6.3,2019-20,Regular%20Season
1629660,Ty Jerome,1610612756,PHX,25,12,13,292.0,7,1,5,0.143,22,0.318,1,0.333,12.6,39,14,25,0.359,54,0.722,3,0.765,8.1,46,15,30,0.326,72,0.639,4,0.676,8.7,2019-20,Regular%20Season
1629076,Tyler Cook,1610612743,DEN,8,1,7,38.0,6,6,0,1.0,9,0.667,0,0.667,2.6,8,2,6,0.25,11,0.727,2,0.889,3.5,14,8,6,0.571,18,0.778,2,0.875,3.1,2019-20,Regular%20Season
1629639,Tyler Herro,1610612748,MIA,52,31,21,1458.0,16,6,10,0.375,61,0.262,2,0.271,12.8,208,30,175,0.144,342,0.608,42,0.693,6.1,224,36,185,0.161,388,0.577,44,0.651,6.6,2019-20,Regular%20Season
204020,Tyler Johnson,1610612751,BKN,31,12,19,592.0,18,3,15,0.167,43,0.419,0,0.419,11.0,57,11,47,0.193,104,0.548,11,0.613,8.5,75,14,62,0.187,145,0.517,11,0.56,9.1,2019-20,Regular%20Season
203092,Tyler Zeller,1610612759,SAS,1,0,1,4.0,3,2,1,0.667,4,0.75,1,1.0,2.3,1,0,1,0.0,1,1.0,0,1.0,1.6,4,2,2,0.5,5,0.8,1,1.0,2.1,2019-20,Regular%20Season
1627820,Tyrone Wallace,1610612737,ATL,9,2,7,123.0,3,1,2,0.333,8,0.375,0,0.375,10.5,19,7,12,0.368,26,0.731,0,0.731,9.0,22,8,14,0.364,32,0.688,0,0.688,9.2,2019-20,Regular%20Season
2199,Tyson Chandler,1610612745,HOU,20,13,7,206.0,25,16,9,0.64,46,0.543,1,0.556,6.9,41,15,25,0.366,72,0.569,10,0.661,4.7,66,31,34,0.47,117,0.564,11,0.623,5.6,2019-20,Regular%20Season
1626145,Tyus Jones,1610612763,MEM,49,27,22,955.0,9,2,7,0.222,31,0.29,2,0.31,12.5,94,8,85,0.085,132,0.712,9,0.764,8.6,103,10,92,0.097,162,0.636,11,0.682,9.0,2019-20,Regular%20Season
2617,Udonis Haslem,1610612748,MIA,4,3,1,44.0,1,1,0,1.0,11,0.091,0,0.091,7.6,15,3,12,0.2,20,0.75,1,0.789,3.3,16,4,12,0.25,29,0.552,1,0.571,3.6,2019-20,Regular%20Season
1629724,Vic Law,1610612753,ORL,4,1,3,56.0,2,1,1,0.5,10,0.2,0,0.2,2.7,9,0,9,0.0,17,0.529,1,0.563,4.4,11,1,10,0.091,26,0.423,1,0.44,4.1,2019-20,Regular%20Season
203506,Victor Oladipo,1610612754,IND,18,11,7,505.0,9,1,8,0.111,20,0.45,1,0.474,16.0,66,22,44,0.333,122,0.541,14,0.611,7.0,75,23,52,0.307,142,0.528,15,0.591,8.0,2019-20,Regular%20Season
1713,Vince Carter,1610612737,ATL,49,16,33,738.0,18,8,10,0.444,68,0.265,4,0.281,14.1,106,25,80,0.236,184,0.576,21,0.65,5.8,124,33,90,0.266,232,0.534,25,0.599,7.0,2019-20,Regular%20Season
1629738,Vincent Poirier,1610612738,BOS,14,11,3,104.0,12,8,3,0.667,33,0.364,0,0.364,4.4,30,9,21,0.3,48,0.625,5,0.698,4.7,42,17,24,0.405,74,0.568,5,0.609,4.6,2019-20,Regular%20Season
1628427,Vlatko Cancar,1610612743,DEN,6,4,2,33.0,5,5,0,1.0,9,0.556,0,0.556,3.3,5,3,2,0.6,8,0.625,1,0.714,7.6,10,8,2,0.8,16,0.625,1,0.667,5.5,2019-20,Regular%20Season
201961,Wayne Ellington,1610612752,NYK,29,8,21,494.0,4,2,2,0.5,10,0.4,0,0.4,10.8,61,9,52,0.148,86,0.709,3,0.735,9.8,65,11,54,0.169,94,0.691,3,0.714,9.8,2019-20,Regular%20Season
1628976,Wendell Carter Jr.,1610612741,CHI,43,15,28,1256.0,139,110,28,0.791,318,0.437,7,0.447,4.7,266,97,168,0.365,460,0.578,47,0.644,4.4,405,207,196,0.511,758,0.534,54,0.575,4.5,2019-20,Regular%20Season
1629117,Wenyen Gabriel,1610612757,POR,22,6,16,211.0,21,13,8,0.619,46,0.457,0,0.457,6.0,29,6,23,0.207,57,0.509,6,0.569,6.4,50,19,31,0.38,97,0.515,6,0.549,6.2,2019-20,Regular%20Season
1628411,Wes Iwundu,1610612753,ORL,49,22,27,937.0,24,16,9,0.667,66,0.364,2,0.375,7.1,107,22,86,0.206,196,0.546,16,0.594,5.5,131,38,95,0.29,259,0.506,18,0.544,5.8,2019-20,Regular%20Season
202083,Wesley Matthews,1610612749,MIL,61,47,14,1523.0,22,7,15,0.318,65,0.338,0,0.338,11.8,143,24,119,0.168,226,0.633,20,0.694,8.7,165,31,134,0.188,287,0.575,20,0.618,9.1,2019-20,Regular%20Season
203115,Will Barton,1610612743,DEN,58,38,20,1916.0,76,49,27,0.645,162,0.469,2,0.475,7.2,289,47,243,0.163,466,0.62,37,0.674,5.7,365,96,270,0.263,606,0.602,39,0.644,6.0,2019-20,Regular%20Season
1629739,William Howard,1610612745,HOU,1,0,1,12.0,0,0,0,0.0,1,0.0,0,0.0,0.0,2,0,2,0.0,2,1.0,0,1.0,3.9,2,0,2,0.0,2,1.0,0,1.0,3.9,2019-20,Regular%20Season
1626161,Willie Cauley-Stein,1610612742,DAL,53,15,38,1082.0,84,53,31,0.631,187,0.449,7,0.467,7.5,226,74,152,0.327,388,0.582,35,0.64,4.9,310,127,183,0.41,556,0.558,42,0.603,5.6,2019-20,Regular%20Season
1626195,Willy Hernangomez,1610612766,CHA,27,7,20,356.0,42,33,11,0.786,80,0.525,0,0.525,6.0,91,26,65,0.286,134,0.679,5,0.705,4.1,133,59,76,0.444,205,0.649,5,0.665,4.7,2019-20,Regular%20Season
201163,Wilson Chandler,1610612751,BKN,35,16,19,734.0,11,9,3,0.818,52,0.212,3,0.224,5.4,134,33,101,0.246,209,0.641,22,0.717,4.9,145,42,104,0.29,249,0.582,25,0.647,4.9,2019-20,Regular%20Season
1627812,Yogi Ferrell,1610612758,SAC,31,11,20,404.0,6,3,3,0.5,17,0.353,0,0.353,9.9,43,3,40,0.07,64,0.672,3,0.705,8.9,49,6,43,0.122,80,0.613,3,0.636,9.0,2019-20,Regular%20Season
1629139,Yuta Watanabe,1610612763,MEM,12,6,6,82.0,7,3,4,0.429,15,0.467,3,0.583,10.5,13,7,6,0.538,24,0.542,1,0.565,6.8,20,10,10,0.5,39,0.513,4,0.571,8.1,2019-20,Regular%20Season
1628380,Zach Collins,1610612757,POR,11,8,3,290.0,25,16,9,0.64,55,0.455,1,0.463,4.6,44,14,30,0.318,76,0.579,6,0.629,5.0,69,30,39,0.435,125,0.552,7,0.585,4.9,2019-20,Regular%20Season
203897,Zach LaVine,1610612741,CHI,59,20,39,2054.0,41,12,30,0.293,162,0.253,5,0.261,12.0,248,28,220,0.113,368,0.674,27,0.727,6.8,289,40,250,0.138,496,0.583,32,0.623,7.5,2019-20,Regular%20Season
1629668,Zach Norvell Jr.,1610612744,GSW,3,1,2,30.0,0,0,0,0.0,2,0.0,0,0.0,0.0,6,1,5,0.167,8,0.75,1,0.857,10.6,6,1,5,0.167,8,0.75,1,0.857,10.6,2019-20,Regular%20Season
1629015,Zhaire Smith,1610612755,PHI,2,1,1,18.0,0,0,0,0.0,1,0.0,1,0.0,0.0,2,0,2,0.0,3,0.667,1,1.0,16.3,2,0,2,0.0,4,0.5,2,1.0,16.3,2019-20,Regular%20Season
1629627,Zion Williamson,1610612740,NOP,22,11,11,618.0,62,42,19,0.677,138,0.449,2,0.456,5.2,82,21,62,0.256,125,0.656,9,0.707,7.5,144,63,81,0.438,246,0.585,11,0.613,6.6,2019-20,Regular%20Season
1629597,Zylan Cheatham,1610612740,NOP,3,1,2,45.0,3,2,1,0.667,9,0.333,0,0.333,6.0,6,1,5,0.167,11,0.545,1,0.6,6.5,9,3,6,0.333,20,0.45,1,0.474,6.3,2019-20,Regular%20Season
1628988,Aaron Holiday,1610612754,IND,3,0,3,59.0,1,0,1,0.0,3,0.333,1,0.5,23.0,4,1,3,0.25,7,0.571,0,0.571,5.3,5,1,4,0.2,10,0.5,1,0.556,8.8,2019-20,Playoffs
1627846,Abdel Nader,1610612760,OKC,3,0,3,25.0,1,1,0,1.0,2,0.5,0,0.5,3.6,2,0,2,0.0,8,0.25,2,0.333,6.7,3,1,2,0.333,10,0.3,2,0.375,5.7,2019-20,Playoffs
201143,Al Horford,1610612755,PHI,4,0,4,128.0,9,7,2,0.778,17,0.529,1,0.563,5.9,20,10,9,0.5,39,0.513,5,0.588,5.3,29,17,11,0.586,56,0.518,6,0.58,5.5,2019-20,Playoffs
202692,Alec Burks,1610612755,PHI,4,0,4,95.0,7,4,3,0.571,15,0.467,0,0.467,9.6,8,0,8,0.0,16,0.5,2,0.571,8.3,15,4,11,0.267,30,0.5,2,0.536,8.9,2019-20,Playoffs
1627936,Alex Caruso,1610612747,LAL,20,16,4,481.0,15,4,11,0.267,36,0.417,2,0.441,15.2,33,4,29,0.121,70,0.471,6,0.516,11.8,48,8,40,0.167,101,0.475,8,0.516,12.9,2019-20,Playoffs
2738,Andre Iguodala,1610612748,MIA,19,13,6,392.0,11,4,7,0.364,29,0.379,0,0.379,12.3,42,7,35,0.167,58,0.724,2,0.75,7.2,53,11,42,0.208,83,0.639,2,0.654,8.3,2019-20,Playoffs
1629014,Anfernee Simons,1610612757,POR,3,0,3,68.0,1,0,1,0.0,2,0.5,0,0.5,18.2,10,3,7,0.3,13,0.769,0,0.769,7.2,11,3,8,0.273,15,0.733,0,0.733,8.2,2019-20,Playoffs
203076,Anthony Davis,1610612747,LAL,21,16,5,769.0,55,39,15,0.709,105,0.524,4,0.545,5.0,149,48,99,0.322,220,0.677,19,0.741,4.7,204,87,114,0.426,321,0.636,23,0.685,4.8,2019-20,Playoffs
1628499,Antonius Cleveland,1610612742,DAL,1,0,1,7.0,1,1,0,1.0,1,1.0,0,1.0,0.8,0,0,0,0.0,0,0.0,0,0.0,0.0,1,1,0,1.0,1,1.0,0,1.0,0.8,2019-20,Playoffs
203085,Austin Rivers,1610612745,HOU,8,4,4,175.0,2,0,2,0.0,5,0.4,0,0.4,18.2,28,1,27,0.036,43,0.651,2,0.683,10.2,30,1,29,0.033,46,0.652,2,0.682,10.7,2019-20,Playoffs
1629168,BJ Johnson,1610612753,ORL,1,0,1,4.0,0,0,0,0.0,0,0.0,0,0.0,0.0,2,0,2,0.0,2,1.0,0,1.0,3.5,2,0,2,0.0,2,1.0,0,1.0,3.5,2019-20,Playoffs
1628389,Bam Adebayo,1610612748,MIA,19,13,6,687.0,47,35,12,0.745,123,0.382,4,0.395,5.6,149,38,109,0.255,204,0.73,22,0.819,5.5,196,73,121,0.372,318,0.616,26,0.671,5.5,2019-20,Playoffs
203463,Ben McLemore,1610612745,HOU,6,3,3,94.0,2,1,1,0.5,6,0.333,1,0.4,13.9,9,1,8,0.111,20,0.45,1,0.474,9.2,11,2,9,0.182,26,0.423,2,0.458,10.0,2019-20,Playoffs
1626246,Boban Marjanovic,1610612742,DAL,6,2,4,82.0,6,4,2,0.667,16,0.375,1,0.4,3.4,29,4,25,0.138,38,0.763,3,0.829,4.7,35,8,27,0.229,51,0.686,4,0.745,4.5,2019-20,Playoffs
1629626,Bol Bol,1610612743,DEN,3,0,3,17.0,3,1,2,0.333,3,1.0,0,1.0,12.6,2,1,1,0.5,4,0.5,0,0.5,3.8,5,2,3,0.4,7,0.714,0,0.714,9.1,2019-20,Playoffs
202954,Brad Wanamaker,1610612738,BOS,14,9,5,243.0,2,0,2,0.0,15,0.133,1,0.143,10.0,32,3,29,0.094,56,0.571,4,0.615,8.2,34,3,31,0.088,70,0.486,5,0.523,8.3,2019-20,Playoffs
201572,Brook Lopez,1610612749,MIL,10,5,5,328.0,19,13,6,0.684,34,0.559,0,0.559,5.7,36,8,28,0.222,62,0.581,5,0.632,7.0,55,21,34,0.382,89,0.618,5,0.655,6.5,2019-20,Playoffs
203998,Bruno Caboclo,1610612745,HOU,2,1,1,7.0,0,0,0,0.0,3,0.0,0,0.0,0.0,3,0,3,0.0,4,0.75,0,0.75,6.8,3,0,3,0.0,5,0.6,0,0.6,6.8,2019-20,Playoffs
203468,CJ McCollum,1610612757,POR,5,1,4,196.0,5,3,2,0.6,15,0.333,0,0.333,12.6,24,3,21,0.125,41,0.585,7,0.706,11.5,29,6,23,0.207,52,0.558,7,0.644,11.7,2019-20,Playoffs
1627747,Caris LeVert,1610612751,BKN,4,0,4,140.0,8,3,5,0.375,14,0.571,0,0.571,7.7,16,1,14,0.063,25,0.64,2,0.696,11.2,24,4,19,0.167,37,0.649,2,0.686,10.0,2019-20,Playoffs
2546,Carmelo Anthony,1610612757,POR,4,1,3,149.0,1,0,1,0.0,10,0.1,1,0.111,2.8,24,2,22,0.083,29,0.828,2,0.889,7.1,25,2,23,0.08,35,0.714,3,0.781,6.9,2019-20,Playoffs
1629035,Carsen Edwards,1610612738,BOS,1,1,0,3.0,0,0,0,0.0,0,0.0,0,0.0,0.0,1,0,1,0.0,2,0.5,1,1.0,6.5,1,0,1,0.0,2,0.5,1,1.0,6.5,2019-20,Playoffs
1628449,Chris Boucher,1610612761,TOR,6,3,3,43.0,3,1,2,0.333,14,0.214,0,0.214,3.0,9,3,6,0.333,17,0.529,1,0.563,5.3,12,4,8,0.333,31,0.387,1,0.4,4.7,2019-20,Playoffs
1629185,Chris Chiozza,1610612751,BKN,2,0,2,45.0,1,1,0,1.0,2,0.5,0,0.5,5.2,5,1,4,0.2,8,0.625,1,0.714,8.3,6,2,4,0.333,10,0.6,1,0.667,7.8,2019-20,Playoffs
1629598,Chris Clemons,1610612745,HOU,2,1,1,8.0,0,0,0,0.0,0,0.0,0,0.0,0.0,2,2,0,1.0,2,1.0,0,1.0,10.0,2,2,0,1.0,2,1.0,0,1.0,10.0,2019-20,Playoffs
101108,Chris Paul,1610612760,OKC,7,3,4,261.0,3,0,3,0.0,7,0.429,1,0.5,13.4,49,7,42,0.143,79,0.62,7,0.681,8.1,52,7,45,0.135,86,0.605,8,0.667,8.4,2019-20,Playoffs
201571,D.J. Augustin,1610612753,ORL,5,1,4,128.0,0,0,0,0.0,3,0.0,0,0.0,0.0,10,0,10,0.0,14,0.714,1,0.769,11.8,10,0,10,0.0,17,0.588,1,0.625,11.8,2019-20,Playoffs
203081,Damian Lillard,1610612757,POR,4,1,3,143.0,1,1,0,1.0,8,0.125,0,0.125,5.5,13,3,10,0.231,27,0.481,6,0.619,11.0,14,4,10,0.286,33,0.424,6,0.519,10.6,2019-20,Playoffs
1628464,Daniel Theis,1610612738,BOS,17,10,7,482.0,32,22,9,0.688,86,0.372,4,0.39,4.7,89,22,67,0.247,151,0.589,15,0.654,5.1,121,44,76,0.364,237,0.511,19,0.555,5.0,2019-20,Playoffs
201568,Danilo Gallinari,1610612760,OKC,7,3,4,212.0,5,3,2,0.6,10,0.5,0,0.5,4.1,33,8,23,0.242,51,0.647,6,0.733,5.6,38,11,25,0.289,60,0.633,6,0.704,5.4,2019-20,Playoffs
201980,Danny Green,1610612747,LAL,20,15,5,497.0,25,14,10,0.56,47,0.532,2,0.556,8.2,41,9,32,0.22,73,0.562,13,0.683,7.5,66,23,42,0.348,118,0.559,15,0.641,7.7,2019-20,Playoffs
1627863,Danuel House Jr.,1610612745,HOU,9,5,4,279.0,10,6,4,0.6,24,0.417,0,0.417,5.4,42,5,37,0.119,67,0.627,7,0.7,6.7,52,11,41,0.212,89,0.584,7,0.634,6.4,2019-20,Playoffs
1629647,Darius Bazley,1610612760,OKC,7,3,4,126.0,2,1,1,0.5,10,0.2,0,0.2,18.1,45,8,37,0.178,61,0.738,5,0.804,3.7,47,9,38,0.191,67,0.701,5,0.758,4.3,2019-20,Playoffs
201960,DeMarre Carroll,1610612745,HOU,1,1,0,4.0,0,0,0,0.0,1,0.0,0,0.0,0.0,3,1,2,0.333,3,1.0,0,1.0,4.3,3,1,2,0.333,3,1.0,0,1.0,4.3,2019-20,Playoffs
1626153,Delon Wright,1610612742,DAL,2,1,1,38.0,1,1,0,1.0,1,1.0,0,1.0,2.2,2,1,1,0.5,2,1.0,0,1.0,9.7,3,2,1,0.667,3,1.0,0,1.0,7.2,2019-20,Playoffs
203471,Dennis Schroder,1610612760,OKC,6,3,3,195.0,2,0,2,0.0,12,0.167,1,0.182,25.5,24,0,24,0.0,34,0.706,1,0.727,10.8,26,0,26,0.0,45,0.578,2,0.605,11.9,2019-20,Playoffs
1627884,Derrick Jones Jr.,1610612748,MIA,7,5,2,71.0,6,6,0,1.0,15,0.4,0,0.4,4.4,6,2,5,0.333,11,0.545,0,0.545,6.3,12,8,5,0.667,25,0.48,0,0.48,5.4,2019-20,Playoffs
203079,Dion Waiters,1610612747,LAL,1,1,0,14.0,0,0,0,0.0,0,0.0,0,0.0,0.0,2,0,2,0.0,2,1.0,0,1.0,11.0,2,0,2,0.0,2,1.0,0,1.0,11.0,2019-20,Playoffs
1628378,Donovan Mitchell,1610612762,UTA,7,3,4,264.0,6,3,3,0.5,19,0.316,2,0.353,9.1,29,7,22,0.241,39,0.744,3,0.806,7.7,35,10,25,0.286,58,0.603,5,0.66,7.9,2019-20,Playoffs
1629743,Donta Hall,1610612751,BKN,2,0,2,14.0,3,3,0,1.0,4,0.75,0,0.75,2.2,2,1,1,0.5,2,1.0,0,1.0,3.9,5,4,1,0.8,6,0.833,0,0.833,2.9,2019-20,Playoffs
1628978,Donte DiVincenzo,1610612749,MIL,10,5,5,165.0,8,4,4,0.5,20,0.4,1,0.421,5.3,24,1,23,0.042,39,0.615,9,0.8,5.4,32,5,27,0.156,58,0.552,10,0.667,5.4,2019-20,Playoffs
1627827,Dorian Finney-Smith,1610612742,DAL,6,2,4,191.0,12,6,6,0.5,21,0.571,1,0.6,5.7,22,9,13,0.409,44,0.5,10,0.647,5.0,34,15,19,0.441,64,0.531,11,0.642,5.2,2019-20,Playoffs
203926,Doug McDermott,1610612754,IND,2,0,2,30.0,0,0,0,0.0,1,0.0,0,0.0,0.0,3,1,2,0.333,4,0.75,0,0.75,2.5,3,1,2,0.333,5,0.6,0,0.6,2.5,2019-20,Playoffs
1629130,Duncan Robinson,1610612748,MIA,20,14,6,578.0,5,0,5,0.0,6,0.833,0,0.833,13.0,53,14,39,0.264,91,0.582,4,0.609,7.1,58,14,44,0.241,96,0.604,4,0.63,7.6,2019-20,Playoffs
2730,Dwight Howard,1610612747,LAL,17,12,5,281.0,32,24,8,0.75,78,0.41,2,0.421,3.7,51,17,34,0.333,100,0.51,11,0.573,4.1,83,41,42,0.494,169,0.491,13,0.532,3.9,2019-20,Playoffs
1629058,Dzanan Musa,1610612751,BKN,2,0,2,35.0,1,0,1,0.0,2,0.5,0,0.5,6.6,2,2,0,1.0,5,0.4,0,0.4,5.2,3,2,1,0.667,7,0.429,0,0.429,5.6,2019-20,Playoffs
1628410,Edmond Sumner,1610612754,IND,1,0,1,27.0,1,0,1,0.0,1,1.0,0,1.0,30.6,5,0,5,0.0,6,0.833,0,0.833,7.9,6,0,6,0.0,7,0.857,0,0.857,11.7,2019-20,Playoffs
1626144,Emmanuel Mudiay,1610612762,UTA,3,2,1,34.0,1,0,1,0.0,3,0.333,1,0.5,2.3,5,0,5,0.0,8,0.625,0,0.625,7.1,6,0,6,0.0,11,0.545,1,0.6,6.3,2019-20,Playoffs
202683,Enes Freedom,1610612738,BOS,9,6,3,99.0,19,14,5,0.737,40,0.475,1,0.487,3.8,24,5,19,0.208,33,0.727,1,0.75,4.9,43,19,24,0.442,72,0.597,2,0.614,4.4,2019-20,Playoffs
202339,Eric Bledsoe,1610612749,MIL,9,5,4,267.0,5,2,3,0.4,22,0.227,2,0.25,8.3,36,4,32,0.111,61,0.59,7,0.667,9.2,41,6,35,0.146,82,0.5,9,0.562,9.1,2019-20,Playoffs
201569,Eric Gordon,1610612745,HOU,12,5,7,410.0,6,3,3,0.5,21,0.286,0,0.286,13.4,26,4,22,0.154,49,0.531,3,0.565,10.4,32,7,25,0.219,69,0.464,3,0.485,10.9,2019-20,Playoffs
101141,Ersan Ilyasova,1610612749,MIL,2,2,0,16.0,0,0,0,0.0,1,0.0,0,0.0,0.0,4,0,4,0.0,4,1.0,0,1.0,5.6,4,0,4,0.0,5,0.8,0,0.8,5.6,2019-20,Playoffs
203095,Evan Fournier,1610612753,ORL,5,1,4,171.0,3,1,2,0.333,5,0.6,0,0.6,15.4,17,0,17,0.0,23,0.739,1,0.773,9.6,20,1,19,0.05,27,0.741,1,0.769,10.5,2019-20,Playoffs
1627832,Fred VanVleet,1610612761,TOR,11,7,4,430.0,5,1,4,0.2,16,0.313,1,0.333,22.7,43,7,36,0.163,63,0.683,5,0.741,9.0,48,8,40,0.167,79,0.608,6,0.658,10.4,2019-20,Playoffs
1627788,Furkan Korkmaz,1610612755,PHI,3,0,3,36.0,0,0,0,0.0,0,0.0,0,0.0,0.0,6,0,6,0.0,8,0.75,1,0.857,6.9,6,0,6,0.0,8,0.75,1,0.857,6.9,2019-20,Playoffs
202066,Garrett Temple,1610612751,BKN,3,0,3,106.0,0,0,0,0.0,4,0.0,0,0.0,0.0,11,1,10,0.091,23,0.478,2,0.524,9.1,11,1,10,0.091,26,0.423,2,0.458,9.1,2019-20,Playoffs
1629109,Gary Clark,1610612753,ORL,5,1,4,144.0,4,4,0,1.0,8,0.5,0,0.5,6.1,24,9,15,0.375,42,0.571,4,0.632,6.0,28,13,15,0.464,50,0.56,4,0.609,6.0,2019-20,Playoffs
203914,Gary Harris,1610612743,DEN,12,5,7,318.0,7,6,2,0.857,14,0.5,0,0.5,9.6,21,6,15,0.286,30,0.7,0,0.7,10.4,28,12,17,0.429,42,0.667,0,0.667,10.2,2019-20,Playoffs
1629018,Gary Trent Jr.,1610612757,POR,5,1,4,153.0,5,1,4,0.2,9,0.556,0,0.556,12.2,5,1,4,0.2,12,0.417,0,0.417,9.1,10,2,8,0.2,21,0.476,0,0.476,10.7,2019-20,Playoffs
201588,George Hill,1610612749,MIL,9,4,5,250.0,5,2,3,0.4,16,0.313,0,0.313,8.1,19,5,14,0.263,34,0.559,0,0.559,5.7,24,7,17,0.292,50,0.48,0,0.48,6.2,2019-20,Playoffs
1627777,Georges Niang,1610612762,UTA,7,3,4,114.0,4,0,4,0.0,6,0.667,0,0.667,17.2,11,3,8,0.273,21,0.524,3,0.611,7.5,15,3,12,0.2,26,0.577,3,0.652,10.1,2019-20,Playoffs
203507,Giannis Antetokounmpo,1610612749,MIL,9,5,4,277.0,27,17,10,0.63,53,0.509,1,0.519,5.6,97,21,76,0.216,130,0.746,9,0.802,5.1,124,38,86,0.306,178,0.697,10,0.738,5.2,2019-20,Playoffs
201609,Goran Dragic,1610612748,MIA,17,12,5,553.0,13,3,10,0.231,38,0.342,2,0.361,12.6,56,9,46,0.161,87,0.644,7,0.7,8.7,69,12,56,0.174,124,0.556,9,0.6,9.4,2019-20,Playoffs
202330,Gordon Hayward,1610612738,BOS,5,3,2,157.0,3,1,2,0.333,5,0.6,0,0.6,6.1,17,5,12,0.294,33,0.515,5,0.607,8.5,20,6,14,0.3,38,0.526,5,0.606,8.1,2019-20,Playoffs
1629684,Grant Williams,1610612738,BOS,11,7,4,117.0,7,5,2,0.714,19,0.368,2,0.412,9.2,19,5,14,0.263,29,0.655,2,0.704,7.1,26,10,16,0.385,47,0.553,4,0.605,7.7,2019-20,Playoffs
1628977,Hamidou Diallo,1610612760,OKC,2,0,2,22.0,2,0,2,0.0,3,0.667,0,0.667,26.2,4,1,3,0.25,6,0.667,0,0.667,5.2,6,1,5,0.167,9,0.667,0,0.667,12.2,2019-20,Playoffs
202355,Hassan Whiteside,1610612757,POR,5,1,4,106.0,7,5,2,0.714,23,0.304,0,0.304,2.8,28,12,16,0.429,49,0.571,5,0.636,4.3,35,17,18,0.486,68,0.515,5,0.556,4.0,2019-20,Playoffs
1627826,Ivica Zubac,1610612746,LAC,13,7,6,320.0,31,25,6,0.806,67,0.463,0,0.463,3.0,62,20,39,0.323,93,0.667,10,0.747,4.2,93,45,45,0.484,156,0.596,10,0.637,3.8,2019-20,Playoffs
2747,JR Smith,1610612747,LAL,2,1,1,10.0,0,0,0,0.0,0,0.0,0,0.0,0.0,2,0,2,0.0,1,2.0,0,2.0,5.7,2,0,2,0.0,1,2.0,0,2.0,5.7,2019-20,Playoffs
203960,JaKarr Sampson,1610612754,IND,4,0,4,50.0,1,0,1,0.0,7,0.143,0,0.143,2.0,12,6,6,0.5,14,0.857,1,0.923,3.8,13,6,7,0.462,19,0.684,1,0.722,3.6,2019-20,Playoffs
203210,JaMychal Green,1610612746,LAC,11,5,6,190.0,13,9,4,0.692,25,0.52,0,0.52,12.3,35,11,24,0.314,47,0.745,1,0.761,4.4,48,20,28,0.417,69,0.696,1,0.706,6.5,2019-20,Playoffs
201580,JaVale McGee,1610612747,LAL,12,9,3,118.0,16,12,4,0.75,36,0.444,0,0.444,4.1,28,3,25,0.107,48,0.583,2,0.609,4.9,44,15,29,0.341,81,0.543,2,0.557,4.6,2019-20,Playoffs
203109,Jae Crowder,1610612748,MIA,21,14,7,660.0,11,4,7,0.364,31,0.355,2,0.379,13.9,106,29,77,0.274,171,0.62,19,0.697,5.9,117,33,84,0.282,197,0.594,21,0.665,6.6,2019-20,Playoffs
1627750,Jamal Murray,1610612743,DEN,19,9,10,753.0,20,7,13,0.35,51,0.392,2,0.408,11.1,72,12,60,0.167,110,0.655,9,0.713,8.0,92,19,73,0.207,158,0.582,11,0.626,8.7,2019-20,Playoffs
203516,James Ennis III,1610612753,ORL,5,1,4,119.0,6,3,3,0.5,19,0.316,1,0.333,10.8,23,2,20,0.087,32,0.719,3,0.793,4.7,29,5,23,0.172,45,0.644,4,0.707,6.0,2019-20,Playoffs
201935,James Harden,1610612745,HOU,12,5,7,448.0,12,4,8,0.333,35,0.343,0,0.343,9.0,55,11,44,0.2,97,0.567,9,0.625,8.5,67,15,52,0.224,129,0.519,9,0.558,8.6,2019-20,Playoffs
201162,Jared Dudley,1610612747,LAL,1,1,0,8.0,0,0,0,0.0,0,0.0,0,0.0,0.0,2,1,1,0.5,2,1.0,0,1.0,7.0,2,1,1,0.5,2,1.0,0,1.0,7.0,2019-20,Playoffs
1629714,Jarrell Brantley,1610612762,UTA,2,2,0,13.0,3,1,2,0.333,5,0.6,0,0.6,9.7,1,0,1,0.0,4,0.25,1,0.333,2.3,4,1,3,0.25,8,0.5,1,0.571,7.8,2019-20,Playoffs
1628386,Jarrett Allen,1610612751,BKN,4,0,4,132.0,17,15,2,0.882,30,0.567,0,0.567,3.6,42,8,34,0.19,49,0.857,1,0.875,4.9,59,23,36,0.39,75,0.787,1,0.797,4.5,2019-20,Playoffs
1629750,Javonte Green,1610612738,BOS,1,1,0,6.0,0,0,0,0.0,0,0.0,0,0.0,0.0,1,0,1,0.0,3,0.333,1,0.5,11.4,1,0,1,0.0,3,0.333,1,0.5,11.4,2019-20,Playoffs
1629121,Jaylen Adams,1610612757,POR,2,0,2,19.0,1,0,1,0.0,1,1.0,0,1.0,10.4,2,0,2,0.0,4,0.5,1,0.667,8.9,3,0,3,0.0,5,0.6,1,0.75,9.4,2019-20,Playoffs
1627759,Jaylen Brown,1610612738,BOS,17,10,7,672.0,24,17,7,0.708,62,0.387,1,0.393,8.4,103,22,81,0.214,170,0.606,15,0.665,6.4,127,39,88,0.307,225,0.564,16,0.608,6.8,2019-20,Playoffs
1629658,Jaylen Hoard,1610612757,POR,3,0,3,41.0,5,2,3,0.4,10,0.5,0,0.5,5.5,4,1,3,0.25,7,0.571,1,0.667,4.8,9,3,6,0.333,17,0.529,1,0.563,5.2,2019-20,Playoffs
1628369,Jayson Tatum,1610612738,BOS,17,10,7,690.0,22,8,14,0.364,71,0.31,2,0.319,9.8,148,23,125,0.155,200,0.74,10,0.779,5.6,170,31,139,0.182,251,0.677,12,0.711,6.1,2019-20,Playoffs
201145,Jeff Green,1610612745,HOU,11,5,6,320.0,5,2,3,0.4,12,0.417,1,0.455,8.9,55,10,45,0.182,94,0.585,7,0.632,6.2,60,12,48,0.2,103,0.583,8,0.632,6.4,2019-20,Playoffs
203924,Jerami Grant,1610612743,DEN,15,7,8,534.0,8,1,7,0.125,24,0.333,0,0.333,19.6,55,12,43,0.218,80,0.688,6,0.743,8.2,63,13,50,0.206,101,0.624,6,0.663,9.6,2019-20,Playoffs
1629725,Jeremiah Martin,1610612751,BKN,2,0,2,18.0,0,0,0,0.0,1,0.0,0,0.0,0.0,3,0,3,0.0,4,0.75,1,1.0,9.5,3,0,3,0.0,5,0.6,1,0.75,9.5,2019-20,Playoffs
202710,Jimmy Butler,1610612748,MIA,21,14,7,806.0,46,27,19,0.587,104,0.442,1,0.447,7.3,90,24,66,0.267,162,0.556,16,0.616,7.0,136,51,85,0.375,261,0.521,17,0.557,7.1,2019-20,Playoffs
203925,Joe Harris,1610612751,BKN,2,0,2,72.0,2,1,1,0.5,8,0.25,0,0.25,15.6,18,4,15,0.222,27,0.667,3,0.75,5.3,20,5,16,0.25,35,0.571,3,0.625,6.2,2019-20,Playoffs
204060,Joe Ingles,1610612762,UTA,6,3,3,205.0,1,0,0,0.0,2,0.5,0,0.5,0.0,23,4,18,0.174,34,0.676,2,0.719,6.7,24,4,18,0.167,36,0.667,2,0.706,6.7,2019-20,Playoffs
203954,Joel Embiid,1610612755,PHI,4,0,4,145.0,11,7,4,0.636,31,0.355,1,0.367,4.6,38,16,22,0.421,71,0.535,9,0.613,4.6,49,23,26,0.469,97,0.505,10,0.563,4.6,2019-20,Playoffs
203903,Jordan Clarkson,1610612762,UTA,7,3,4,200.0,2,1,1,0.5,11,0.182,1,0.2,6.1,22,4,18,0.182,38,0.579,4,0.647,7.6,24,5,19,0.208,48,0.5,5,0.558,7.5,2019-20,Playoffs
1629729,Josh Reaves,1610612742,DAL,1,0,1,7.0,0,0,0,0.0,2,0.0,0,0.0,0.0,2,1,1,0.5,2,1.0,0,1.0,3.2,2,1,1,0.5,4,0.5,0,0.5,3.2,2019-20,Playoffs
1626196,Josh Richardson,1610612755,PHI,4,0,4,144.0,4,3,1,0.75,11,0.364,0,0.364,11.7,11,0,11,0.0,23,0.478,3,0.55,9.3,15,3,12,0.2,34,0.441,3,0.484,9.9,2019-20,Playoffs
1626147,Justin Anderson,1610612751,BKN,3,0,3,28.0,0,0,0,0.0,2,0.0,0,0.0,0.0,8,1,7,0.125,10,0.8,1,0.889,9.8,8,1,7,0.125,12,0.667,1,0.727,9.8,2019-20,Playoffs
203200,Justin Holiday,1610612754,IND,4,0,4,131.0,4,4,0,1.0,8,0.5,0,0.5,3.2,11,2,9,0.182,20,0.55,2,0.611,5.7,15,6,9,0.4,27,0.556,2,0.6,5.0,2019-20,Playoffs
1628382,Justin Jackson,1610612742,DAL,2,0,2,11.0,0,0,0,0.0,2,0.0,0,0.0,0.0,3,0,3,0.0,3,1.0,0,1.0,6.6,3,0,3,0.0,5,0.6,0,0.6,6.6,2019-20,Playoffs
203994,Jusuf Nurkic,1610612757,POR,5,1,4,161.0,14,11,3,0.786,30,0.467,0,0.467,4.2,38,14,25,0.368,65,0.585,8,0.667,3.4,52,25,28,0.481,93,0.559,8,0.612,3.6,2019-20,Playoffs
1629752,Juwan Morgan,1610612762,UTA,6,3,3,85.0,6,3,3,0.5,14,0.429,0,0.429,10.9,15,5,10,0.333,24,0.625,3,0.714,4.3,21,8,13,0.381,37,0.568,3,0.618,6.2,2019-20,Playoffs
202695,Kawhi Leonard,1610612746,LAC,13,7,6,511.0,24,13,11,0.542,55,0.436,2,0.453,8.2,97,23,74,0.237,137,0.708,12,0.776,6.2,121,36,85,0.298,184,0.658,14,0.712,6.6,2019-20,Playoffs
1628966,Keita Bates-Diop,1610612743,DEN,3,0,3,22.0,3,3,0,1.0,3,1.0,0,1.0,3.2,3,1,2,0.333,6,0.5,0,0.5,4.3,6,4,2,0.667,9,0.667,0,0.667,3.7,2019-20,Playoffs
203482,Kelly Olynyk,1610612748,MIA,16,10,6,255.0,13,10,2,0.769,35,0.371,1,0.382,4.8,66,17,49,0.258,105,0.629,11,0.702,5.6,79,27,51,0.342,131,0.603,12,0.664,5.5,2019-20,Playoffs
202689,Kemba Walker,1610612738,BOS,17,10,7,628.0,6,1,4,0.167,26,0.231,2,0.25,13.6,63,14,49,0.222,121,0.521,15,0.594,8.9,69,15,53,0.217,143,0.483,17,0.548,9.3,2019-20,Playoffs
1629134,Kendrick Nunn,1610612748,MIA,12,7,5,210.0,3,1,2,0.333,11,0.273,1,0.3,12.2,29,7,21,0.241,43,0.674,2,0.707,8.4,32,8,23,0.25,54,0.593,3,0.627,8.8,2019-20,Playoffs
203484,Kentavious Caldwell-Pope,1610612747,LAL,19,14,5,546.0,7,2,5,0.286,23,0.304,2,0.333,11.3,35,6,29,0.171,58,0.603,9,0.714,8.4,42,8,34,0.19,80,0.525,11,0.609,8.9,2019-20,Playoffs
203920,Khem Birch,1610612753,ORL,5,1,4,89.0,9,6,3,0.667,19,0.474,0,0.474,9.8,16,6,10,0.375,26,0.615,5,0.762,6.7,25,12,13,0.48,45,0.556,5,0.625,7.8,2019-20,Playoffs
203114,Khris Middleton,1610612749,MIL,10,5,5,355.0,5,2,3,0.4,16,0.313,1,0.333,11.0,64,6,58,0.094,92,0.696,4,0.727,6.4,69,8,61,0.116,106,0.651,5,0.683,6.7,2019-20,Playoffs
204001,Kristaps Porzingis,1610612742,DAL,3,1,2,94.0,3,2,1,0.667,8,0.375,0,0.375,3.8,23,10,13,0.435,44,0.523,6,0.605,3.4,26,12,14,0.462,50,0.52,6,0.591,3.4,2019-20,Playoffs
2594,Kyle Korver,1610612749,MIL,4,2,2,61.0,1,0,1,0.0,4,0.25,0,0.25,23.8,7,1,7,0.143,10,0.7,0,0.7,8.3,8,1,8,0.125,12,0.667,0,0.667,10.0,2019-20,Playoffs
1628398,Kyle Kuzma,1610612747,LAL,19,14,5,443.0,18,11,7,0.611,34,0.529,0,0.529,8.9,47,12,35,0.255,69,0.681,5,0.734,7.8,65,23,42,0.354,98,0.663,5,0.699,8.1,2019-20,Playoffs
200768,Kyle Lowry,1610612761,TOR,11,7,4,413.0,8,3,5,0.375,34,0.235,1,0.242,17.8,64,10,54,0.156,109,0.587,12,0.66,8.1,72,13,59,0.181,143,0.503,13,0.554,9.2,2019-20,Playoffs
203124,Kyle O'Quinn,1610612755,PHI,1,0,1,6.0,0,0,0,0.0,0,0.0,0,0.0,0.0,1,0,1,0.0,1,1.0,0,1.0,1.2,1,0,1,0.0,1,1.0,0,1.0,1.2,2019-20,Playoffs
202498,Lance Thomas,1610612751,BKN,1,0,1,7.0,1,0,1,0.0,3,0.333,0,0.333,25.3,2,0,2,0.0,3,0.667,0,0.667,10.1,3,0,3,0.0,5,0.6,0,0.6,15.2,2019-20,Playoffs
1629013,Landry Shamet,1610612746,LAC,9,6,3,199.0,0,0,0,0.0,3,0.0,0,0.0,0.0,22,2,20,0.091,32,0.688,2,0.733,11.4,22,2,20,0.091,34,0.647,2,0.688,11.4,2019-20,Playoffs
2544,LeBron James,1610612747,LAL,21,16,5,762.0,28,17,10,0.607,76,0.368,2,0.378,7.7,198,30,163,0.152,252,0.786,8,0.811,6.3,226,47,173,0.208,308,0.734,10,0.758,6.5,2019-20,Playoffs
101150,Lou Williams,1610612746,LAC,13,7,6,341.0,7,3,4,0.429,19,0.368,0,0.368,9.0,34,11,23,0.324,48,0.708,3,0.756,7.7,41,14,27,0.341,65,0.631,3,0.661,7.9,2019-20,Playoffs
1629652,Luguentz Dort,1610612760,OKC,5,3,2,152.0,5,0,4,0.0,16,0.313,0,0.313,6.9,17,3,14,0.176,28,0.607,3,0.68,7.9,22,3,18,0.136,44,0.5,3,0.537,7.7,2019-20,Playoffs
1629029,Luka Doncic,1610612742,DAL,6,2,4,215.0,4,3,1,0.75,21,0.19,1,0.2,9.6,55,9,46,0.164,73,0.753,3,0.786,5.7,59,12,47,0.203,89,0.663,4,0.694,6.0,2019-20,Playoffs
1627763,Malcolm Brogdon,1610612754,IND,4,0,4,160.0,0,0,0,0.0,4,0.0,0,0.0,0.0,17,5,12,0.294,27,0.63,4,0.739,6.2,17,5,12,0.294,30,0.567,4,0.654,6.2,2019-20,Playoffs
201188,Marc Gasol,1610612761,TOR,11,7,4,228.0,4,3,1,0.75,11,0.364,0,0.364,8.5,44,13,31,0.295,74,0.595,5,0.638,5.2,48,16,32,0.333,84,0.571,5,0.608,5.5,2019-20,Playoffs
202694,Marcus Morris Sr.,1610612746,LAC,13,7,6,388.0,11,3,8,0.273,24,0.458,2,0.5,10.7,52,11,41,0.212,80,0.65,6,0.703,7.1,63,14,49,0.222,98,0.643,8,0.7,7.7,2019-20,Playoffs
203935,Marcus Smart,1610612738,BOS,17,10,7,648.0,10,4,6,0.4,35,0.286,2,0.303,18.0,79,20,59,0.253,132,0.598,10,0.648,8.3,89,24,65,0.27,161,0.553,12,0.597,9.4,2019-20,Playoffs
1626209,Mario Hezonja,1610612757,POR,5,1,4,68.0,2,0,2,0.0,4,0.5,0,0.5,8.2,14,0,13,0.0,18,0.778,1,0.824,8.8,16,0,15,0.0,21,0.762,1,0.8,8.7,2019-20,Playoffs
1628365,Markelle Fultz,1610612753,ORL,5,1,4,147.0,0,0,0,0.0,5,0.0,0,0.0,0.0,11,0,11,0.0,27,0.407,5,0.5,8.2,11,0,11,0.0,31,0.355,5,0.423,8.2,2019-20,Playoffs
202693,Markieff Morris,1610612747,LAL,19,16,3,366.0,12,6,7,0.5,31,0.387,1,0.4,8.0,52,12,40,0.231,91,0.571,7,0.619,7.9,64,18,47,0.281,117,0.547,8,0.587,7.9,2019-20,Playoffs
101107,Marvin Williams,1610612749,MIL,10,5,5,179.0,13,11,2,0.846,21,0.619,1,0.65,6.2,35,7,28,0.2,42,0.833,1,0.854,5.4,48,18,30,0.375,61,0.787,2,0.814,5.6,2019-20,Playoffs
203486,Mason Plumlee,1610612743,DEN,18,8,10,199.0,31,20,11,0.645,62,0.5,1,0.508,7.5,30,5,25,0.167,54,0.556,8,0.652,5.3,61,25,36,0.41,114,0.535,9,0.581,6.4,2019-20,Playoffs
1629680,Matisse Thybulle,1610612755,PHI,3,0,3,67.0,1,0,1,0.0,2,0.5,0,0.5,26.0,6,0,6,0.0,8,0.75,0,0.75,13.1,7,0,7,0.0,10,0.7,0,0.7,15.0,2019-20,Playoffs
1629744,Matt Thomas,1610612761,TOR,9,6,3,77.0,1,0,1,0.0,4,0.25,0,0.25,11.4,13,1,12,0.077,18,0.722,0,0.722,9.3,14,1,13,0.071,21,0.667,0,0.667,9.4,2019-20,Playoffs
1628467,Maxi Kleber,1610612742,DAL,6,2,4,203.0,10,7,3,0.7,34,0.294,2,0.313,4.6,29,13,16,0.448,52,0.558,8,0.659,6.8,39,20,19,0.513,81,0.481,10,0.549,6.3,2019-20,Playoffs
203086,Meyers Leonard,1610612748,MIA,1,1,0,13.0,0,0,0,0.0,1,0.0,0,0.0,0.0,1,0,1,0.0,4,0.25,2,0.5,8.3,1,0,1,0.0,4,0.25,2,0.5,8.3,2019-20,Playoffs
1626187,Michael Frazier II,1610612745,HOU,2,1,1,8.0,1,0,1,0.0,1,1.0,0,1.0,23.1,3,0,3,0.0,4,0.75,0,0.75,6.0,4,0,4,0.0,5,0.8,0,0.8,10.3,2019-20,Playoffs
203077,Michael Kidd-Gilchrist,1610612742,DAL,3,2,1,31.0,2,1,1,0.5,4,0.5,0,0.5,5.3,4,1,3,0.25,5,0.8,0,0.8,5.4,6,2,4,0.333,9,0.667,0,0.667,5.4,2019-20,Playoffs
1629008,Michael Porter Jr.,1610612743,DEN,19,9,10,451.0,21,14,5,0.667,65,0.323,0,0.323,4.9,106,20,87,0.189,154,0.688,12,0.746,4.1,127,34,92,0.268,203,0.626,12,0.665,4.2,2019-20,Playoffs
201144,Mike Conley,1610612762,UTA,4,1,3,140.0,3,1,2,0.333,8,0.375,0,0.375,17.5,11,3,8,0.273,26,0.423,1,0.44,9.9,14,4,10,0.286,34,0.412,1,0.424,11.5,2019-20,Playoffs
203488,Mike Muscala,1610612760,OKC,2,0,2,20.0,0,0,0,0.0,0,0.0,0,0.0,0.0,4,1,3,0.25,5,0.8,0,0.8,5.8,4,1,3,0.25,5,0.8,0,0.8,5.8,2019-20,Playoffs
203118,Mike Scott,1610612755,PHI,4,0,4,20.0,2,0,2,0.0,2,1.0,0,1.0,6.0,6,0,6,0.0,7,0.857,0,0.857,5.6,8,0,8,0.0,9,0.889,0,0.889,5.7,2019-20,Playoffs
1629671,Miye Oni,1610612762,UTA,1,1,0,10.0,2,1,1,0.5,2,1.0,0,1.0,4.7,2,0,2,0.0,6,0.333,0,0.333,4.0,4,1,3,0.25,7,0.571,0,0.571,4.3,2019-20,Playoffs
1628420,Monte Morris,1610612743,DEN,15,6,9,334.0,4,0,4,0.0,9,0.444,0,0.444,12.7,25,1,24,0.04,42,0.595,4,0.658,9.6,29,1,28,0.034,50,0.58,4,0.63,10.0,2019-20,Playoffs
1626149,Montrezl Harrell,1610612746,LAC,13,7,6,243.0,11,8,2,0.727,31,0.355,1,0.367,4.0,27,7,20,0.259,54,0.5,2,0.519,6.9,38,15,22,0.395,83,0.458,3,0.475,6.1,2019-20,Playoffs
1626167,Myles Turner,1610612754,IND,4,0,4,146.0,11,6,5,0.545,20,0.55,0,0.55,9.0,32,7,25,0.219,58,0.552,8,0.64,4.4,43,13,30,0.302,77,0.558,8,0.623,5.6,2019-20,Playoffs
203457,Nerlens Noel,1610612760,OKC,7,3,4,97.0,5,5,0,1.0,18,0.278,0,0.278,4.3,24,5,18,0.208,37,0.649,4,0.727,5.0,29,10,18,0.345,53,0.547,4,0.592,4.9,2019-20,Playoffs
203999,Nikola Jokic,1610612743,DEN,19,9,10,694.0,37,29,8,0.784,87,0.425,1,0.43,6.6,150,46,103,0.307,244,0.615,21,0.673,4.0,187,75,111,0.401,321,0.583,22,0.625,4.5,2019-20,Playoffs
202696,Nikola Vucevic,1610612753,ORL,5,1,4,185.0,9,7,2,0.778,25,0.36,1,0.375,6.4,46,13,33,0.283,65,0.708,5,0.767,4.9,55,20,35,0.364,87,0.632,6,0.679,5.2,2019-20,Playoffs
1626181,Norman Powell,1610612761,TOR,9,6,3,241.0,4,1,3,0.25,12,0.333,1,0.364,17.0,22,2,20,0.091,37,0.595,5,0.688,8.1,26,3,23,0.115,48,0.542,6,0.619,9.5,2019-20,Playoffs
1628384,OG Anunoby,1610612761,TOR,11,7,4,393.0,26,17,8,0.654,47,0.553,0,0.553,7.9,50,15,35,0.3,81,0.617,7,0.676,5.2,76,32,43,0.421,121,0.628,7,0.667,6.1,2019-20,Playoffs
200782,P.J. Tucker,1610612745,HOU,12,5,7,414.0,23,15,8,0.652,77,0.299,2,0.307,6.9,63,21,42,0.333,119,0.529,11,0.583,5.1,86,36,50,0.419,184,0.467,13,0.503,5.6,2019-20,Playoffs
1628408,PJ Dozier,1610612743,DEN,7,2,5,113.0,2,1,1,0.5,6,0.333,1,0.4,25.8,16,3,13,0.188,26,0.615,5,0.762,8.4,18,4,14,0.222,31,0.581,6,0.72,10.3,2019-20,Playoffs
1627783,Pascal Siakam,1610612761,TOR,11,7,4,418.0,14,6,7,0.429,42,0.333,2,0.35,9.5,69,13,56,0.188,105,0.657,7,0.704,6.1,83,19,63,0.229,143,0.58,9,0.619,6.6,2019-20,Playoffs
1626192,Pat Connaughton,1610612749,MIL,9,5,4,170.0,5,0,5,0.0,11,0.455,0,0.455,12.7,34,6,28,0.176,54,0.63,2,0.654,6.0,39,6,33,0.154,64,0.609,2,0.629,6.9,2019-20,Playoffs
201976,Patrick Beverley,1610612746,LAC,8,4,4,166.0,9,4,5,0.444,17,0.529,0,0.529,12.1,24,6,18,0.25,41,0.585,5,0.667,8.1,33,10,23,0.303,58,0.569,5,0.623,9.2,2019-20,Playoffs
202335,Patrick Patterson,1610612746,LAC,1,1,0,5.0,0,0,0,0.0,0,0.0,0,0.0,0.0,1,0,1,0.0,1,1.0,0,1.0,5.5,1,0,1,0.0,1,1.0,0,1.0,5.5,2019-20,Playoffs
202331,Paul George,1610612746,LAC,13,7,6,479.0,14,8,6,0.571,28,0.5,1,0.519,14.0,65,13,52,0.2,112,0.58,15,0.67,6.2,79,21,58,0.266,137,0.577,16,0.653,7.6,2019-20,Playoffs
200794,Paul Millsap,1610612743,DEN,19,9,10,459.0,26,16,10,0.615,62,0.419,3,0.441,7.9,63,17,46,0.27,110,0.573,12,0.643,5.0,89,33,56,0.371,168,0.53,15,0.582,5.8,2019-20,Playoffs
1626188,Quinn Cook,1610612747,LAL,1,1,0,9.0,0,0,0,0.0,0,0.0,0,0.0,0.0,1,0,1,0.0,1,1.0,0,1.0,1.9,1,0,1,0.0,1,1.0,0,1.0,1.9,2019-20,Playoffs
200765,Rajon Rondo,1610612747,LAL,16,12,4,395.0,13,9,4,0.692,33,0.394,2,0.419,7.7,56,7,48,0.125,76,0.737,5,0.789,8.1,69,16,52,0.232,105,0.657,7,0.704,8.0,2019-20,Playoffs
203526,Raul Neto,1610612755,PHI,2,0,2,26.0,0,0,0,0.0,1,0.0,0,0.0,0.0,3,0,3,0.0,5,0.6,0,0.6,8.1,3,0,3,0.0,6,0.5,0,0.5,8.1,2019-20,Playoffs
202704,Reggie Jackson,1610612746,LAC,7,4,3,146.0,2,1,1,0.5,4,0.5,0,0.5,17.0,19,2,17,0.105,32,0.594,2,0.633,8.9,21,3,18,0.143,36,0.583,2,0.618,9.7,2019-20,Playoffs
203496,Robert Covington,1610612745,HOU,12,5,7,379.0,8,4,4,0.5,26,0.308,0,0.308,6.9,52,14,37,0.269,93,0.559,9,0.619,4.9,60,18,41,0.3,116,0.517,9,0.561,5.2,2019-20,Playoffs
1629057,Robert Williams III,1610612738,BOS,12,6,6,147.0,22,15,7,0.682,31,0.71,1,0.733,6.4,29,10,19,0.345,40,0.725,2,0.763,6.1,51,25,26,0.49,69,0.739,3,0.773,6.2,2019-20,Playoffs
201577,Robin Lopez,1610612749,MIL,2,1,1,11.0,0,0,0,0.0,0,0.0,0,0.0,0.0,4,0,4,0.0,4,1.0,0,1.0,12.5,4,0,4,0.0,4,1.0,0,1.0,12.5,2019-20,Playoffs
1629066,Rodions Kurucs,1610612751,BKN,4,0,4,58.0,3,1,2,0.333,5,0.6,0,0.6,11.4,10,2,8,0.2,17,0.588,2,0.667,7.9,13,3,10,0.231,22,0.591,2,0.65,8.7,2019-20,Playoffs
203585,Rodney McGruder,1610612746,LAC,4,3,1,15.0,1,0,1,0.0,1,1.0,0,1.0,22.9,3,1,2,0.333,5,0.6,0,0.6,13.6,4,1,3,0.25,6,0.667,0,0.667,15.9,2019-20,Playoffs
1629641,Romeo Langford,1610612738,BOS,3,3,0,30.0,0,0,0,0.0,5,0.0,0,0.0,0.0,3,0,3,0.0,7,0.429,1,0.5,2.2,3,0,3,0.0,10,0.3,1,0.333,2.2,2019-20,Playoffs
1626178,Rondae Hollis-Jefferson,1610612761,TOR,4,3,1,37.0,5,4,1,0.8,7,0.714,0,0.714,3.3,5,1,4,0.2,12,0.417,1,0.455,4.5,10,5,5,0.5,19,0.526,1,0.556,3.9,2019-20,Playoffs
1626220,Royce O'Neale,1610612762,UTA,7,3,4,249.0,3,1,2,0.333,7,0.429,0,0.429,12.0,35,11,24,0.314,59,0.593,7,0.673,5.2,38,12,26,0.316,65,0.585,7,0.655,5.7,2019-20,Playoffs
203497,Rudy Gobert,1610612762,UTA,7,3,4,270.0,24,19,5,0.792,48,0.5,2,0.522,5.0,56,23,34,0.411,90,0.622,7,0.675,3.7,80,42,39,0.525,134,0.597,9,0.64,4.1,2019-20,Playoffs
201566,Russell Westbrook,1610612745,HOU,8,3,5,262.0,11,7,4,0.636,39,0.282,2,0.297,10.1,45,8,37,0.178,57,0.789,3,0.833,7.2,56,15,41,0.268,92,0.609,5,0.644,7.7,2019-20,Playoffs
1628400,Semi Ojeleye,1610612738,BOS,7,4,3,58.0,2,1,1,0.5,5,0.4,0,0.4,11.8,10,1,9,0.1,13,0.769,1,0.833,9.4,12,2,10,0.167,18,0.667,1,0.706,9.8,2019-20,Playoffs
201586,Serge Ibaka,1610612761,TOR,11,7,4,251.0,17,12,5,0.706,40,0.425,0,0.425,7.1,68,16,52,0.235,109,0.624,11,0.694,4.7,85,28,57,0.329,141,0.603,11,0.654,5.2,2019-20,Playoffs
203552,Seth Curry,1610612742,DAL,5,2,3,142.0,2,0,2,0.0,3,0.667,0,0.667,15.6,9,0,9,0.0,11,0.818,0,0.818,10.3,11,0,11,0.0,14,0.786,0,0.786,11.3,2019-20,Playoffs
1628983,Shai Gilgeous-Alexander,1610612760,OKC,7,3,4,279.0,3,2,1,0.667,11,0.273,0,0.273,1.6,34,8,27,0.235,52,0.654,1,0.667,9.3,37,10,28,0.27,59,0.627,1,0.638,8.7,2019-20,Playoffs
1629003,Shake Milton,1610612755,PHI,3,0,3,100.0,1,0,1,0.0,2,0.5,0,0.5,21.3,12,1,11,0.083,18,0.667,2,0.75,9.9,13,1,12,0.077,19,0.684,2,0.765,10.8,2019-20,Playoffs
203524,Solomon Hill,1610612748,MIA,3,1,2,31.0,1,0,1,0.0,2,0.5,0,0.5,4.5,6,1,5,0.167,6,1.0,0,1.0,6.1,7,1,6,0.143,7,1.0,0,1.0,5.8,2019-20,Playoffs
1626169,Stanley Johnson,1610612761,TOR,2,2,0,16.0,1,1,0,1.0,2,0.5,0,0.5,10.5,3,0,3,0.0,5,0.6,1,0.75,4.2,4,1,3,0.25,6,0.667,1,0.8,5.8,2019-20,Playoffs
1628425,Sterling Brown,1610612749,MIL,1,1,0,4.0,0,0,0,0.0,0,0.0,0,0.0,0.0,1,0,1,0.0,1,1.0,0,1.0,4.3,1,0,1,0.0,1,1.0,0,1.0,4.3,2019-20,Playoffs
203500,Steven Adams,1610612760,OKC,7,3,4,210.0,34,27,7,0.794,77,0.442,1,0.447,4.7,47,10,37,0.213,68,0.691,6,0.758,4.5,81,37,44,0.457,144,0.563,7,0.591,4.6,2019-20,Playoffs
204456,T.J. McConnell,1610612754,IND,3,0,3,28.0,0,0,0,0.0,0,0.0,0,0.0,0.0,6,1,5,0.167,9,0.667,1,0.75,7.2,6,1,5,0.167,9,0.667,1,0.75,7.2,2019-20,Playoffs
203933,T.J. Warren,1610612754,IND,4,0,4,156.0,5,3,2,0.6,19,0.263,0,0.263,5.7,20,4,16,0.2,26,0.769,3,0.87,5.3,25,7,18,0.28,40,0.625,3,0.676,5.4,2019-20,Playoffs
1629605,Tacko Fall,1610612738,BOS,1,1,0,3.0,0,0,0,0.0,0,0.0,0,0.0,0.0,1,0,1,0.0,2,0.5,0,0.5,5.7,1,0,1,0.0,2,0.5,0,0.5,5.7,2019-20,Playoffs
1629659,Talen Horton-Tucker,1610612747,LAL,2,2,0,17.0,0,0,0,0.0,0,0.0,0,0.0,0.0,5,0,5,0.0,11,0.455,1,0.5,8.0,5,0,5,0.0,11,0.455,1,0.5,8.0,2019-20,Playoffs
1629611,Terance Mann,1610612746,LAC,5,3,2,23.0,0,0,0,0.0,1,0.0,0,0.0,0.0,7,3,4,0.429,10,0.7,0,0.7,2.7,7,3,4,0.429,11,0.636,0,0.636,2.7,2019-20,Playoffs
1629056,Terence Davis,1610612761,TOR,5,3,2,72.0,2,0,2,0.0,7,0.286,0,0.286,10.5,11,1,10,0.091,15,0.733,0,0.733,5.5,13,1,12,0.077,21,0.619,0,0.619,6.2,2019-20,Playoffs
1628390,Terrance Ferguson,1610612760,OKC,4,2,2,42.0,1,0,1,0.0,3,0.333,0,0.333,9.3,3,1,2,0.333,4,0.75,0,0.75,8.2,4,1,3,0.25,7,0.571,0,0.571,8.5,2019-20,Playoffs
203082,Terrence Ross,1610612753,ORL,5,1,4,135.0,1,0,1,0.0,8,0.125,0,0.125,18.2,21,2,19,0.095,35,0.6,2,0.636,5.4,22,2,20,0.091,37,0.595,2,0.629,6.0,2019-20,Playoffs
203501,Tim Hardaway Jr.,1610612742,DAL,6,2,4,204.0,3,0,3,0.0,11,0.273,1,0.3,14.4,18,4,14,0.222,27,0.667,2,0.72,7.6,21,4,17,0.19,36,0.583,3,0.636,8.6,2019-20,Playoffs
1627789,Timothe Luwawu-Cabarrot,1610612751,BKN,4,0,4,131.0,1,0,1,0.0,7,0.143,0,0.143,4.2,14,4,10,0.286,32,0.438,6,0.538,4.8,15,4,11,0.267,38,0.395,6,0.469,4.8,2019-20,Playoffs
202699,Tobias Harris,1610612755,PHI,4,0,4,149.0,14,11,3,0.786,32,0.438,1,0.452,4.7,24,5,20,0.208,43,0.558,4,0.615,4.4,38,16,23,0.421,73,0.521,5,0.559,4.5,2019-20,Playoffs
1628396,Tony Bradley,1610612762,UTA,5,3,2,44.0,10,6,3,0.6,19,0.526,0,0.526,6.5,13,3,10,0.231,18,0.722,1,0.765,4.7,23,9,13,0.391,36,0.639,1,0.657,5.5,2019-20,Playoffs
1628470,Torrey Craig,1610612743,DEN,17,9,8,358.0,13,8,4,0.615,46,0.283,4,0.31,8.8,49,6,43,0.122,71,0.69,7,0.766,6.8,62,14,47,0.226,108,0.574,11,0.639,7.2,2019-20,Playoffs
1629682,Tremont Waters,1610612738,BOS,1,1,0,2.0,0,0,0,0.0,0,0.0,0,0.0,0.0,1,0,1,0.0,1,1.0,0,1.0,16.7,1,0,1,0.0,1,1.0,0,1.0,16.7,2019-20,Playoffs
203504,Trey Burke,1610612742,DAL,5,2,3,140.0,2,2,0,1.0,6,0.333,1,0.4,6.7,17,2,15,0.118,25,0.68,2,0.739,8.9,19,4,15,0.211,31,0.613,3,0.679,8.6,2019-20,Playoffs
203584,Troy Daniels,1610612743,DEN,2,0,2,19.0,1,1,0,1.0,1,1.0,0,1.0,6.2,2,0,2,0.0,4,0.5,0,0.5,7.3,3,1,2,0.333,5,0.6,0,0.6,6.9,2019-20,Playoffs
1629076,Tyler Cook,1610612743,DEN,1,0,1,4.0,0,0,0,0.0,0,0.0,0,0.0,0.0,2,0,2,0.0,3,0.667,0,0.667,19.1,2,0,2,0.0,3,0.667,0,0.667,19.1,2019-20,Playoffs
1629639,Tyler Herro,1610612748,MIA,20,14,6,676.0,7,0,7,0.0,23,0.304,1,0.318,12.4,97,13,83,0.134,162,0.599,19,0.678,6.3,104,13,90,0.125,180,0.578,20,0.65,6.7,2019-20,Playoffs
204020,Tyler Johnson,1610612751,BKN,3,0,3,75.0,0,0,0,0.0,2,0.0,0,0.0,0.0,7,1,6,0.143,16,0.438,2,0.5,9.5,7,1,6,0.143,18,0.389,2,0.438,9.5,2019-20,Playoffs
1629724,Vic Law,1610612753,ORL,1,0,1,4.0,0,0,0,0.0,0,0.0,0,0.0,0.0,2,0,2,0.0,4,0.5,0,0.5,7.2,2,0,2,0.0,4,0.5,0,0.5,7.2,2019-20,Playoffs
203506,Victor Oladipo,1610612754,IND,3,0,3,114.0,0,0,0,0.0,1,0.0,0,0.0,0.0,13,2,11,0.154,24,0.542,1,0.565,8.7,13,2,11,0.154,25,0.52,1,0.542,8.7,2019-20,Playoffs
1629117,Wenyen Gabriel,1610612757,POR,3,1,2,49.0,7,4,3,0.571,16,0.438,1,0.467,16.0,3,0,3,0.0,10,0.3,0,0.3,13.7,10,4,6,0.4,26,0.385,1,0.4,15.3,2019-20,Playoffs
1628411,Wes Iwundu,1610612753,ORL,5,1,4,76.0,1,1,0,1.0,4,0.25,0,0.25,2.7,10,1,9,0.1,15,0.667,0,0.667,5.2,11,2,9,0.182,19,0.579,0,0.579,5.0,2019-20,Playoffs
202083,Wesley Matthews,1610612749,MIL,9,4,5,225.0,6,3,3,0.5,11,0.545,0,0.545,7.6,12,2,10,0.167,21,0.571,3,0.667,9.5,18,5,13,0.278,30,0.6,3,0.667,8.9,2019-20,Playoffs
203932,Aaron Gordon,1610612743,DEN,50,29,21,1384.0,77,50,26,0.649,154,0.5,6,0.52,7.0,207,48,159,0.232,289,0.716,24,0.781,6.3,284,98,185,0.345,427,0.665,30,0.715,6.5,2020-21,Regular%20Season
1628988,Aaron Holiday,1610612754,IND,48,22,26,946.0,15,5,10,0.333,49,0.306,1,0.313,14.3,74,4,70,0.054,122,0.607,15,0.692,9.2,89,9,80,0.101,170,0.524,16,0.578,10.1,2020-21,Regular%20Season
1630174,Aaron Nesmith,1610612738,BOS,35,15,20,585.0,28,19,8,0.679,63,0.444,3,0.467,8.3,99,26,73,0.263,155,0.639,10,0.683,6.2,127,45,81,0.354,216,0.588,13,0.626,6.7,2020-21,Regular%20Season
1627846,Abdel Nader,1610612756,PHX,21,13,8,344.0,7,3,4,0.429,24,0.292,0,0.292,3.7,55,9,45,0.164,80,0.688,10,0.786,6.3,62,12,49,0.194,100,0.62,10,0.689,6.0,2020-21,Regular%20Season
1629690,Adam Mokoka,1610612741,CHI,4,0,4,37.0,1,1,0,1.0,3,0.333,0,0.333,7.3,4,1,3,0.25,6,0.667,0,0.667,9.5,5,2,3,0.4,9,0.556,0,0.556,9.1,2020-21,Regular%20Season
201143,Al Horford,1610612738,BOS,28,11,17,782.0,29,13,15,0.448,77,0.377,0,0.377,7.9,159,52,105,0.327,243,0.654,16,0.7,5.6,188,65,120,0.346,311,0.605,16,0.637,6.0,2020-21,Regular%20Season
202329,Al-Farouq Aminu,1610612741,CHI,23,5,18,434.0,22,10,12,0.455,46,0.478,2,0.5,6.2,88,22,66,0.25,132,0.667,15,0.752,7.1,110,32,78,0.291,175,0.629,17,0.696,6.9,2020-21,Regular%20Season
202692,Alec Burks,1610612752,NYK,49,27,22,1255.0,21,9,12,0.429,69,0.304,5,0.328,14.5,206,39,164,0.189,282,0.73,19,0.783,7.3,227,48,176,0.211,346,0.656,24,0.705,8.0,2020-21,Regular%20Season
1630197,Aleksej Pokusevski,1610612760,OKC,43,13,30,1065.0,30,14,16,0.467,66,0.455,2,0.469,8.6,182,31,145,0.17,289,0.63,26,0.692,5.0,212,45,161,0.212,348,0.609,28,0.663,5.5,2020-21,Regular%20Season
1629346,Alen Smailagic,1610612744,GSW,8,6,2,63.0,6,5,1,0.833,16,0.375,3,0.462,3.7,10,3,7,0.3,15,0.667,2,0.769,3.5,16,8,8,0.5,30,0.533,5,0.64,3.6,2020-21,Regular%20Season
1627936,Alex Caruso,1610612747,LAL,57,32,25,1188.0,31,14,16,0.452,78,0.397,4,0.419,12.3,139,20,119,0.144,222,0.626,19,0.685,8.4,170,34,135,0.2,294,0.578,23,0.627,9.1,2020-21,Regular%20Season
203458,Alex Len,1610612764,WAS,57,25,32,936.0,78,53,27,0.679,181,0.431,5,0.443,4.6,182,57,124,0.313,313,0.581,28,0.639,5.0,260,110,151,0.423,484,0.537,33,0.576,4.9,2020-21,Regular%20Season
1628035,Alfonzo McKinnie,1610612747,LAL,25,14,11,208.0,22,13,9,0.591,43,0.512,1,0.524,4.4,32,8,24,0.25,52,0.615,3,0.653,4.3,54,21,33,0.389,87,0.621,4,0.651,4.4,2020-21,Regular%20Season
1628993,Alize Johnson,1610612751,BKN,15,8,7,184.0,27,19,7,0.704,60,0.45,1,0.458,6.1,63,14,49,0.222,94,0.67,10,0.75,4.8,90,33,56,0.367,152,0.592,11,0.638,5.1,2020-21,Regular%20Season
1628578,Amida Brimah,1610612754,IND,3,1,2,23.0,2,2,0,1.0,7,0.286,0,0.286,4.0,6,2,4,0.333,15,0.4,3,0.5,3.1,8,4,4,0.5,20,0.4,3,0.471,3.3,2020-21,Regular%20Season
1629599,Amir Coffey,1610612746,LAC,19,15,4,318.0,10,4,6,0.4,14,0.714,0,0.714,14.9,34,12,22,0.353,57,0.596,6,0.667,9.4,44,16,28,0.364,71,0.62,6,0.677,10.7,2020-21,Regular%20Season
2760,Anderson Varejao,1610612739,CLE,5,1,4,36.0,7,5,2,0.714,18,0.389,0,0.389,4.2,13,5,8,0.385,18,0.722,1,0.765,2.8,20,10,10,0.5,34,0.588,1,0.606,3.3,2020-21,Regular%20Season
203083,Andre Drummond,1610612747,LAL,45,18,27,1220.0,166,120,46,0.723,319,0.52,4,0.527,4.3,385,125,258,0.325,529,0.728,30,0.772,4.1,551,245,304,0.445,812,0.679,34,0.708,4.2,2020-21,Regular%20Season
2738,Andre Iguodala,1610612748,MIA,59,35,24,1274.0,38,20,18,0.526,83,0.458,3,0.475,13.2,183,41,140,0.224,310,0.59,27,0.647,6.8,221,61,158,0.276,383,0.577,30,0.626,7.9,2020-21,Regular%20Season
203460,Andre Roberson,1610612751,BKN,5,4,1,63.0,7,3,4,0.429,11,0.636,0,0.636,10.2,8,0,8,0.0,17,0.471,3,0.571,4.6,15,3,12,0.2,27,0.556,3,0.625,7.2,2020-21,Regular%20Season
203952,Andrew Wiggins,1610612744,GSW,71,38,33,2364.0,82,54,27,0.659,193,0.425,6,0.439,7.8,265,59,204,0.223,468,0.566,56,0.643,6.8,347,113,231,0.326,655,0.53,62,0.585,7.0,2020-21,Regular%20Season
1629014,Anfernee Simons,1610612757,POR,49,32,17,940.0,14,4,10,0.286,34,0.412,2,0.438,20.2,126,20,106,0.159,171,0.737,9,0.778,6.8,140,24,116,0.171,203,0.69,11,0.729,8.2,2020-21,Regular%20Season
203076,Anthony Davis,1610612747,LAL,36,23,13,1162.0,62,45,16,0.726,118,0.525,3,0.539,5.1,224,55,169,0.246,335,0.669,26,0.725,5.1,286,100,185,0.35,447,0.64,29,0.684,5.1,2020-21,Regular%20Season
1630162,Anthony Edwards,1610612750,MIN,67,22,45,2175.0,59,30,29,0.508,141,0.418,7,0.44,9.3,277,36,242,0.13,424,0.653,33,0.708,6.8,336,66,271,0.196,555,0.605,40,0.652,7.3,2020-21,Regular%20Season
1630264,Anthony Gill,1610612764,WAS,19,8,11,197.0,16,11,5,0.688,29,0.552,0,0.552,7.2,35,6,29,0.171,52,0.673,2,0.7,6.8,51,17,34,0.333,78,0.654,2,0.671,6.9,2020-21,Regular%20Season
1630237,Anthony Lamb,1610612745,HOU,20,2,18,396.0,27,16,11,0.593,68,0.397,0,0.397,8.2,43,11,32,0.256,83,0.518,13,0.614,6.8,70,27,43,0.386,148,0.473,13,0.519,7.3,2020-21,Regular%20Season
201229,Anthony Tolliver,1610612755,PHI,6,3,3,81.0,3,1,2,0.333,7,0.429,0,0.429,2.6,7,2,5,0.286,17,0.412,1,0.438,6.0,10,3,7,0.3,21,0.476,1,0.5,5.0,2020-21,Regular%20Season
1628394,Anzejs Pasecniks,1610612764,WAS,1,1,0,6.0,1,0,1,0.0,3,0.333,1,0.5,6.4,0,0,0,0.0,0,0.0,0,0.0,0.0,1,0,1,0.0,3,0.333,1,0.5,6.4,2020-21,Regular%20Season
1629717,Armoni Brooks,1610612745,HOU,19,3,16,509.0,10,3,7,0.3,21,0.476,0,0.476,12.9,58,8,49,0.138,86,0.674,5,0.716,6.8,68,11,56,0.162,107,0.636,5,0.667,7.7,2020-21,Regular%20Season
203382,Aron Baynes,1610612761,TOR,50,19,31,947.0,87,57,28,0.655,191,0.455,4,0.465,4.7,186,55,131,0.296,335,0.555,33,0.616,4.9,273,112,159,0.41,514,0.531,37,0.572,4.8,2020-21,Regular%20Season
203085,Austin Rivers,1610612743,DEN,31,17,14,774.0,8,3,5,0.375,31,0.258,0,0.258,10.8,74,10,64,0.135,106,0.698,6,0.74,9.1,82,13,69,0.159,134,0.612,6,0.641,9.2,2020-21,Regular%20Season
202340,Avery Bradley,1610612745,HOU,25,6,19,549.0,8,3,5,0.375,24,0.333,3,0.381,16.8,49,11,38,0.224,93,0.527,10,0.59,7.0,57,14,43,0.246,116,0.491,13,0.553,8.4,2020-21,Regular%20Season
1626253,Axel Toupane,1610612749,MIL,4,1,3,51.0,0,0,0,0.0,2,0.0,0,0.0,0.0,6,2,4,0.333,11,0.545,2,0.667,6.0,6,2,4,0.333,13,0.462,2,0.545,6.0,2020-21,Regular%20Season
1628389,Bam Adebayo,1610612748,MIA,64,34,30,2143.0,142,92,50,0.648,355,0.4,9,0.41,6.7,431,129,302,0.299,667,0.646,48,0.696,5.5,573,221,352,0.386,970,0.591,57,0.628,5.8,2020-21,Regular%20Season
203463,Ben McLemore,1610612747,LAL,43,17,26,808.0,15,6,6,0.4,39,0.385,0,0.385,13.0,85,15,68,0.176,162,0.525,22,0.607,8.1,100,21,74,0.21,194,0.515,22,0.581,8.7,2020-21,Regular%20Season
1627732,Ben Simmons,1610612755,PHI,58,42,16,1877.0,93,52,40,0.559,212,0.439,6,0.451,6.8,324,47,276,0.145,421,0.77,26,0.82,7.5,417,99,316,0.237,603,0.692,32,0.73,7.3,2020-21,Regular%20Season
202687,Bismack Biyombo,1610612766,CHA,63,28,35,1330.0,137,89,47,0.65,327,0.419,6,0.427,6.5,210,68,141,0.324,393,0.534,43,0.6,5.0,347,157,188,0.452,704,0.493,49,0.53,5.6,2020-21,Regular%20Season
201933,Blake Griffin,1610612751,BKN,44,24,20,1141.0,34,25,9,0.735,104,0.327,4,0.34,7.0,181,36,145,0.199,288,0.628,17,0.668,5.1,215,61,154,0.284,361,0.596,21,0.632,5.4,2020-21,Regular%20Season
1626246,Boban Marjanovic,1610612742,DAL,29,13,16,256.0,47,35,11,0.745,87,0.54,1,0.547,4.2,81,23,58,0.284,120,0.675,7,0.717,3.9,128,58,69,0.453,198,0.646,8,0.674,4.0,2020-21,Regular%20Season
1626171,Bobby Portis,1610612749,MIL,66,44,22,1372.0,124,87,37,0.702,273,0.454,11,0.473,4.8,342,93,247,0.272,549,0.623,53,0.69,4.7,466,180,284,0.386,789,0.591,64,0.643,4.7,2020-21,Regular%20Season
203992,Bogdan Bogdanovic,1610612737,ATL,43,29,14,1276.0,20,10,10,0.5,53,0.377,1,0.385,10.6,140,16,124,0.114,245,0.571,30,0.651,7.1,160,26,134,0.163,295,0.542,31,0.606,7.6,2020-21,Regular%20Season
202711,Bojan Bogdanovic,1610612762,UTA,70,50,20,2160.0,40,12,27,0.3,134,0.299,8,0.317,11.2,241,26,214,0.108,400,0.603,38,0.666,7.3,281,38,241,0.135,523,0.537,46,0.589,7.9,2020-21,Regular%20Season
1629626,Bol Bol,1610612743,DEN,19,14,5,114.0,0,0,0,0.0,3,0.0,1,0.0,0.0,24,10,14,0.417,36,0.667,7,0.828,3.8,24,10,14,0.417,37,0.649,8,0.828,3.8,2020-21,Regular%20Season
202954,Brad Wanamaker,1610612766,CHA,51,23,28,917.0,18,11,7,0.611,71,0.254,6,0.277,11.3,87,17,69,0.195,149,0.584,10,0.626,10.8,105,28,76,0.267,219,0.479,16,0.517,10.9,2020-21,Regular%20Season
203078,Bradley Beal,1610612764,WAS,60,32,28,2147.0,72,28,44,0.389,168,0.429,10,0.456,9.0,211,40,171,0.19,350,0.603,34,0.668,7.4,283,68,215,0.24,510,0.555,44,0.607,7.8,2020-21,Regular%20Season
1629634,Brandon Clarke,1610612763,MEM,58,32,26,1399.0,97,63,33,0.649,215,0.451,1,0.453,5.4,231,64,167,0.277,391,0.591,44,0.666,5.3,328,127,200,0.387,580,0.566,45,0.613,5.3,2020-21,Regular%20Season
1629164,Brandon Goodwin,1610612737,ATL,30,17,13,508.0,8,1,7,0.125,37,0.216,0,0.216,10.1,61,6,55,0.098,96,0.635,8,0.693,8.0,69,7,62,0.101,131,0.527,8,0.561,8.2,2020-21,Regular%20Season
1627742,Brandon Ingram,1610612740,NOP,59,28,31,2024.0,34,15,19,0.441,86,0.395,0,0.395,12.8,264,54,210,0.205,393,0.672,32,0.731,6.4,298,69,229,0.232,475,0.627,32,0.673,7.1,2020-21,Regular%20Season
1628968,Brian Bowen II,1610612754,IND,3,0,3,11.0,0,0,0,0.0,1,0.0,0,0.0,0.0,3,1,2,0.333,3,1.0,0,1.0,2.7,3,1,2,0.333,4,0.75,0,0.75,2.7,2020-21,Regular%20Season
1630271,Brodric Thomas,1610612739,CLE,19,4,15,333.0,8,5,3,0.625,21,0.381,0,0.381,10.2,45,12,33,0.267,64,0.703,4,0.75,6.7,53,17,36,0.321,79,0.671,4,0.707,7.2,2020-21,Regular%20Season
201572,Brook Lopez,1610612749,MIL,70,46,24,1902.0,104,60,43,0.577,194,0.536,5,0.55,6.6,243,96,146,0.395,461,0.527,46,0.586,6.4,347,156,189,0.45,639,0.543,51,0.59,6.4,2020-21,Regular%20Season
1628971,Bruce Brown,1610612751,BKN,65,45,20,1451.0,111,64,45,0.577,264,0.42,7,0.432,6.1,238,40,198,0.168,393,0.606,25,0.647,6.2,349,104,243,0.298,645,0.541,32,0.569,6.2,2020-21,Regular%20Season
203998,Bruno Caboclo,1610612745,HOU,5,1,4,35.0,3,2,1,0.667,9,0.333,3,0.5,5.6,11,3,8,0.273,17,0.647,1,0.688,5.3,14,5,9,0.357,24,0.583,4,0.7,5.3,2020-21,Regular%20Season
1628981,Bruno Fernando,1610612737,ATL,22,11,11,198.0,16,13,3,0.813,50,0.32,1,0.327,4.0,62,12,50,0.194,89,0.697,7,0.756,5.0,78,25,53,0.321,133,0.586,8,0.624,4.8,2020-21,Regular%20Season
1627854,Bryn Forbes,1610612749,MIL,47,30,17,965.0,11,3,8,0.273,30,0.367,0,0.367,12.4,101,15,86,0.149,178,0.567,25,0.66,8.3,112,18,94,0.161,204,0.549,25,0.626,8.7,2020-21,Regular%20Season
1627741,Buddy Hield,1610612758,SAC,69,31,38,2374.0,29,12,17,0.414,80,0.363,2,0.372,12.9,305,66,239,0.216,500,0.61,50,0.678,7.3,334,78,256,0.234,579,0.577,52,0.634,7.8,2020-21,Regular%20Season
1629604,CJ Elleby,1610612757,POR,15,9,6,120.0,11,7,4,0.636,23,0.478,1,0.5,6.8,21,6,15,0.286,31,0.677,5,0.808,8.1,32,13,19,0.406,54,0.593,6,0.667,7.7,2020-21,Regular%20Season
203468,CJ McCollum,1610612757,POR,46,27,19,1581.0,30,9,20,0.3,79,0.38,5,0.405,11.2,155,17,138,0.11,269,0.576,24,0.633,9.1,185,26,158,0.141,342,0.541,29,0.591,9.4,2020-21,Regular%20Season
1628997,Caleb Martin,1610612766,CHA,40,15,25,714.0,31,15,16,0.484,65,0.477,2,0.492,11.7,110,25,85,0.227,178,0.618,16,0.679,7.7,141,40,101,0.284,241,0.585,18,0.632,8.6,2020-21,Regular%20Season
1629629,Cam Reddish,1610612737,ATL,25,10,15,729.0,22,6,16,0.273,44,0.5,3,0.537,11.3,82,18,63,0.22,120,0.683,8,0.732,8.6,104,24,79,0.231,162,0.642,11,0.689,9.2,2020-21,Regular%20Season
1629244,Cam Reynolds,1610612745,HOU,2,1,1,34.0,2,1,1,0.5,5,0.4,0,0.4,4.5,3,0,3,0.0,9,0.333,3,0.5,6.2,5,1,4,0.2,13,0.385,3,0.5,5.5,2020-21,Regular%20Season
1629661,Cameron Johnson,1610612756,PHX,58,41,17,1398.0,33,12,21,0.364,80,0.413,2,0.423,8.6,166,43,121,0.259,284,0.585,28,0.648,7.5,199,55,142,0.276,355,0.561,30,0.612,7.7,2020-21,Regular%20Season
1628419,Cameron Oliver,1610612745,HOU,4,1,3,87.0,5,3,2,0.6,10,0.5,0,0.5,12.8,16,4,12,0.25,34,0.471,4,0.533,4.6,21,7,14,0.333,43,0.488,4,0.538,6.6,2020-21,Regular%20Season
1626166,Cameron Payne,1610612756,PHX,55,39,16,1005.0,16,4,12,0.25,39,0.41,2,0.432,12.3,128,10,117,0.078,210,0.61,23,0.684,7.6,144,14,129,0.097,244,0.59,25,0.658,8.2,2020-21,Regular%20Season
1627747,Caris LeVert,1610612754,IND,47,24,23,1485.0,33,13,21,0.394,103,0.32,8,0.347,10.6,181,35,146,0.193,283,0.64,27,0.707,8.3,214,48,167,0.224,382,0.56,35,0.617,8.7,2020-21,Regular%20Season
2546,Carmelo Anthony,1610612757,POR,66,37,29,1622.0,32,21,11,0.656,79,0.405,3,0.421,8.1,182,36,146,0.198,285,0.639,22,0.692,6.6,214,57,157,0.266,353,0.606,25,0.652,6.8,2020-21,Regular%20Season
1629035,Carsen Edwards,1610612738,BOS,11,6,5,169.0,3,0,3,0.0,8,0.375,2,0.5,25.0,23,4,18,0.174,31,0.742,1,0.767,10.9,26,4,21,0.154,38,0.684,3,0.743,12.6,2020-21,Regular%20Season
1630199,Cassius Stanley,1610612754,IND,13,4,9,60.0,8,2,6,0.25,12,0.667,2,0.8,8.1,12,2,10,0.167,14,0.857,1,0.923,5.0,20,4,16,0.2,26,0.769,3,0.87,6.2,2020-21,Regular%20Season
1630216,Cassius Winston,1610612764,WAS,4,0,4,40.0,0,0,0,0.0,0,0.0,0,0.0,0.0,9,0,9,0.0,12,0.75,0,0.75,6.8,9,0,9,0.0,12,0.75,0,0.75,6.8,2020-21,Regular%20Season
1626224,Cedi Osman,1610612739,CLE,57,17,40,1485.0,38,13,26,0.342,88,0.432,4,0.452,10.1,163,23,140,0.141,244,0.668,17,0.718,7.7,201,36,166,0.179,327,0.615,21,0.657,8.1,2020-21,Regular%20Season
1628990,Chandler Hutchison,1610612764,WAS,22,8,14,320.0,6,3,3,0.5,26,0.231,0,0.231,6.4,72,10,61,0.139,104,0.692,9,0.758,4.9,78,13,64,0.167,124,0.629,9,0.678,5.0,2020-21,Regular%20Season
1629718,Charlie Brown Jr.,1610612760,OKC,7,1,6,133.0,3,0,2,0.0,12,0.25,2,0.3,19.1,14,5,11,0.357,19,0.737,1,0.778,7.3,17,5,13,0.294,30,0.567,3,0.63,8.9,2020-21,Regular%20Season
1626184,Chasson Randle,1610612753,ORL,34,9,25,769.0,7,4,4,0.571,20,0.35,1,0.368,17.2,75,10,65,0.133,119,0.63,8,0.676,9.3,82,14,69,0.171,138,0.594,9,0.636,10.1,2020-21,Regular%20Season
1629002,Chimezie Metu,1610612758,SAC,29,10,19,461.0,31,19,11,0.613,67,0.463,0,0.463,5.3,81,23,59,0.284,135,0.6,15,0.675,4.4,112,42,70,0.375,197,0.569,15,0.615,4.6,2020-21,Regular%20Season
1628449,Chris Boucher,1610612761,TOR,60,25,35,1453.0,117,81,35,0.692,285,0.411,7,0.421,4.4,287,76,210,0.265,509,0.564,49,0.624,4.5,404,157,245,0.389,763,0.529,56,0.571,4.5,2020-21,Regular%20Season
1629185,Chris Chiozza,1610612751,BKN,13,9,4,161.0,3,1,2,0.333,10,0.3,0,0.3,9.5,21,3,18,0.143,33,0.636,4,0.724,8.0,24,4,20,0.167,43,0.558,4,0.615,8.2,2020-21,Regular%20Season
101108,Chris Paul,1610612756,PHX,68,48,20,2142.0,25,10,15,0.4,51,0.49,2,0.51,14.8,287,37,246,0.129,457,0.628,44,0.695,8.3,312,47,261,0.151,504,0.619,46,0.681,8.8,2020-21,Regular%20Season
1629735,Chris Silva,1610612758,SAC,8,4,4,76.0,7,6,1,0.857,25,0.28,0,0.28,5.9,20,6,14,0.3,33,0.606,5,0.714,3.6,27,12,15,0.444,56,0.482,5,0.529,4.2,2020-21,Regular%20Season
1626174,Christian Wood,1610612745,HOU,41,12,29,1326.0,76,56,19,0.737,175,0.434,5,0.447,6.2,319,85,233,0.266,480,0.665,37,0.72,4.7,395,141,252,0.357,625,0.632,42,0.678,5.0,2020-21,Regular%20Season
1629643,Chuma Okeke,1610612753,ORL,44,15,29,1115.0,42,27,15,0.643,107,0.393,3,0.404,6.0,139,35,104,0.252,220,0.632,22,0.702,6.4,181,62,119,0.343,321,0.564,25,0.611,6.3,2020-21,Regular%20Season
203991,Clint Capela,1610612737,ATL,63,34,29,1898.0,297,225,69,0.758,549,0.541,9,0.55,5.1,606,205,400,0.338,940,0.645,90,0.713,4.7,903,430,469,0.476,1459,0.619,99,0.664,4.8,2020-21,Regular%20Season
1629632,Coby White,1610612741,CHI,68,30,38,2133.0,28,7,20,0.25,91,0.308,4,0.322,19.8,256,51,205,0.199,403,0.635,32,0.69,8.0,284,58,225,0.204,491,0.578,36,0.624,9.1,2020-21,Regular%20Season
1628998,Cody Martin,1610612766,CHA,44,22,22,801.0,52,31,20,0.596,100,0.52,2,0.531,8.1,109,17,92,0.156,192,0.568,20,0.634,7.4,161,48,112,0.298,284,0.567,22,0.615,7.6,2020-21,Regular%20Season
203469,Cody Zeller,1610612766,CHA,48,21,27,1005.0,119,82,34,0.689,260,0.458,4,0.465,4.1,209,77,133,0.368,345,0.606,36,0.676,4.6,328,159,167,0.485,593,0.553,40,0.593,4.4,2020-21,Regular%20Season
1630175,Cole Anthony,1610612753,ORL,47,13,34,1273.0,38,22,17,0.579,122,0.311,9,0.336,8.5,183,35,148,0.191,304,0.602,33,0.675,6.5,221,57,165,0.258,422,0.524,42,0.582,6.9,2020-21,Regular%20Season
1629012,Collin Sexton,1610612739,CLE,57,18,39,2008.0,58,31,26,0.534,170,0.341,9,0.36,10.1,129,21,108,0.163,236,0.547,26,0.614,10.7,187,52,134,0.278,404,0.463,35,0.507,10.5,2020-21,Regular%20Season
202709,Cory Joseph,1610612765,DET,58,23,35,1355.0,35,11,24,0.314,92,0.38,7,0.412,12.6,123,28,95,0.228,262,0.469,41,0.557,8.6,158,39,119,0.247,351,0.45,48,0.521,9.5,2020-21,Regular%20Season
1626245,Cristiano Felicio,1610612741,CHI,10,2,8,69.0,10,8,2,0.8,21,0.476,0,0.476,3.6,16,6,10,0.375,26,0.615,5,0.762,4.1,26,14,12,0.538,45,0.578,5,0.65,3.9,2020-21,Regular%20Season
1626156,D'Angelo Russell,1610612750,MIN,39,15,24,1126.0,16,2,14,0.125,46,0.348,0,0.348,15.4,95,13,82,0.137,168,0.565,15,0.621,8.4,111,15,96,0.135,211,0.526,15,0.566,9.4,2020-21,Regular%20Season
201571,D.J. Augustin,1610612745,HOU,42,24,18,881.0,20,5,14,0.25,34,0.588,3,0.645,19.4,74,7,67,0.095,113,0.655,10,0.718,10.7,94,12,81,0.128,146,0.644,13,0.707,12.5,2020-21,Regular%20Season
1628391,D.J. Wilson,1610612745,HOU,33,12,21,418.0,20,15,5,0.75,56,0.357,2,0.37,4.8,92,24,68,0.261,146,0.63,18,0.719,4.4,112,39,73,0.348,196,0.571,20,0.636,4.5,2020-21,Regular%20Season
1629610,DaQuan Jeffries,1610612759,SAS,25,5,20,444.0,19,9,10,0.474,43,0.442,1,0.452,12.1,52,8,44,0.154,82,0.634,5,0.675,8.3,71,17,54,0.239,119,0.597,6,0.628,9.3,2020-21,Regular%20Season
1629751,Dakota Mathias,1610612755,PHI,6,2,4,117.0,1,0,1,0.0,2,0.5,0,0.5,27.0,6,0,6,0.0,17,0.353,0,0.353,10.8,7,0,7,0.0,19,0.368,0,0.368,13.1,2020-21,Regular%20Season
1627745,Damian Jones,1610612758,SAC,35,21,14,524.0,36,22,14,0.611,84,0.429,2,0.439,5.4,85,23,62,0.271,156,0.545,18,0.616,6.0,121,45,76,0.372,232,0.522,20,0.571,5.8,2020-21,Regular%20Season
203081,Damian Lillard,1610612757,POR,66,39,27,2369.0,32,17,15,0.531,118,0.271,4,0.281,10.9,251,28,223,0.112,383,0.655,27,0.705,9.0,283,45,238,0.159,495,0.572,31,0.61,9.2,2020-21,Regular%20Season
1627814,Damion Lee,1610612744,GSW,53,26,27,1001.0,22,9,12,0.409,48,0.458,0,0.458,12.6,158,39,115,0.247,243,0.65,23,0.718,6.0,180,48,127,0.267,277,0.65,23,0.709,6.8,2020-21,Regular%20Season
1628422,Damyean Dotson,1610612739,CLE,42,14,28,828.0,5,1,4,0.2,26,0.192,3,0.217,11.2,88,15,73,0.17,138,0.638,9,0.682,7.8,93,16,77,0.172,157,0.592,12,0.641,8.0,2020-21,Regular%20Season
1629655,Daniel Gafford,1610612764,WAS,52,30,22,778.0,94,69,24,0.734,198,0.475,4,0.485,4.3,137,60,75,0.438,276,0.496,40,0.581,4.2,231,129,99,0.558,462,0.5,44,0.553,4.2,2020-21,Regular%20Season
1630187,Daniel Oturu,1610612746,LAC,18,13,5,144.0,21,11,5,0.524,44,0.477,2,0.5,9.9,27,5,19,0.185,37,0.73,3,0.794,10.6,48,16,24,0.333,77,0.623,5,0.667,9.9,2020-21,Regular%20Season
1628464,Daniel Theis,1610612741,CHI,63,27,36,1583.0,93,63,30,0.677,204,0.456,4,0.465,5.7,263,88,175,0.335,481,0.547,58,0.622,4.7,356,151,205,0.424,675,0.527,62,0.581,5.0,2020-21,Regular%20Season
201568,Danilo Gallinari,1610612737,ATL,48,28,20,1164.0,17,11,5,0.647,49,0.347,1,0.354,8.0,194,46,150,0.237,299,0.649,17,0.688,5.8,211,57,155,0.27,340,0.621,18,0.655,5.9,2020-21,Regular%20Season
201980,Danny Green,1610612755,PHI,66,44,22,1870.0,55,22,34,0.4,121,0.455,8,0.487,12.1,205,49,155,0.239,346,0.592,29,0.647,7.0,260,71,189,0.273,461,0.564,37,0.613,8.1,2020-21,Regular%20Season
203957,Dante Exum,1610612745,HOU,5,3,2,115.0,2,1,1,0.5,7,0.286,0,0.286,9.9,15,1,14,0.067,22,0.682,1,0.714,7.4,17,2,15,0.118,26,0.654,1,0.68,7.7,2020-21,Regular%20Season
1627863,Danuel House Jr.,1610612745,HOU,36,8,28,932.0,18,7,11,0.389,50,0.36,3,0.383,10.5,114,27,87,0.237,176,0.648,14,0.704,6.9,132,34,98,0.258,218,0.606,17,0.657,7.4,2020-21,Regular%20Season
203967,Dario Saric,1610612756,PHX,47,36,11,846.0,46,26,20,0.565,131,0.351,7,0.371,5.5,144,27,118,0.188,260,0.554,29,0.623,5.2,190,53,138,0.279,381,0.499,36,0.551,5.2,2020-21,Regular%20Season
1629647,Darius Bazley,1610612760,OKC,55,16,39,1714.0,51,28,22,0.549,152,0.336,4,0.345,6.8,345,76,269,0.22,509,0.678,38,0.732,4.7,396,104,291,0.263,631,0.628,42,0.672,5.0,2020-21,Regular%20Season
1629636,Darius Garland,1610612739,CLE,48,16,32,1650.0,23,6,17,0.261,61,0.377,2,0.39,12.4,106,14,92,0.132,179,0.592,10,0.627,10.7,129,20,109,0.155,238,0.542,12,0.571,11.0,2020-21,Regular%20Season
203121,Darius Miller,1610612760,OKC,13,4,9,168.0,2,1,1,0.5,6,0.333,0,0.333,16.5,22,3,19,0.136,29,0.759,0,0.759,7.3,24,4,20,0.167,35,0.686,0,0.686,8.0,2020-21,Regular%20Season
1628021,David Nwaba,1610612745,HOU,27,7,20,623.0,37,23,14,0.622,88,0.42,1,0.425,7.1,74,8,66,0.108,134,0.552,9,0.592,8.4,111,31,80,0.279,215,0.516,10,0.541,8.0,2020-21,Regular%20Season
202722,Davis Bertans,1610612764,WAS,51,27,24,1337.0,18,9,9,0.5,49,0.367,2,0.383,14.0,150,34,116,0.227,249,0.602,18,0.649,6.9,168,43,125,0.256,285,0.589,20,0.634,7.6,2020-21,Regular%20Season
1628368,De'Aaron Fox,1610612758,SAC,54,22,32,1934.0,33,9,23,0.273,95,0.347,7,0.375,15.4,170,24,147,0.141,282,0.603,28,0.669,8.9,203,33,170,0.163,373,0.544,35,0.601,9.9,2020-21,Regular%20Season
1629631,De'Andre Hunter,1610612737,ATL,23,12,11,678.0,17,7,11,0.412,50,0.34,2,0.354,11.4,93,21,72,0.226,164,0.567,15,0.624,6.2,110,28,83,0.255,207,0.531,17,0.579,7.0,2020-21,Regular%20Season
1629001,De'Anthony Melton,1610612763,MEM,47,24,23,953.0,30,14,15,0.467,87,0.345,1,0.349,8.6,131,39,92,0.298,217,0.604,16,0.652,6.6,161,53,107,0.329,298,0.54,17,0.573,7.0,2020-21,Regular%20Season
201599,DeAndre Jordan,1610612751,BKN,57,37,20,1246.0,117,73,43,0.624,246,0.476,10,0.496,5.6,310,77,231,0.248,459,0.675,28,0.719,4.5,427,150,274,0.351,675,0.633,38,0.67,4.8,2020-21,Regular%20Season
1627761,DeAndre' Bembry,1610612761,TOR,43,19,24,916.0,33,19,14,0.576,77,0.429,3,0.446,6.8,113,24,89,0.212,179,0.631,13,0.681,6.9,146,43,103,0.295,252,0.579,16,0.619,6.9,2020-21,Regular%20Season
201942,DeMar DeRozan,1610612759,SAS,60,27,33,2019.0,40,13,26,0.325,124,0.323,5,0.336,11.0,219,35,184,0.16,335,0.654,21,0.697,8.0,259,48,210,0.185,442,0.586,26,0.623,8.5,2020-21,Regular%20Season
202326,DeMarcus Cousins,1610612746,LAC,41,22,19,713.0,53,30,20,0.566,125,0.424,2,0.431,6.0,210,52,146,0.248,295,0.712,14,0.747,4.6,263,82,166,0.312,401,0.656,16,0.683,4.9,2020-21,Regular%20Season
1629731,Dean Wade,1610612739,CLE,51,16,35,1120.0,38,22,15,0.579,91,0.418,3,0.432,5.9,177,49,129,0.277,286,0.619,22,0.67,5.7,215,71,144,0.33,367,0.586,25,0.629,5.8,2020-21,Regular%20Season
1629028,Deandre Ayton,1610612756,PHX,69,48,21,2115.0,228,164,58,0.719,430,0.53,6,0.538,5.4,499,161,332,0.323,743,0.672,68,0.739,4.3,727,325,390,0.447,1132,0.642,74,0.687,4.6,2020-21,Regular%20Season
1629686,Deividas Sirvydis,1610612765,DET,11,4,7,120.0,0,0,0,0.0,10,0.0,0,0.0,0.0,29,6,23,0.207,38,0.763,2,0.806,5.7,29,6,23,0.207,45,0.644,2,0.674,5.7,2020-21,Regular%20Season
1627749,Dejounte Murray,1610612759,SAS,66,32,34,2138.0,58,29,28,0.5,159,0.365,9,0.387,9.9,415,78,336,0.188,627,0.662,59,0.731,5.4,473,107,364,0.226,777,0.609,68,0.667,5.9,2020-21,Regular%20Season
1626153,Delon Wright,1610612758,SAC,61,20,41,1718.0,65,28,36,0.431,157,0.414,1,0.417,9.1,204,26,178,0.127,324,0.63,38,0.713,8.8,269,54,214,0.201,474,0.568,39,0.618,8.9,2020-21,Regular%20Season
1630166,Deni Avdija,1610612764,WAS,53,25,28,1241.0,22,11,12,0.5,69,0.319,3,0.333,9.0,240,61,178,0.254,384,0.625,38,0.694,4.6,262,72,190,0.275,442,0.593,41,0.653,5.0,2020-21,Regular%20Season
203471,Dennis Schroder,1610612747,LAL,61,38,23,1956.0,30,11,19,0.367,95,0.316,4,0.33,14.7,181,21,160,0.116,310,0.584,34,0.656,9.4,211,32,179,0.152,400,0.528,38,0.583,10.1,2020-21,Regular%20Season
1628372,Dennis Smith Jr.,1610612765,DET,17,5,12,340.0,12,6,6,0.5,29,0.414,1,0.429,8.6,43,14,29,0.326,75,0.573,13,0.694,6.2,55,20,35,0.364,104,0.529,14,0.611,6.7,2020-21,Regular%20Season
1627756,Denzel Valentine,1610612741,CHI,54,22,32,976.0,24,2,22,0.083,56,0.429,4,0.462,13.7,173,55,118,0.318,289,0.599,27,0.66,5.6,197,57,140,0.289,340,0.579,31,0.638,6.6,2020-21,Regular%20Season
202324,Derrick Favors,1610612762,UTA,68,49,19,1039.0,138,101,37,0.732,275,0.502,11,0.523,5.0,238,87,151,0.366,380,0.626,35,0.69,4.5,376,188,188,0.5,644,0.584,46,0.629,4.7,2020-21,Regular%20Season
1627884,Derrick Jones Jr.,1610612757,POR,52,29,23,1262.0,77,46,31,0.597,151,0.51,5,0.527,6.4,128,40,88,0.313,211,0.607,19,0.667,7.6,205,86,119,0.42,351,0.584,24,0.627,7.1,2020-21,Regular%20Season
201565,Derrick Rose,1610612752,NYK,47,27,20,1214.0,20,5,14,0.25,55,0.364,1,0.37,10.9,110,11,97,0.1,181,0.608,13,0.655,11.6,130,16,111,0.123,233,0.558,14,0.594,11.5,2020-21,Regular%20Season
1628401,Derrick White,1610612759,SAS,35,18,17,1036.0,13,3,10,0.231,63,0.206,3,0.217,16.4,94,20,73,0.213,163,0.577,17,0.644,7.5,107,23,83,0.215,222,0.482,20,0.53,8.6,2020-21,Regular%20Season
1630217,Desmond Bane,1610612763,MEM,67,36,31,1490.0,31,12,19,0.387,86,0.36,1,0.365,11.9,179,33,145,0.184,278,0.644,28,0.716,7.0,210,45,164,0.214,356,0.59,29,0.642,7.7,2020-21,Regular%20Season
1626164,Devin Booker,1610612756,PHX,65,48,17,2201.0,34,14,19,0.412,109,0.312,7,0.333,11.8,247,37,207,0.15,390,0.633,40,0.706,8.1,281,51,226,0.181,486,0.578,47,0.64,8.5,2020-21,Regular%20Season
1629962,Devin Cannady,1610612753,ORL,2,0,2,40.0,0,0,0,0.0,1,0.0,0,0.0,0.0,5,3,2,0.6,6,0.833,0,0.833,6.2,5,3,2,0.6,7,0.714,0,0.714,6.2,2020-21,Regular%20Season
1630170,Devin Vassell,1610612759,SAS,57,27,30,1017.0,24,9,15,0.375,46,0.522,0,0.522,9.9,150,35,116,0.233,240,0.625,21,0.685,6.2,174,44,131,0.253,283,0.615,21,0.664,6.7,2020-21,Regular%20Season
1629653,Devon Dotson,1610612741,CHI,4,1,3,35.0,2,1,1,0.5,4,0.5,0,0.5,11.9,3,2,1,0.667,4,0.75,1,1.0,8.8,5,3,2,0.6,8,0.625,1,0.714,10.0,2020-21,Regular%20Season
1629719,Devontae Cacok,1610612747,LAL,13,5,8,75.0,10,6,4,0.6,30,0.333,0,0.333,3.6,20,1,19,0.05,27,0.741,1,0.769,4.9,30,7,23,0.233,50,0.6,1,0.612,4.5,2020-21,Regular%20Season
1628984,Devonte' Graham,1610612766,CHA,51,21,30,1541.0,22,4,18,0.182,62,0.355,2,0.367,18.0,126,16,110,0.127,228,0.553,19,0.603,9.1,148,20,128,0.135,284,0.521,21,0.563,10.5,2020-21,Regular%20Season
203473,Dewayne Dedmon,1610612748,MIA,16,11,5,210.0,28,19,9,0.679,53,0.528,0,0.528,4.9,58,18,40,0.31,88,0.659,8,0.725,4.8,86,37,49,0.43,133,0.647,8,0.688,4.8,2020-21,Regular%20Season
1629712,Didi Louzada,1610612740,NOP,3,0,3,56.0,1,1,0,1.0,3,0.333,0,0.333,4.9,2,0,2,0.0,5,0.4,2,0.667,5.6,3,1,2,0.333,8,0.375,2,0.5,5.4,2020-21,Regular%20Season
1628415,Dillon Brooks,1610612763,MEM,64,35,29,1914.0,53,26,26,0.491,114,0.465,4,0.482,11.2,143,22,121,0.154,249,0.574,26,0.641,8.7,196,48,147,0.245,357,0.549,30,0.599,9.4,2020-21,Regular%20Season
1627734,Domantas Sabonis,1610612754,IND,62,29,33,2231.0,150,105,45,0.7,412,0.364,9,0.372,5.2,592,156,435,0.264,886,0.668,69,0.725,4.0,742,261,480,0.352,1254,0.592,78,0.631,4.3,2020-21,Regular%20Season
1628378,Donovan Mitchell,1610612762,UTA,52,39,13,1736.0,50,29,22,0.58,123,0.407,5,0.424,9.1,185,28,157,0.151,296,0.625,19,0.668,9.8,235,57,179,0.243,411,0.572,24,0.607,9.6,2020-21,Regular%20Season
1629743,Donta Hall,1610612753,ORL,12,3,9,172.0,24,16,8,0.667,41,0.585,0,0.585,4.8,38,16,22,0.421,67,0.567,10,0.667,4.8,62,32,30,0.516,106,0.585,10,0.646,4.8,2020-21,Regular%20Season
1628978,Donte DiVincenzo,1610612749,MIL,66,44,22,1815.0,81,51,29,0.63,155,0.523,4,0.536,7.5,299,46,253,0.154,474,0.631,50,0.705,6.1,380,97,282,0.255,621,0.612,54,0.67,6.4,2020-21,Regular%20Season
1627827,Dorian Finney-Smith,1610612742,DAL,59,36,23,1898.0,98,58,39,0.592,197,0.497,7,0.516,7.7,228,59,169,0.259,398,0.573,45,0.646,5.9,326,117,208,0.359,577,0.565,52,0.621,6.4,2020-21,Regular%20Season
203926,Doug McDermott,1610612754,IND,64,31,33,1575.0,60,33,26,0.55,145,0.414,2,0.42,6.6,161,34,127,0.211,285,0.565,30,0.631,6.7,221,67,153,0.303,417,0.53,32,0.574,6.7,2020-21,Regular%20Season
203110,Draymond Green,1610612744,GSW,62,35,27,1965.0,55,36,18,0.655,128,0.43,4,0.444,7.0,393,101,294,0.257,657,0.598,69,0.668,5.7,448,137,312,0.306,745,0.601,73,0.667,5.9,2020-21,Regular%20Season
1629234,Drew Eubanks,1610612759,SAS,52,21,31,751.0,74,45,29,0.608,172,0.43,5,0.443,5.9,167,49,118,0.293,284,0.588,38,0.679,4.1,241,94,147,0.39,439,0.549,43,0.609,4.6,2020-21,Regular%20Season
1629130,Duncan Robinson,1610612748,MIA,69,39,30,2184.0,7,1,6,0.143,41,0.171,2,0.179,24.0,243,39,204,0.16,415,0.586,45,0.657,7.9,250,40,210,0.16,449,0.557,47,0.622,8.4,2020-21,Regular%20Season
1628407,Dwayne Bacon,1610612753,ORL,69,19,50,1803.0,31,16,15,0.516,95,0.326,6,0.348,9.7,193,33,160,0.171,302,0.639,32,0.715,7.1,224,49,175,0.219,390,0.574,38,0.636,7.5,2020-21,Regular%20Season
2730,Dwight Howard,1610612755,PHI,69,46,23,1195.0,190,149,40,0.784,427,0.445,10,0.456,3.6,390,107,284,0.274,605,0.645,46,0.698,3.9,580,256,324,0.441,994,0.584,56,0.618,3.8,2020-21,Regular%20Season
203939,Dwight Powell,1610612742,DAL,53,31,22,933.0,80,51,30,0.638,197,0.406,7,0.421,6.6,154,37,118,0.24,267,0.577,23,0.631,6.5,234,88,148,0.376,455,0.514,30,0.551,6.5,2020-21,Regular%20Season
1629685,Dylan Windler,1610612739,CLE,28,10,18,481.0,20,11,9,0.55,56,0.357,3,0.377,7.4,87,18,69,0.207,139,0.626,14,0.696,6.6,107,29,78,0.271,185,0.578,17,0.637,6.8,2020-21,Regular%20Season
202734,E'Twaun Moore,1610612756,PHX,22,16,6,348.0,14,8,6,0.571,29,0.483,0,0.483,11.6,31,11,20,0.355,49,0.633,1,0.646,7.8,45,19,26,0.422,77,0.584,1,0.592,9.0,2020-21,Regular%20Season
202334,Ed Davis,1610612750,MIN,22,4,18,298.0,46,27,16,0.587,100,0.46,1,0.465,6.9,69,21,49,0.304,113,0.611,13,0.69,4.7,115,48,65,0.417,203,0.567,14,0.608,5.5,2020-21,Regular%20Season
1628410,Edmond Sumner,1610612754,IND,39,15,24,734.0,18,11,7,0.611,58,0.31,2,0.321,7.5,76,17,59,0.224,123,0.618,13,0.691,7.9,94,28,66,0.298,179,0.525,15,0.573,7.8,2020-21,Regular%20Season
203901,Elfrid Payton,1610612752,NYK,61,34,27,1456.0,64,34,29,0.531,151,0.424,10,0.454,10.1,152,19,133,0.125,224,0.679,18,0.738,8.6,216,53,162,0.245,370,0.584,28,0.632,9.0,2020-21,Regular%20Season
1629091,Elijah Bryant,1610612749,MIL,1,0,1,32.0,2,1,1,0.5,2,1.0,0,1.0,3.9,4,1,3,0.25,5,0.8,1,1.0,6.4,6,2,4,0.333,7,0.857,1,1.0,5.6,2020-21,Regular%20Season
1630190,Elijah Hughes,1610612762,UTA,6,4,2,23.0,1,0,1,0.0,1,1.0,0,1.0,17.0,8,1,7,0.125,11,0.727,0,0.727,6.6,9,1,8,0.111,12,0.75,0,0.75,7.8,2020-21,Regular%20Season
202683,Enes Freedom,1610612757,POR,72,42,30,1757.0,284,229,52,0.806,683,0.416,19,0.428,4.0,511,149,362,0.292,785,0.651,72,0.717,4.0,795,378,414,0.475,1431,0.556,91,0.593,4.0,2020-21,Regular%20Season
202339,Eric Bledsoe,1610612740,NOP,70,31,39,2087.0,29,8,21,0.276,81,0.358,5,0.382,17.1,215,22,190,0.102,343,0.627,31,0.689,8.6,244,30,211,0.123,421,0.58,36,0.634,9.6,2020-21,Regular%20Season
201569,Eric Gordon,1610612745,HOU,22,8,14,656.0,8,2,7,0.25,24,0.333,2,0.364,19.4,50,7,45,0.14,84,0.595,6,0.641,11.0,58,9,52,0.155,105,0.552,8,0.598,12.8,2020-21,Regular%20Season
1629672,Eric Paschall,1610612744,GSW,38,19,19,666.0,28,12,15,0.429,55,0.509,1,0.519,6.0,100,30,68,0.3,177,0.565,19,0.633,6.0,128,42,83,0.328,226,0.566,20,0.621,6.0,2020-21,Regular%20Season
101141,Ersan Ilyasova,1610612762,UTA,12,9,3,124.0,7,4,3,0.571,19,0.368,1,0.389,7.5,22,4,18,0.182,33,0.667,5,0.786,4.8,29,8,21,0.276,50,0.58,6,0.659,5.5,2020-21,Regular%20Season
203095,Evan Fournier,1610612738,BOS,39,15,24,1174.0,10,4,6,0.4,45,0.222,2,0.233,10.4,118,23,95,0.195,193,0.611,17,0.67,8.9,128,27,101,0.211,230,0.557,19,0.607,9.0,2020-21,Regular%20Season
1630267,Facundo Campazzo,1610612743,DEN,51,35,16,1283.0,22,6,15,0.273,57,0.386,0,0.386,15.0,111,14,96,0.126,161,0.689,9,0.73,10.8,133,20,111,0.15,212,0.627,9,0.655,11.4,2020-21,Regular%20Season
1628402,Frank Jackson,1610612765,DET,32,10,22,680.0,15,7,8,0.467,39,0.385,4,0.429,10.6,71,16,55,0.225,99,0.717,7,0.772,10.8,86,23,63,0.267,137,0.628,11,0.683,10.7,2020-21,Regular%20Season
1626163,Frank Kaminsky,1610612756,PHX,45,31,14,703.0,36,26,10,0.722,95,0.379,3,0.391,6.4,152,41,109,0.27,251,0.606,27,0.679,4.9,188,67,119,0.356,343,0.548,30,0.601,5.2,2020-21,Regular%20Season
1628412,Frank Mason III,1610612753,ORL,3,1,2,75.0,3,2,1,0.667,10,0.3,0,0.3,10.9,9,1,8,0.111,9,1.0,0,1.0,9.5,12,3,9,0.25,19,0.632,0,0.632,9.9,2020-21,Regular%20Season
1628373,Frank Ntilikina,1610612752,NYK,16,10,6,216.0,6,2,4,0.333,12,0.5,0,0.5,12.9,25,3,22,0.12,38,0.658,3,0.714,11.1,31,5,26,0.161,48,0.646,3,0.689,11.4,2020-21,Regular%20Season
1627832,Fred VanVleet,1610612761,TOR,50,21,29,1831.0,32,19,14,0.594,102,0.314,4,0.327,13.0,188,42,148,0.223,327,0.575,27,0.627,8.5,220,61,162,0.277,425,0.518,31,0.558,9.2,2020-21,Regular%20Season
1630273,Freddie Gillespie,1610612761,TOR,20,7,13,392.0,42,32,10,0.762,119,0.353,2,0.359,4.1,55,21,33,0.382,119,0.462,18,0.545,4.6,97,53,43,0.546,235,0.413,20,0.451,4.4,2020-21,Regular%20Season
1627788,Furkan Korkmaz,1610612755,PHI,45,33,12,891.0,17,3,14,0.176,52,0.327,1,0.333,13.6,96,19,77,0.198,155,0.619,10,0.662,8.2,113,22,91,0.195,192,0.589,11,0.624,9.0,2020-21,Regular%20Season
1629216,Gabe Vincent,1610612748,MIA,29,14,15,459.0,10,5,6,0.5,25,0.4,1,0.417,11.3,46,11,35,0.239,80,0.575,8,0.639,9.3,56,16,41,0.286,105,0.533,9,0.583,9.7,2020-21,Regular%20Season
1630466,Gabriel Deck,1610612760,OKC,9,0,9,193.0,16,11,5,0.688,23,0.696,0,0.696,7.8,23,7,16,0.304,37,0.622,5,0.719,5.9,39,18,21,0.462,58,0.672,5,0.736,6.7,2020-21,Regular%20Season
202066,Garrett Temple,1610612741,CHI,53,25,28,1483.0,29,10,19,0.345,65,0.446,1,0.453,12.5,131,24,106,0.183,226,0.58,20,0.636,8.3,160,34,125,0.213,286,0.559,21,0.604,9.1,2020-21,Regular%20Season
1629726,Garrison Mathews,1610612764,WAS,43,21,22,784.0,16,6,10,0.375,34,0.471,1,0.485,11.5,71,12,58,0.169,101,0.703,6,0.747,8.1,87,18,68,0.207,132,0.659,7,0.696,8.7,2020-21,Regular%20Season
1629109,Gary Clark,1610612755,PHI,35,11,24,618.0,33,20,13,0.606,76,0.434,7,0.478,8.4,82,13,69,0.159,126,0.651,13,0.726,6.1,115,33,82,0.287,200,0.575,20,0.639,6.8,2020-21,Regular%20Season
203914,Gary Harris,1610612753,ORL,34,15,19,968.0,21,7,14,0.333,56,0.375,3,0.396,10.8,58,10,49,0.172,93,0.624,4,0.652,9.9,79,17,63,0.215,146,0.541,7,0.568,10.1,2020-21,Regular%20Season
1627780,Gary Payton II,1610612744,GSW,6,4,2,38.0,2,1,1,0.5,5,0.4,0,0.4,9.8,9,2,7,0.222,12,0.75,1,0.818,5.7,11,3,8,0.273,17,0.647,1,0.688,6.5,2020-21,Regular%20Season
1629018,Gary Trent Jr.,1610612761,TOR,55,28,27,1725.0,27,14,13,0.519,55,0.491,1,0.5,13.6,125,19,105,0.152,191,0.654,15,0.71,8.2,152,33,118,0.217,244,0.623,16,0.667,9.1,2020-21,Regular%20Season
201588,George Hill,1610612755,PHI,24,14,10,530.0,16,9,7,0.563,34,0.471,0,0.471,6.8,45,5,40,0.111,80,0.563,3,0.584,8.4,61,14,47,0.23,113,0.54,3,0.555,8.0,2020-21,Regular%20Season
1627777,Georges Niang,1610612762,UTA,64,46,18,1064.0,28,11,16,0.393,57,0.491,1,0.5,12.0,148,36,112,0.243,243,0.609,17,0.655,6.8,176,47,128,0.267,293,0.601,18,0.64,7.6,2020-21,Regular%20Season
203507,Giannis Antetokounmpo,1610612749,MIL,60,40,20,2012.0,97,56,39,0.577,245,0.396,8,0.409,8.6,574,125,448,0.218,784,0.732,47,0.779,5.3,671,181,487,0.27,997,0.673,55,0.712,5.7,2020-21,Regular%20Season
203922,Glenn Robinson III,1610612758,SAC,17,5,12,309.0,11,7,4,0.636,35,0.314,3,0.344,9.4,34,7,27,0.206,55,0.618,3,0.654,7.5,45,14,31,0.311,89,0.506,6,0.542,8.0,2020-21,Regular%20Season
1629048,Goga Bitadze,1610612754,IND,40,16,24,548.0,60,39,21,0.65,139,0.432,6,0.451,4.1,90,27,63,0.3,180,0.5,25,0.581,4.7,150,66,84,0.44,309,0.485,31,0.54,4.5,2020-21,Regular%20Season
201609,Goran Dragic,1610612748,MIA,46,28,18,1248.0,25,9,16,0.36,77,0.325,2,0.333,13.6,144,26,118,0.181,238,0.605,19,0.658,8.4,169,35,134,0.207,312,0.542,21,0.581,9.2,2020-21,Regular%20Season
202330,Gordon Hayward,1610612766,CHA,44,24,20,1496.0,37,20,17,0.541,110,0.336,7,0.359,8.9,221,38,180,0.172,330,0.67,22,0.718,7.1,258,58,197,0.225,421,0.613,29,0.658,7.3,2020-21,Regular%20Season
203476,Gorgui Dieng,1610612759,SAS,31,11,20,515.0,40,28,12,0.7,97,0.412,1,0.417,5.6,100,23,77,0.23,160,0.625,12,0.676,5.1,140,51,89,0.364,246,0.569,13,0.601,5.2,2020-21,Regular%20Season
1630203,Grant Riller,1610612766,CHA,1,0,1,2.0,0,0,0,0.0,0,0.0,0,0.0,0.0,1,0,1,0.0,1,1.0,0,1.0,7.8,1,0,1,0.0,1,1.0,0,1.0,7.8,2020-21,Regular%20Season
1629684,Grant Williams,1610612738,BOS,56,24,32,1081.0,48,23,26,0.479,122,0.393,3,0.403,7.8,130,35,96,0.269,236,0.551,25,0.616,5.8,178,58,122,0.326,347,0.513,28,0.558,6.3,2020-21,Regular%20Season
1628960,Grayson Allen,1610612763,MEM,45,23,22,1158.0,19,3,17,0.158,41,0.463,1,0.475,14.0,141,15,126,0.106,220,0.641,20,0.705,7.1,160,18,143,0.113,255,0.627,21,0.684,8.0,2020-21,Regular%20Season
1628977,Hamidou Diallo,1610612765,DET,52,18,34,1226.0,59,41,16,0.695,139,0.424,1,0.428,7.6,213,52,161,0.244,298,0.715,14,0.75,5.6,272,93,177,0.342,427,0.637,15,0.66,6.0,2020-21,Regular%20Season
203084,Harrison Barnes,1610612758,SAC,57,24,33,2065.0,64,36,29,0.563,170,0.376,6,0.39,7.7,321,87,233,0.271,487,0.659,40,0.718,5.4,385,123,262,0.319,635,0.606,46,0.654,5.8,2020-21,Regular%20Season
1628385,Harry Giles III,1610612757,POR,33,20,13,329.0,31,21,10,0.677,75,0.413,2,0.425,6.5,102,37,65,0.363,141,0.723,6,0.756,4.6,133,58,75,0.436,201,0.662,8,0.689,5.1,2020-21,Regular%20Season
202355,Hassan Whiteside,1610612758,SAC,34,16,18,540.0,61,50,10,0.82,149,0.409,6,0.427,4.2,154,55,99,0.357,220,0.7,13,0.744,3.9,215,105,109,0.488,357,0.602,19,0.636,4.0,2020-21,Regular%20Season
1627740,Henry Ellenson,1610612761,TOR,2,0,2,38.0,3,1,2,0.333,6,0.5,0,0.5,8.9,9,3,6,0.333,13,0.692,0,0.692,7.8,12,4,8,0.333,18,0.667,0,0.667,8.1,2020-21,Regular%20Season
1629649,Ignas Brazdeikis,1610612753,ORL,11,2,9,244.0,11,5,6,0.455,26,0.423,1,0.44,5.7,34,8,26,0.235,57,0.596,6,0.667,6.7,45,13,32,0.289,83,0.542,7,0.592,6.4,2020-21,Regular%20Season
202697,Iman Shumpert,1610612751,BKN,1,1,0,6.0,1,0,1,0.0,1,1.0,0,1.0,8.0,0,0,0,0.0,0,0.0,0,0.0,0.0,1,0,1,0.0,1,1.0,0,1.0,8.0,2020-21,Regular%20Season
1630193,Immanuel Quickley,1610612752,NYK,54,29,25,1101.0,25,6,18,0.24,67,0.373,3,0.391,10.6,112,14,98,0.125,169,0.663,14,0.723,8.9,137,20,116,0.146,231,0.593,17,0.64,9.2,2020-21,Regular%20Season
1629067,Isaac Bonga,1610612764,WAS,27,8,19,361.0,18,9,9,0.5,34,0.529,1,0.545,11.2,48,12,36,0.25,82,0.585,7,0.64,8.5,66,21,45,0.318,113,0.584,8,0.629,9.2,2020-21,Regular%20Season
1630171,Isaac Okoro,1610612739,CLE,64,20,44,2092.0,68,35,32,0.515,178,0.382,7,0.398,12.1,138,34,104,0.246,249,0.554,28,0.624,9.2,206,69,136,0.335,420,0.49,35,0.535,10.1,2020-21,Regular%20Season
1628392,Isaiah Hartenstein,1610612739,CLE,45,20,25,548.0,65,45,20,0.692,176,0.369,4,0.378,4.2,116,36,80,0.31,210,0.552,19,0.607,5.6,181,81,100,0.448,371,0.488,23,0.52,5.1,2020-21,Regular%20Season
1630198,Isaiah Joe,1610612755,PHI,21,14,7,250.0,6,0,6,0.0,12,0.5,0,0.5,19.2,30,3,27,0.1,47,0.638,3,0.682,8.5,36,3,33,0.083,57,0.632,3,0.667,10.3,2020-21,Regular%20Season
1629676,Isaiah Roby,1610612760,OKC,59,17,42,1409.0,89,53,36,0.596,206,0.432,9,0.452,7.2,247,63,183,0.255,404,0.611,38,0.675,5.5,336,116,219,0.345,591,0.569,47,0.618,5.9,2020-21,Regular%20Season
1630191,Isaiah Stewart,1610612765,DET,66,19,47,1440.0,159,118,38,0.742,396,0.402,8,0.41,3.9,294,94,195,0.32,550,0.535,63,0.604,4.4,453,212,233,0.468,911,0.497,71,0.539,4.2,2020-21,Regular%20Season
202738,Isaiah Thomas,1610612740,NOP,2,1,1,29.0,1,0,1,0.0,1,1.0,0,1.0,14.0,3,0,3,0.0,6,0.5,1,0.6,9.9,4,0,4,0.0,7,0.571,1,0.667,11.0,2020-21,Regular%20Season
202397,Ish Smith,1610612764,WAS,43,23,20,916.0,22,4,18,0.182,43,0.512,3,0.55,11.8,128,19,109,0.148,217,0.59,20,0.65,8.1,150,23,127,0.153,255,0.588,23,0.647,8.6,2020-21,Regular%20Season
1627826,Ivica Zubac,1610612746,LAC,69,46,23,1586.0,189,145,44,0.767,469,0.403,8,0.41,3.7,330,117,211,0.355,586,0.563,57,0.624,4.5,519,262,255,0.505,1028,0.505,65,0.539,4.2,2020-21,Regular%20Season
200755,JJ Redick,1610612742,DAL,33,15,18,599.0,4,0,4,0.0,11,0.364,1,0.4,16.5,60,6,54,0.1,98,0.612,7,0.659,10.4,64,6,58,0.094,109,0.587,8,0.634,10.8,2020-21,Regular%20Season
1629630,Ja Morant,1610612763,MEM,62,32,30,2022.0,59,27,31,0.458,148,0.399,4,0.41,8.3,193,43,150,0.223,323,0.598,37,0.675,7.0,252,70,181,0.278,466,0.541,41,0.593,7.3,2020-21,Regular%20Season
203960,JaKarr Sampson,1610612754,IND,24,12,12,289.0,27,19,8,0.704,56,0.482,3,0.509,3.8,50,13,37,0.26,103,0.485,10,0.538,3.9,77,32,45,0.416,153,0.503,13,0.55,3.9,2020-21,Regular%20Season
203210,JaMychal Green,1610612743,DEN,55,35,20,1090.0,85,56,29,0.659,181,0.47,4,0.48,5.3,192,45,144,0.234,271,0.708,22,0.771,6.1,277,101,173,0.365,433,0.64,26,0.681,5.8,2020-21,Regular%20Season
201580,JaVale McGee,1610612743,DEN,45,21,24,670.0,77,53,24,0.688,155,0.497,2,0.503,4.9,162,41,119,0.253,252,0.643,21,0.701,4.3,239,94,143,0.393,390,0.613,23,0.651,4.5,2020-21,Regular%20Season
203953,Jabari Parker,1610612738,BOS,12,4,8,163.0,10,4,6,0.4,21,0.476,1,0.5,5.7,32,6,26,0.188,61,0.525,4,0.561,5.9,42,10,32,0.238,81,0.519,5,0.553,5.9,2020-21,Regular%20Season
1630183,Jaden McDaniels,1610612750,MIN,60,18,42,1484.0,52,36,17,0.692,128,0.406,3,0.416,8.7,180,53,127,0.294,325,0.554,36,0.623,5.8,232,89,144,0.384,431,0.538,39,0.592,6.5,2020-21,Regular%20Season
203109,Jae Crowder,1610612756,PHX,58,42,16,1601.0,32,14,18,0.438,84,0.381,0,0.381,10.6,249,55,191,0.221,395,0.63,40,0.701,5.6,281,69,209,0.246,462,0.608,40,0.666,6.2,2020-21,Regular%20Season
1630256,Jae'Sean Tate,1610612745,HOU,69,16,53,2010.0,131,81,49,0.618,319,0.411,8,0.421,7.4,240,66,172,0.275,439,0.547,48,0.614,7.3,371,147,221,0.396,745,0.498,56,0.538,7.3,2020-21,Regular%20Season
1626143,Jahlil Okafor,1610612765,DET,23,4,19,305.0,23,19,3,0.826,69,0.333,0,0.333,4.3,43,14,29,0.326,94,0.457,12,0.524,5.1,66,33,32,0.5,158,0.418,12,0.452,4.8,2020-21,Regular%20Season
1630186,Jahmi'us Ramsey,1610612758,SAC,6,1,5,71.0,2,1,1,0.5,4,0.5,0,0.5,16.1,8,1,7,0.125,12,0.667,1,0.727,7.1,10,2,8,0.2,16,0.625,1,0.667,8.9,2020-21,Regular%20Season
1627774,Jake Layman,1610612750,MIN,30,7,23,509.0,13,4,9,0.308,37,0.351,4,0.394,11.6,54,13,41,0.241,89,0.607,9,0.675,7.1,67,17,50,0.254,120,0.558,13,0.626,7.9,2020-21,Regular%20Season
1627751,Jakob Poeltl,1610612759,SAS,69,32,37,1845.0,219,172,47,0.785,405,0.541,10,0.554,4.8,328,136,191,0.415,566,0.58,65,0.655,4.4,547,308,238,0.563,951,0.575,75,0.624,4.5,2020-21,Regular%20Season
1628973,Jalen Brunson,1610612742,DAL,64,37,27,1607.0,27,8,19,0.296,67,0.403,2,0.415,14.7,204,23,181,0.113,332,0.614,31,0.678,7.7,231,31,200,0.134,394,0.586,33,0.64,8.5,2020-21,Regular%20Season
1630223,Jalen Harris,1610612761,TOR,9,1,8,149.0,3,3,0,1.0,7,0.429,0,0.429,11.6,15,1,14,0.067,21,0.714,2,0.789,9.5,18,4,14,0.222,28,0.643,2,0.692,9.8,2020-21,Regular%20Season
1629665,Jalen Lecque,1610612754,IND,4,2,2,12.0,2,0,2,0.0,5,0.4,0,0.4,20.1,3,1,2,0.333,3,1.0,0,1.0,10.9,5,1,4,0.2,7,0.714,0,0.714,14.6,2020-21,Regular%20Season
1629667,Jalen McDaniels,1610612766,CHA,41,15,26,882.0,45,22,23,0.489,114,0.395,4,0.409,8.2,124,35,89,0.282,221,0.561,24,0.629,5.9,169,57,112,0.337,326,0.518,28,0.567,6.5,2020-21,Regular%20Season
1630188,Jalen Smith,1610612756,PHX,15,9,6,131.0,7,5,2,0.714,22,0.318,2,0.35,6.2,30,6,24,0.2,48,0.625,7,0.732,5.7,37,11,26,0.297,68,0.544,9,0.627,5.8,2020-21,Regular%20Season
1627750,Jamal Murray,1610612743,DEN,46,30,16,1640.0,37,11,25,0.297,82,0.451,4,0.474,10.7,157,22,133,0.14,238,0.66,19,0.717,8.5,194,33,158,0.17,313,0.62,23,0.669,8.9,2020-21,Regular%20Season
203516,James Ennis III,1610612753,ORL,40,12,28,970.0,43,25,18,0.581,114,0.377,2,0.384,6.9,123,18,105,0.146,196,0.628,23,0.711,5.9,166,43,123,0.259,306,0.542,25,0.591,6.2,2020-21,Regular%20Season
201935,James Harden,1610612751,BKN,44,31,13,1609.0,35,16,19,0.457,136,0.257,4,0.265,9.7,313,47,265,0.15,460,0.68,30,0.728,6.0,348,63,284,0.181,565,0.616,34,0.655,6.4,2020-21,Regular%20Season
201949,James Johnson,1610612740,NOP,44,18,26,965.0,32,14,18,0.438,81,0.395,2,0.405,7.9,145,31,115,0.214,224,0.647,15,0.694,7.3,177,45,133,0.254,292,0.606,17,0.644,7.4,2020-21,Regular%20Season
203263,James Nunnally,1610612740,NOP,6,2,4,40.0,2,0,2,0.0,4,0.5,0,0.5,12.1,7,0,7,0.0,9,0.778,0,0.778,6.2,9,0,9,0.0,11,0.818,0,0.818,7.5,2020-21,Regular%20Season
1630164,James Wiseman,1610612744,GSW,39,18,21,836.0,55,32,21,0.582,140,0.393,3,0.401,5.0,171,37,130,0.216,290,0.59,21,0.636,4.7,226,69,151,0.305,412,0.549,24,0.582,4.8,2020-21,Regular%20Season
201162,Jared Dudley,1610612747,LAL,8,5,3,73.0,4,1,3,0.25,6,0.667,0,0.667,6.2,17,6,11,0.353,25,0.68,2,0.739,5.5,21,7,14,0.333,28,0.75,2,0.808,5.6,2020-21,Regular%20Season
1629607,Jared Harper,1610612752,NYK,2,1,1,4.0,0,0,0,0.0,0,0.0,0,0.0,0.0,2,0,2,0.0,2,1.0,0,1.0,10.8,2,0,2,0.0,2,1.0,0,1.0,10.8,2020-21,Regular%20Season
1628991,Jaren Jackson Jr.,1610612763,MEM,11,4,7,258.0,17,10,7,0.588,39,0.436,2,0.459,7.6,45,13,32,0.289,79,0.57,5,0.608,5.6,62,23,39,0.371,114,0.544,7,0.579,6.1,2020-21,Regular%20Season
1629020,Jarred Vanderbilt,1610612750,MIN,59,18,41,1110.0,118,81,37,0.686,304,0.388,11,0.403,5.7,250,59,191,0.236,393,0.636,33,0.694,4.7,368,140,228,0.38,673,0.547,44,0.585,5.0,2020-21,Regular%20Season
1629714,Jarrell Brantley,1610612762,UTA,13,12,1,93.0,9,6,3,0.667,16,0.563,0,0.563,7.2,18,0,18,0.0,23,0.783,2,0.857,6.4,27,6,21,0.222,39,0.692,2,0.73,6.7,2020-21,Regular%20Season
1628386,Jarrett Allen,1610612739,CLE,63,20,43,1864.0,196,139,57,0.709,415,0.472,8,0.482,4.9,435,141,294,0.324,693,0.628,67,0.695,4.4,631,280,351,0.444,1069,0.59,75,0.635,4.6,2020-21,Regular%20Season
1629633,Jarrett Culver,1610612750,MIN,27,5,22,456.0,34,18,16,0.529,65,0.523,0,0.523,9.1,70,20,51,0.286,111,0.631,15,0.729,6.6,104,38,67,0.365,171,0.608,15,0.667,7.5,2020-21,Regular%20Season
1629750,Javonte Green,1610612741,CHI,29,14,15,401.0,26,16,10,0.615,46,0.565,1,0.578,6.8,45,15,30,0.333,69,0.652,12,0.789,7.9,71,31,40,0.437,112,0.634,13,0.717,7.5,2020-21,Regular%20Season
1629637,Jaxson Hayes,1610612740,NOP,57,22,35,952.0,92,56,36,0.609,170,0.541,4,0.554,5.6,165,60,105,0.364,274,0.602,27,0.668,6.2,257,116,141,0.451,433,0.594,31,0.639,6.0,2020-21,Regular%20Season
1630206,Jay Scrubb,1610612746,LAC,3,1,2,80.0,2,0,0,0.0,9,0.222,0,0.222,0.0,12,1,12,0.083,21,0.571,1,0.6,35.5,14,1,12,0.071,29,0.483,1,0.5,35.5,2020-21,Regular%20Season
1629121,Jaylen Adams,1610612749,MIL,2,2,0,13.0,0,0,0,0.0,2,0.0,0,0.0,0.0,3,0,3,0.0,3,1.0,0,1.0,21.7,3,0,3,0.0,5,0.6,0,0.6,21.7,2020-21,Regular%20Season
1627759,Jaylen Brown,1610612738,BOS,58,30,28,1999.0,71,39,32,0.549,174,0.408,2,0.413,12.1,276,49,227,0.178,449,0.615,41,0.676,7.1,347,88,259,0.254,608,0.571,43,0.614,8.1,2020-21,Regular%20Season
1629658,Jaylen Hoard,1610612760,OKC,18,1,17,318.0,21,11,9,0.524,48,0.438,0,0.438,5.8,44,10,34,0.227,78,0.564,12,0.667,5.1,65,21,43,0.323,123,0.528,12,0.586,5.3,2020-21,Regular%20Season
1629669,Jaylen Nowell,1610612750,MIN,37,7,30,709.0,19,6,14,0.316,49,0.388,3,0.413,13.2,76,6,70,0.079,117,0.65,14,0.738,7.3,95,12,84,0.126,164,0.579,17,0.646,8.5,2020-21,Regular%20Season
1628369,Jayson Tatum,1610612738,BOS,64,34,30,2290.0,50,23,27,0.46,155,0.323,3,0.329,10.7,422,57,363,0.135,581,0.726,35,0.773,5.6,472,80,390,0.169,704,0.67,38,0.709,6.1,2020-21,Regular%20Season
201145,Jeff Green,1610612751,BKN,63,41,22,1757.0,34,15,19,0.441,88,0.386,2,0.395,10.1,229,54,174,0.236,368,0.622,27,0.672,7.0,263,69,193,0.262,445,0.591,29,0.632,7.4,2020-21,Regular%20Season
201952,Jeff Teague,1610612749,MIL,43,21,22,751.0,15,1,14,0.067,35,0.429,3,0.469,18.4,72,12,60,0.167,110,0.655,7,0.699,8.9,87,13,74,0.149,145,0.6,10,0.644,10.6,2020-21,Regular%20Season
203924,Jerami Grant,1610612765,DET,53,15,38,1795.0,34,22,11,0.647,121,0.281,6,0.296,6.1,208,40,165,0.192,298,0.698,27,0.768,6.9,242,62,176,0.256,412,0.587,33,0.639,6.8,2020-21,Regular%20Season
1629725,Jeremiah Martin,1610612739,CLE,5,0,5,48.0,2,2,0,1.0,10,0.2,1,0.222,4.5,5,0,4,0.0,9,0.556,2,0.714,6.4,7,2,4,0.286,19,0.368,3,0.438,5.8,2020-21,Regular%20Season
203087,Jeremy Lamb,1610612754,IND,34,16,18,729.0,25,12,12,0.48,60,0.417,2,0.431,8.7,106,14,92,0.132,192,0.552,11,0.586,5.2,131,26,104,0.198,243,0.539,13,0.57,5.8,2020-21,Regular%20Season
1629010,Jerome Robinson,1610612764,WAS,12,3,9,269.0,4,2,2,0.5,12,0.333,0,0.333,4.6,34,2,32,0.059,55,0.618,4,0.667,8.5,38,4,34,0.105,65,0.585,4,0.623,8.1,2020-21,Regular%20Season
1628975,Jevon Carter,1610612756,PHX,38,29,9,567.0,16,3,13,0.188,35,0.457,0,0.457,15.8,76,11,65,0.145,111,0.685,9,0.745,9.1,92,14,78,0.152,140,0.657,9,0.702,10.3,2020-21,Regular%20Season
202710,Jimmy Butler,1610612748,MIA,52,33,19,1745.0,94,58,34,0.617,207,0.454,10,0.477,6.1,265,64,201,0.242,424,0.625,36,0.683,6.5,359,122,235,0.34,626,0.573,46,0.619,6.4,2020-21,Regular%20Season
203925,Joe Harris,1610612751,BKN,66,43,23,2087.0,43,22,21,0.512,107,0.402,6,0.426,11.5,204,44,159,0.216,384,0.531,43,0.598,8.1,247,66,180,0.267,482,0.512,49,0.57,8.7,2020-21,Regular%20Season
204060,Joe Ingles,1610612762,UTA,65,46,19,1824.0,27,4,23,0.148,60,0.45,4,0.482,15.1,217,24,193,0.111,327,0.664,24,0.716,8.4,244,28,216,0.115,382,0.639,28,0.689,9.1,2020-21,Regular%20Season
203954,Joel Embiid,1610612755,PHI,51,39,12,1585.0,113,86,26,0.761,247,0.457,4,0.465,5.9,426,135,289,0.317,698,0.61,87,0.697,4.4,539,221,315,0.41,921,0.585,91,0.649,4.7,2020-21,Regular%20Season
1628381,John Collins,1610612737,ATL,63,34,29,1848.0,118,81,35,0.686,303,0.389,7,0.399,5.0,349,83,264,0.238,606,0.576,73,0.655,4.2,467,164,299,0.351,869,0.537,80,0.592,4.4,2020-21,Regular%20Season
1629723,John Konchar,1610612763,MEM,39,20,19,555.0,35,17,18,0.486,86,0.407,3,0.422,9.0,93,29,64,0.312,159,0.585,10,0.624,5.6,128,46,82,0.359,234,0.547,13,0.579,6.5,2020-21,Regular%20Season
202322,John Wall,1610612745,HOU,38,12,26,1231.0,17,10,8,0.588,57,0.298,2,0.309,8.8,112,19,93,0.17,174,0.644,9,0.679,8.4,129,29,101,0.225,231,0.558,11,0.586,8.5,2020-21,Regular%20Season
202685,Jonas Valanciunas,1610612763,MEM,62,32,30,1755.0,253,194,58,0.767,517,0.489,10,0.499,4.0,523,167,354,0.319,778,0.672,66,0.735,3.7,776,361,412,0.465,1264,0.614,76,0.653,3.8,2020-21,Regular%20Season
1629007,Jontay Porter,1610612763,MEM,7,5,2,46.0,4,2,2,0.5,10,0.4,1,0.444,8.5,10,4,6,0.4,17,0.588,1,0.625,4.8,14,6,8,0.429,26,0.538,2,0.583,5.9,2020-21,Regular%20Season
1628395,Jordan Bell,1610612744,GSW,5,2,3,81.0,7,7,0,1.0,26,0.269,2,0.292,1.9,17,2,15,0.118,27,0.63,2,0.68,5.1,24,9,15,0.375,52,0.462,4,0.5,4.1,2020-21,Regular%20Season
1629648,Jordan Bone,1610612753,ORL,11,2,9,176.0,4,0,4,0.0,6,0.667,0,0.667,18.0,20,3,17,0.15,28,0.714,1,0.741,10.5,24,3,21,0.125,34,0.706,1,0.727,11.7,2020-21,Regular%20Season
203903,Jordan Clarkson,1610612762,UTA,66,47,19,1767.0,47,19,27,0.404,118,0.398,6,0.42,9.2,227,29,197,0.128,354,0.641,35,0.712,7.8,274,48,224,0.175,469,0.584,41,0.64,8.0,2020-21,Regular%20Season
1629162,Jordan McLaughlin,1610612750,MIN,41,12,29,777.0,21,6,15,0.286,55,0.382,2,0.396,14.3,87,17,70,0.195,124,0.702,6,0.737,9.5,108,23,85,0.213,174,0.621,8,0.651,10.5,2020-21,Regular%20Season
1629670,Jordan Nwora,1610612749,MIL,19,12,7,245.0,9,3,6,0.333,27,0.333,2,0.36,10.7,51,9,42,0.176,73,0.699,4,0.739,8.3,60,12,48,0.2,94,0.638,6,0.682,8.6,2020-21,Regular%20Season
1629673,Jordan Poole,1610612744,GSW,44,23,21,893.0,15,3,12,0.2,29,0.517,1,0.536,16.3,77,12,65,0.156,123,0.626,6,0.658,8.3,92,15,77,0.163,148,0.622,7,0.652,9.6,2020-21,Regular%20Season
1630182,Josh Green,1610612742,DAL,30,15,15,414.0,28,14,14,0.5,48,0.583,0,0.583,9.4,50,7,42,0.14,71,0.704,4,0.746,9.6,78,21,56,0.269,118,0.661,4,0.684,9.5,2020-21,Regular%20Season
1630221,Josh Hall,1610612760,OKC,16,2,14,299.0,6,4,3,0.667,20,0.3,0,0.3,24.8,53,9,39,0.17,73,0.726,12,0.869,10.2,59,13,42,0.22,93,0.634,12,0.728,12.1,2020-21,Regular%20Season
1628404,Josh Hart,1610612740,NOP,47,21,26,1350.0,53,26,26,0.491,114,0.465,4,0.482,11.0,324,67,255,0.207,482,0.672,40,0.733,5.6,377,93,281,0.247,581,0.649,44,0.702,6.4,2020-21,Regular%20Season
1628367,Josh Jackson,1610612765,DET,60,15,45,1517.0,57,39,17,0.684,135,0.422,1,0.425,6.9,197,38,160,0.193,298,0.661,23,0.716,7.8,254,77,177,0.303,419,0.606,24,0.643,7.6,2020-21,Regular%20Season
1629006,Josh Okogie,1610612750,MIN,54,21,33,1140.0,63,40,23,0.635,135,0.467,5,0.485,6.9,93,23,70,0.247,158,0.589,7,0.616,8.7,156,63,93,0.404,290,0.538,12,0.561,8.0,2020-21,Regular%20Season
1626196,Josh Richardson,1610612742,DAL,58,34,24,1766.0,51,19,31,0.373,109,0.468,4,0.486,10.3,144,13,131,0.09,234,0.615,19,0.67,9.3,195,32,162,0.164,335,0.582,23,0.625,9.5,2020-21,Regular%20Season
201950,Jrue Holiday,1610612749,MIL,58,40,18,1889.0,73,44,29,0.603,186,0.392,10,0.415,7.7,195,37,157,0.19,302,0.646,19,0.689,9.6,268,81,186,0.302,480,0.558,29,0.594,9.1,2020-21,Regular%20Season
1629308,Juan Toscano-Anderson,1610612744,GSW,48,25,23,1087.0,29,12,16,0.414,92,0.315,2,0.322,12.0,206,47,158,0.228,342,0.602,38,0.678,4.9,235,59,174,0.251,416,0.565,40,0.625,5.8,2020-21,Regular%20Season
1627823,Juancho Hernangomez,1610612750,MIN,51,19,32,898.0,45,29,16,0.644,115,0.391,8,0.421,5.7,160,37,123,0.231,249,0.643,15,0.684,5.1,205,66,139,0.322,351,0.584,23,0.625,5.2,2020-21,Regular%20Season
203944,Julius Randle,1610612752,NYK,71,40,31,2667.0,84,56,25,0.667,280,0.3,12,0.313,8.0,640,137,492,0.214,951,0.673,83,0.737,5.1,724,193,517,0.267,1170,0.619,95,0.673,5.4,2020-21,Regular%20Season
203200,Justin Holiday,1610612754,IND,69,33,36,2106.0,32,18,14,0.563,81,0.395,4,0.416,9.0,224,31,192,0.138,380,0.589,36,0.651,7.3,256,49,206,0.191,444,0.577,40,0.634,7.5,2020-21,Regular%20Season
1628382,Justin Jackson,1610612749,MIL,29,10,19,525.0,16,4,12,0.25,30,0.533,3,0.593,11.8,61,9,52,0.148,96,0.635,4,0.663,9.0,77,13,64,0.169,122,0.631,7,0.67,9.6,2020-21,Regular%20Season
1629713,Justin James,1610612758,SAC,14,7,7,197.0,9,3,5,0.333,24,0.375,1,0.391,4.5,21,2,19,0.095,47,0.447,9,0.553,5.9,30,5,24,0.167,68,0.441,10,0.517,5.5,2020-21,Regular%20Season
1628383,Justin Patton,1610612745,HOU,11,1,10,225.0,14,10,4,0.714,35,0.4,0,0.4,6.7,35,19,16,0.543,60,0.583,3,0.614,5.3,49,29,20,0.592,93,0.527,3,0.544,5.7,2020-21,Regular%20Season
1629620,Justin Robinson,1610612760,OKC,5,0,5,75.0,1,0,1,0.0,1,1.0,0,1.0,22.9,6,0,6,0.0,13,0.462,2,0.545,8.3,7,0,7,0.0,14,0.5,2,0.583,10.4,2020-21,Regular%20Season
1626159,Justise Winslow,1610612763,MEM,25,13,12,491.0,18,9,9,0.5,40,0.45,0,0.45,11.9,100,22,78,0.22,143,0.699,13,0.769,5.1,118,31,87,0.263,176,0.67,13,0.724,6.1,2020-21,Regular%20Season
203994,Jusuf Nurkic,1610612757,POR,37,22,15,880.0,86,64,22,0.744,216,0.398,7,0.411,4.9,246,64,180,0.26,383,0.642,44,0.726,4.1,332,128,202,0.386,587,0.566,51,0.619,4.3,2020-21,Regular%20Season
1629752,Juwan Morgan,1610612762,UTA,16,13,3,123.0,9,7,2,0.778,33,0.273,0,0.273,3.9,19,4,15,0.211,32,0.594,3,0.655,5.0,28,11,17,0.393,63,0.444,3,0.467,4.6,2020-21,Regular%20Season
1630231,KJ Martin,1610612745,HOU,43,9,34,1060.0,73,54,19,0.74,154,0.474,5,0.49,6.2,169,49,120,0.29,268,0.631,26,0.698,5.4,242,103,139,0.426,410,0.59,31,0.639,5.6,2020-21,Regular%20Season
1629644,KZ Okpala,1610612748,MIA,23,13,10,395.0,21,12,9,0.571,42,0.5,1,0.512,11.1,47,9,38,0.191,83,0.566,5,0.603,8.3,68,21,47,0.309,123,0.553,6,0.581,9.2,2020-21,Regular%20Season
1630211,Karim Mane,1610612753,ORL,5,0,5,68.0,1,0,1,0.0,7,0.143,0,0.143,2.8,13,3,10,0.231,16,0.813,1,0.867,5.4,14,3,11,0.214,22,0.636,1,0.667,5.2,2020-21,Regular%20Season
1626157,Karl-Anthony Towns,1610612750,MIN,50,19,31,1689.0,133,93,40,0.699,308,0.432,3,0.436,5.5,396,135,261,0.341,612,0.647,56,0.712,4.4,529,228,301,0.431,885,0.598,59,0.64,4.7,2020-21,Regular%20Season
202695,Kawhi Leonard,1610612746,LAC,52,36,16,1772.0,55,33,22,0.6,120,0.458,2,0.466,10.2,282,74,207,0.262,398,0.709,28,0.762,6.7,337,107,229,0.318,492,0.685,30,0.729,7.2,2020-21,Regular%20Season
1628966,Keita Bates-Diop,1610612759,SAS,18,5,13,208.0,9,6,2,0.667,23,0.391,1,0.409,7.1,40,11,29,0.275,54,0.741,2,0.769,6.2,49,17,31,0.347,73,0.671,3,0.7,6.4,2020-21,Regular%20Season
1629103,Kelan Martin,1610612754,IND,24,10,14,288.0,18,10,7,0.556,38,0.474,0,0.474,7.9,60,10,51,0.167,89,0.674,5,0.714,5.1,78,20,58,0.256,122,0.639,5,0.667,5.7,2020-21,Regular%20Season
1629640,Keldon Johnson,1610612759,SAS,68,32,36,1944.0,93,56,36,0.602,238,0.391,14,0.415,6.8,319,69,252,0.216,474,0.673,38,0.732,5.7,412,125,288,0.303,674,0.611,52,0.662,5.9,2020-21,Regular%20Season
1629833,Keljin Blevins,1610612757,POR,7,6,1,32.0,3,1,2,0.333,6,0.5,1,0.6,7.2,7,1,6,0.143,9,0.778,1,0.875,10.3,10,2,8,0.2,14,0.714,2,0.833,9.4,2020-21,Regular%20Season
203482,Kelly Olynyk,1610612745,HOU,70,26,44,1997.0,87,59,29,0.678,258,0.337,7,0.347,7.4,402,79,320,0.197,637,0.631,57,0.693,5.2,489,138,349,0.282,859,0.569,64,0.615,5.6,2020-21,Regular%20Season
1626162,Kelly Oubre Jr.,1610612744,GSW,55,27,28,1688.0,82,57,25,0.695,192,0.427,4,0.436,6.7,247,42,204,0.17,400,0.618,41,0.688,5.8,329,99,229,0.301,571,0.576,45,0.625,6.1,2020-21,Regular%20Season
202689,Kemba Walker,1610612760,OKC,42,22,20,1342.0,16,5,11,0.313,64,0.25,3,0.262,13.4,154,27,128,0.175,264,0.583,22,0.636,8.9,170,32,139,0.188,325,0.523,25,0.567,9.3,2020-21,Regular%20Season
1629134,Kendrick Nunn,1610612748,MIA,51,29,22,1594.0,21,4,17,0.19,59,0.356,3,0.375,14.9,158,26,132,0.165,274,0.577,33,0.656,8.4,179,30,149,0.168,331,0.541,36,0.607,9.2,2020-21,Regular%20Season
1629026,Kenrich Williams,1610612760,OKC,63,21,42,1411.0,84,51,32,0.607,197,0.426,8,0.444,7.2,189,48,141,0.254,307,0.616,28,0.677,6.1,273,99,173,0.363,489,0.558,36,0.603,6.5,2020-21,Regular%20Season
203145,Kent Bazemore,1610612744,GSW,64,34,30,1292.0,26,12,14,0.462,69,0.377,2,0.388,8.6,203,23,177,0.113,340,0.597,33,0.661,6.2,229,35,191,0.153,393,0.583,35,0.64,6.5,2020-21,Regular%20Season
203484,Kentavious Caldwell-Pope,1610612747,LAL,60,36,24,1705.0,27,11,16,0.407,77,0.351,0,0.351,9.3,152,25,127,0.164,247,0.615,20,0.67,7.6,179,36,143,0.201,315,0.568,20,0.607,7.8,2020-21,Regular%20Season
201142,Kevin Durant,1610612751,BKN,35,23,12,1157.0,13,5,8,0.385,60,0.217,4,0.232,17.6,234,58,175,0.248,352,0.665,21,0.707,5.7,247,63,183,0.255,393,0.628,25,0.671,6.3,2020-21,Regular%20Season
1628989,Kevin Huerter,1610612737,ATL,66,39,27,2043.0,38,22,16,0.579,87,0.437,1,0.442,11.0,193,32,161,0.166,323,0.598,27,0.652,8.4,231,54,177,0.234,401,0.576,28,0.619,8.8,2020-21,Regular%20Season
1628995,Kevin Knox II,1610612752,NYK,29,16,13,407.0,10,2,7,0.2,20,0.5,0,0.5,13.3,51,9,42,0.176,74,0.689,4,0.729,7.3,61,11,49,0.18,91,0.67,4,0.701,8.2,2020-21,Regular%20Season
201567,Kevin Love,1610612739,CLE,24,7,17,620.0,17,11,6,0.647,53,0.321,0,0.321,9.9,169,40,129,0.237,256,0.66,18,0.71,4.8,186,51,135,0.274,296,0.628,18,0.669,5.2,2020-21,Regular%20Season
1629645,Kevin Porter Jr.,1610612745,HOU,25,4,21,826.0,20,10,10,0.5,48,0.417,1,0.426,11.6,79,18,61,0.228,133,0.594,11,0.648,8.2,99,28,71,0.283,180,0.55,12,0.589,8.9,2020-21,Regular%20Season
1626172,Kevon Looney,1610612744,GSW,59,34,25,1136.0,116,87,28,0.75,222,0.523,8,0.542,5.1,204,90,114,0.441,373,0.547,47,0.626,4.9,320,177,142,0.553,582,0.55,55,0.607,5.0,2020-21,Regular%20Season
203920,Khem Birch,1610612761,TOR,65,22,43,1518.0,174,110,63,0.632,338,0.515,13,0.535,6.0,213,68,144,0.319,388,0.549,56,0.642,5.5,387,178,207,0.46,710,0.545,69,0.604,5.7,2020-21,Regular%20Season
203114,Khris Middleton,1610612749,MIL,68,45,23,2269.0,54,25,29,0.463,146,0.37,6,0.386,11.2,352,55,297,0.156,520,0.677,30,0.718,6.7,406,80,326,0.197,650,0.625,36,0.661,7.3,2020-21,Regular%20Season
1629017,Khyri Thomas,1610612745,HOU,5,1,4,153.0,7,1,6,0.143,10,0.7,0,0.7,14.7,11,2,9,0.182,21,0.524,2,0.579,7.0,18,3,15,0.167,30,0.6,2,0.643,10.0,2020-21,Regular%20Season
1630165,Killian Hayes,1610612765,DET,22,6,16,578.0,6,1,5,0.167,19,0.316,1,0.333,11.0,63,7,56,0.111,118,0.534,12,0.594,7.0,69,8,61,0.116,133,0.519,13,0.575,7.4,2020-21,Regular%20Season
1629681,Killian Tillie,1610612763,MEM,10,8,2,142.0,6,4,2,0.667,12,0.5,0,0.5,10.0,18,5,13,0.278,39,0.462,4,0.514,7.3,24,9,15,0.375,49,0.49,4,0.533,8.0,2020-21,Regular%20Season
1630184,Kira Lewis Jr.,1610612740,NOP,34,15,19,699.0,12,5,7,0.417,37,0.324,5,0.375,11.7,59,5,53,0.085,97,0.608,10,0.678,9.9,71,10,60,0.141,134,0.53,15,0.597,10.2,2020-21,Regular%20Season
1628961,Kostas Antetokounmpo,1610612747,LAL,10,5,5,44.0,4,3,1,0.75,8,0.5,0,0.5,4.5,15,6,9,0.4,20,0.75,2,0.833,4.6,19,9,10,0.474,26,0.731,2,0.792,4.6,2020-21,Regular%20Season
1627739,Kris Dunn,1610612737,ATL,4,1,3,45.0,0,0,0,0.0,2,0.0,0,0.0,0.0,6,2,4,0.333,11,0.545,2,0.667,5.5,6,2,4,0.333,13,0.462,2,0.545,5.5,2020-21,Regular%20Season
204001,Kristaps Porzingis,1610612742,DAL,43,26,17,1327.0,82,55,25,0.671,173,0.474,2,0.48,5.5,299,88,211,0.294,449,0.666,45,0.74,4.7,381,143,236,0.375,588,0.648,47,0.704,4.9,2020-21,Regular%20Season
203937,Kyle Anderson,1610612763,MEM,69,36,33,1887.0,52,31,21,0.596,142,0.366,3,0.374,7.3,344,64,278,0.186,472,0.729,30,0.778,6.4,396,95,299,0.24,576,0.688,33,0.729,6.5,2020-21,Regular%20Season
1629657,Kyle Guy,1610612758,SAC,16,6,10,156.0,5,3,3,0.6,13,0.385,0,0.385,17.7,30,3,25,0.1,46,0.652,5,0.732,6.9,35,6,28,0.171,56,0.625,5,0.686,8.8,2020-21,Regular%20Season
1628398,Kyle Kuzma,1610612747,LAL,67,40,27,1931.0,108,62,45,0.574,208,0.519,3,0.527,7.3,309,48,264,0.155,482,0.641,34,0.69,5.5,417,110,309,0.264,667,0.625,37,0.662,5.9,2020-21,Regular%20Season
200768,Kyle Lowry,1610612761,TOR,44,14,30,1558.0,35,17,17,0.486,108,0.324,9,0.354,9.2,212,41,170,0.193,376,0.564,39,0.629,7.1,247,58,187,0.235,482,0.512,48,0.569,7.4,2020-21,Regular%20Season
202681,Kyrie Irving,1610612751,BKN,53,35,18,1847.0,52,27,25,0.519,148,0.351,8,0.371,10.1,205,41,161,0.2,369,0.556,39,0.621,7.6,257,68,186,0.265,512,0.502,47,0.553,8.1,2020-21,Regular%20Season
200746,LaMarcus Aldridge,1610612751,BKN,26,15,11,674.0,19,15,4,0.789,61,0.311,1,0.317,2.7,99,32,67,0.323,167,0.593,17,0.66,5.4,118,47,71,0.398,222,0.532,18,0.578,4.9,2020-21,Regular%20Season
1630163,LaMelo Ball,1610612766,CHA,51,23,28,1469.0,63,35,29,0.556,163,0.387,6,0.401,8.9,239,34,208,0.142,345,0.693,22,0.74,7.5,302,69,237,0.228,494,0.611,28,0.648,7.8,2020-21,Regular%20Season
1630205,Lamar Stevens,1610612739,CLE,30,11,19,423.0,24,14,10,0.583,62,0.387,2,0.4,7.7,72,19,52,0.264,117,0.615,8,0.661,5.2,96,33,62,0.344,177,0.542,10,0.575,5.8,2020-21,Regular%20Season
1629013,Landry Shamet,1610612751,BKN,52,31,21,1229.0,11,3,8,0.273,46,0.239,4,0.262,14.6,101,20,80,0.198,197,0.513,16,0.558,8.3,112,23,88,0.205,234,0.479,20,0.523,8.9,2020-21,Regular%20Season
204038,Langston Galloway,1610612756,PHX,24,19,5,304.0,7,4,3,0.571,14,0.5,0,0.5,7.2,35,7,28,0.2,52,0.673,7,0.778,8.6,42,11,31,0.262,65,0.646,7,0.724,8.3,2020-21,Regular%20Season
1626204,Larry Nance Jr.,1610612739,CLE,35,13,22,1091.0,54,31,23,0.574,136,0.397,1,0.4,6.2,181,45,134,0.249,289,0.626,32,0.704,6.0,235,76,157,0.323,407,0.577,33,0.628,6.0,2020-21,Regular%20Season
1628374,Lauri Markkanen,1610612741,CHI,51,20,31,1317.0,35,24,11,0.686,95,0.368,4,0.385,6.8,233,52,181,0.223,344,0.677,25,0.73,5.6,268,76,192,0.284,422,0.635,29,0.682,5.8,2020-21,Regular%20Season
2544,LeBron James,1610612747,LAL,45,30,15,1504.0,29,14,15,0.483,105,0.276,3,0.284,9.9,317,43,273,0.136,439,0.722,19,0.755,6.4,346,57,288,0.165,510,0.678,22,0.709,6.7,2020-21,Regular%20Season
1629022,Lonnie Walker IV,1610612759,SAS,53,27,26,1386.0,14,6,9,0.429,36,0.389,0,0.389,12.5,141,24,117,0.17,202,0.698,13,0.746,7.4,155,30,126,0.194,234,0.662,13,0.701,7.9,2020-21,Regular%20Season
1628366,Lonzo Ball,1610612740,NOP,53,23,30,1696.0,33,15,18,0.455,96,0.344,7,0.371,12.0,230,35,194,0.152,346,0.665,30,0.728,7.1,263,50,212,0.19,419,0.628,37,0.688,7.7,2020-21,Regular%20Season
101150,Lou Williams,1610612737,ATL,54,39,15,1200.0,20,13,6,0.65,51,0.392,1,0.4,9.2,117,15,102,0.128,175,0.669,10,0.709,9.4,137,28,108,0.204,222,0.617,11,0.649,9.4,2020-21,Regular%20Season
1629663,Louis King,1610612758,SAC,5,2,3,84.0,5,3,2,0.6,8,0.625,0,0.625,15.2,13,1,12,0.077,20,0.65,1,0.684,6.9,18,4,14,0.222,26,0.692,1,0.72,9.2,2020-21,Regular%20Season
1629652,Luguentz Dort,1610612760,OKC,51,17,34,1534.0,38,14,24,0.368,108,0.352,6,0.373,11.3,151,38,114,0.252,239,0.632,26,0.709,7.5,189,52,138,0.275,345,0.548,32,0.604,8.2,2020-21,Regular%20Season
1629029,Luka Doncic,1610612742,DAL,66,40,26,2262.0,54,35,17,0.648,148,0.365,5,0.378,7.2,473,90,380,0.19,658,0.719,60,0.791,5.3,527,125,397,0.237,787,0.67,65,0.73,5.5,2020-21,Regular%20Season
1629677,Luka Samanic,1610612759,SAS,20,8,12,251.0,16,11,5,0.688,34,0.471,1,0.485,5.2,52,13,39,0.25,76,0.684,6,0.743,4.2,68,24,44,0.353,102,0.667,7,0.716,4.5,2020-21,Regular%20Season
1628379,Luke Kennard,1610612746,LAC,52,38,14,1087.0,15,4,11,0.267,34,0.441,1,0.455,17.7,143,29,114,0.203,220,0.65,20,0.715,6.6,158,33,125,0.209,252,0.627,21,0.684,7.7,2020-21,Regular%20Season
1628436,Luke Kornet,1610612738,BOS,23,10,13,307.0,14,11,4,0.786,28,0.5,0,0.5,4.1,53,28,25,0.528,88,0.602,9,0.671,4.7,67,39,29,0.582,111,0.604,9,0.657,4.6,2020-21,Regular%20Season
1630201,Malachi Flynn,1610612761,TOR,33,13,20,827.0,10,3,7,0.3,35,0.286,4,0.323,14.7,106,19,87,0.179,150,0.707,11,0.763,7.9,116,22,94,0.19,181,0.641,15,0.699,8.5,2020-21,Regular%20Season
1627763,Malcolm Brogdon,1610612754,IND,56,27,29,1930.0,58,30,28,0.517,152,0.382,6,0.397,9.3,236,36,200,0.153,358,0.659,23,0.704,7.5,294,66,228,0.224,506,0.581,29,0.616,7.9,2020-21,Regular%20Season
1627736,Malik Beasley,1610612750,MIN,37,8,29,1214.0,28,16,12,0.571,79,0.354,1,0.359,11.5,134,37,97,0.276,222,0.604,25,0.68,7.4,162,53,109,0.327,290,0.559,26,0.614,8.1,2020-21,Regular%20Season
1630238,Malik Fitts,1610612746,LAC,2,2,0,10.0,0,0,0,0.0,1,0.0,0,0.0,0.0,3,1,2,0.333,3,1.0,0,1.0,6.5,3,1,2,0.333,4,0.75,0,0.75,6.5,2020-21,Regular%20Season
1628370,Malik Monk,1610612766,CHA,35,17,18,799.0,14,4,10,0.286,32,0.438,0,0.438,10.7,87,16,71,0.184,125,0.696,5,0.725,7.0,101,20,81,0.198,155,0.652,5,0.673,7.5,2020-21,Regular%20Season
1629603,Mamadi Diakite,1610612749,MIL,12,6,6,139.0,8,6,2,0.75,27,0.296,0,0.296,4.1,26,10,16,0.385,52,0.5,10,0.619,4.4,34,16,18,0.471,77,0.442,10,0.507,4.3,2020-21,Regular%20Season
201188,Marc Gasol,1610612747,LAL,51,32,19,987.0,38,24,14,0.632,87,0.437,2,0.447,6.0,177,51,124,0.288,293,0.604,31,0.676,5.5,215,75,138,0.349,366,0.587,33,0.646,5.6,2020-21,Regular%20Season
202694,Marcus Morris Sr.,1610612746,LAC,56,37,19,1480.0,35,15,19,0.429,94,0.372,4,0.389,9.6,199,35,164,0.176,333,0.598,37,0.672,6.3,234,50,183,0.214,404,0.579,41,0.645,6.8,2020-21,Regular%20Season
203935,Marcus Smart,1610612738,BOS,45,22,23,1498.0,36,21,15,0.583,84,0.429,3,0.444,9.9,131,30,101,0.229,245,0.535,32,0.615,7.9,167,51,116,0.305,323,0.517,35,0.58,8.4,2020-21,Regular%20Season
1628365,Markelle Fultz,1610612753,ORL,7,5,2,211.0,5,3,2,0.6,14,0.357,0,0.357,6.1,20,5,15,0.25,32,0.625,2,0.667,6.2,25,8,17,0.32,46,0.543,2,0.568,6.2,2020-21,Regular%20Season
202693,Markieff Morris,1610612747,LAL,59,31,28,1190.0,48,28,20,0.583,107,0.449,3,0.462,6.5,218,41,176,0.188,328,0.665,33,0.739,6.6,266,69,196,0.259,412,0.646,36,0.707,6.6,2020-21,Regular%20Season
1630210,Markus Howard,1610612743,DEN,13,9,4,143.0,1,0,1,0.0,4,0.25,0,0.25,13.8,20,4,16,0.2,31,0.645,2,0.69,9.3,21,4,17,0.19,35,0.6,2,0.636,9.5,2020-21,Regular%20Season
1629716,Marques Bolden,1610612739,CLE,4,0,4,23.0,3,2,1,0.667,5,0.6,0,0.6,13.9,3,3,1,1.0,6,0.5,1,0.6,5.6,6,5,2,0.833,11,0.545,1,0.6,9.2,2020-21,Regular%20Season
1627737,Marquese Chriss,1610612744,GSW,2,0,2,27.0,3,2,1,0.667,7,0.429,0,0.429,2.1,10,3,7,0.3,14,0.714,1,0.769,3.9,13,5,8,0.385,20,0.65,1,0.684,3.5,2020-21,Regular%20Season
1628963,Marvin Bagley III,1610612758,SAC,43,20,23,1112.0,106,70,35,0.66,208,0.51,2,0.515,5.1,212,53,160,0.25,305,0.695,18,0.739,5.2,318,123,195,0.387,492,0.646,20,0.674,5.1,2020-21,Regular%20Season
1630222,Mason Jones,1610612755,PHI,22,6,16,260.0,7,2,5,0.286,15,0.467,0,0.467,8.8,47,6,40,0.128,69,0.681,9,0.783,6.2,54,8,45,0.148,83,0.651,9,0.73,6.5,2020-21,Regular%20Season
203486,Mason Plumlee,1610612765,DET,56,14,42,1499.0,145,78,61,0.538,342,0.424,5,0.43,5.3,374,100,265,0.267,595,0.629,64,0.704,4.2,519,178,326,0.343,893,0.581,69,0.63,4.5,2020-21,Regular%20Season
1629680,Matisse Thybulle,1610612755,PHI,52,35,17,1095.0,30,12,18,0.4,53,0.566,1,0.577,10.0,94,19,75,0.202,164,0.573,19,0.648,10.1,124,31,93,0.25,213,0.582,20,0.642,10.1,2020-21,Regular%20Season
1629744,Matt Thomas,1610612762,UTA,25,17,8,231.0,7,2,5,0.286,14,0.5,0,0.5,7.4,36,6,30,0.167,52,0.692,4,0.75,8.7,43,8,35,0.186,64,0.672,4,0.717,8.4,2020-21,Regular%20Season
203521,Matthew Dellavedova,1610612739,CLE,11,2,9,189.0,6,5,1,0.833,10,0.6,0,0.6,7.7,18,4,14,0.222,28,0.643,1,0.667,9.0,24,9,15,0.375,38,0.632,1,0.649,8.6,2020-21,Regular%20Season
203090,Maurice Harkless,1610612758,SAC,31,13,18,710.0,13,7,6,0.538,49,0.265,2,0.277,7.4,76,16,61,0.211,138,0.551,12,0.603,7.4,89,23,67,0.258,175,0.509,14,0.553,7.4,2020-21,Regular%20Season
1629622,Max Strus,1610612748,MIA,19,8,11,341.0,5,3,2,0.6,11,0.455,1,0.5,6.6,35,8,27,0.229,53,0.66,9,0.795,8.0,40,11,29,0.275,63,0.635,10,0.755,7.8,2020-21,Regular%20Season
1628467,Maxi Kleber,1610612742,DAL,49,31,18,1331.0,47,22,25,0.468,107,0.439,3,0.452,9.3,213,53,160,0.249,349,0.61,30,0.668,5.3,260,75,185,0.288,438,0.594,33,0.642,6.1,2020-21,Regular%20Season
203086,Meyers Leonard,1610612748,MIA,3,2,1,29.0,0,0,0,0.0,0,0.0,0,0.0,0.0,7,2,5,0.286,11,0.636,2,0.778,6.7,7,2,5,0.286,11,0.636,2,0.778,6.7,2020-21,Regular%20Season
1629662,Mfiondu Kabengele,1610612739,CLE,20,8,12,209.0,12,8,4,0.667,39,0.308,0,0.308,4.3,48,13,36,0.271,74,0.649,9,0.738,4.9,60,21,40,0.35,106,0.566,9,0.619,4.8,2020-21,Regular%20Season
203487,Michael Carter-Williams,1610612753,ORL,30,12,18,776.0,39,19,19,0.487,83,0.47,1,0.476,7.9,100,18,81,0.18,154,0.649,10,0.694,7.5,139,37,100,0.266,234,0.594,11,0.623,7.6,2020-21,Regular%20Season
1629008,Michael Porter Jr.,1610612743,DEN,61,40,21,1912.0,91,61,31,0.67,216,0.421,3,0.427,6.2,354,90,263,0.254,543,0.652,53,0.722,5.0,445,151,294,0.339,733,0.607,56,0.657,5.3,2020-21,Regular%20Season
1628969,Mikal Bridges,1610612756,PHX,71,51,20,2316.0,76,41,34,0.539,141,0.539,4,0.555,9.7,233,54,174,0.232,388,0.601,32,0.654,7.3,309,95,208,0.307,522,0.592,36,0.636,7.9,2020-21,Regular%20Season
201144,Mike Conley,1610612762,UTA,49,36,13,1440.0,36,13,24,0.361,68,0.529,2,0.545,13.3,141,15,126,0.106,230,0.613,24,0.684,10.0,177,28,150,0.158,295,0.6,26,0.658,10.7,2020-21,Regular%20Season
1628455,Mike James,1610612751,BKN,12,9,3,231.0,3,2,1,0.667,10,0.3,0,0.3,9.9,29,5,24,0.172,43,0.674,4,0.744,6.2,32,7,25,0.219,53,0.604,4,0.653,6.5,2020-21,Regular%20Season
203488,Mike Muscala,1610612760,OKC,32,14,18,602.0,19,11,7,0.579,50,0.38,1,0.388,5.8,113,46,66,0.407,191,0.592,18,0.653,5.3,132,57,73,0.432,231,0.571,19,0.623,5.4,2020-21,Regular%20Season
203118,Mike Scott,1610612755,PHI,44,29,15,785.0,11,6,5,0.545,25,0.44,0,0.44,10.9,109,21,88,0.193,172,0.634,15,0.694,6.6,120,27,93,0.225,192,0.625,15,0.678,7.0,2020-21,Regular%20Season
1628970,Miles Bridges,1610612766,CHA,66,31,35,1932.0,81,41,41,0.506,175,0.463,4,0.474,8.3,316,97,219,0.307,491,0.644,42,0.704,5.6,397,138,260,0.348,628,0.632,46,0.682,6.1,2020-21,Regular%20Season
1629011,Mitchell Robinson,1610612752,NYK,31,15,16,853.0,113,85,21,0.752,198,0.571,3,0.579,4.3,139,74,62,0.532,241,0.577,27,0.65,5.5,252,159,83,0.631,432,0.583,30,0.627,5.0,2020-21,Regular%20Season
1629671,Miye Oni,1610612762,UTA,40,33,7,443.0,23,12,11,0.522,49,0.469,1,0.479,9.8,61,9,52,0.148,100,0.61,14,0.709,6.6,84,21,63,0.25,146,0.575,15,0.641,7.5,2020-21,Regular%20Season
1628964,Mo Bamba,1610612753,ORL,46,11,35,725.0,76,52,23,0.684,178,0.427,5,0.439,4.3,189,50,139,0.265,309,0.612,28,0.673,3.5,265,102,162,0.385,472,0.561,33,0.604,3.7,2020-21,Regular%20Season
1628420,Monte Morris,1610612743,DEN,40,26,14,1032.0,11,4,7,0.364,41,0.268,1,0.275,12.4,85,6,76,0.071,145,0.586,11,0.634,10.4,96,10,83,0.104,186,0.516,12,0.552,10.6,2020-21,Regular%20Season
1626149,Montrezl Harrell,1610612747,LAL,68,40,28,1578.0,158,118,42,0.747,322,0.491,6,0.5,5.2,270,71,196,0.263,460,0.587,43,0.647,5.7,428,189,238,0.442,757,0.565,49,0.605,5.6,2020-21,Regular%20Season
1629021,Moritz Wagner,1610612753,ORL,42,17,25,702.0,27,16,10,0.593,95,0.284,1,0.287,4.8,119,31,88,0.261,202,0.589,21,0.657,4.9,146,47,98,0.322,280,0.521,22,0.566,4.9,2020-21,Regular%20Season
1629650,Moses Brown,1610612738,BOS,42,7,35,919.0,154,113,34,0.734,282,0.546,5,0.556,3.7,229,74,147,0.323,366,0.626,39,0.7,4.1,383,187,181,0.488,631,0.607,44,0.652,4.0,2020-21,Regular%20Season
1628539,Mychal Mulder,1610612744,GSW,30,16,14,500.0,8,4,4,0.5,13,0.615,0,0.615,12.5,52,5,47,0.096,92,0.565,10,0.634,8.4,60,9,51,0.15,104,0.577,10,0.638,9.0,2020-21,Regular%20Season
1626167,Myles Turner,1610612754,IND,47,22,25,1455.0,63,34,29,0.54,153,0.412,3,0.42,6.7,243,80,163,0.329,517,0.47,58,0.529,4.7,306,114,192,0.373,648,0.472,61,0.521,5.1,2020-21,Regular%20Season
1630230,Naji Marshall,1610612740,NOP,26,10,16,680.0,15,12,3,0.8,48,0.313,3,0.333,5.4,132,28,104,0.212,200,0.66,19,0.729,4.7,147,40,107,0.272,236,0.623,22,0.687,4.7,2020-21,Regular%20Season
1629642,Nassir Little,1610612757,POR,41,23,18,583.0,32,18,13,0.563,67,0.478,1,0.485,8.5,96,12,84,0.125,143,0.671,13,0.738,5.1,128,30,97,0.234,204,0.627,14,0.674,5.9,2020-21,Regular%20Season
1630268,Nate Darling,1610612766,CHA,1,0,1,6.0,1,0,1,0.0,1,1.0,0,1.0,19.5,0,0,0,0.0,0,0.0,0,0.0,0.0,1,0,1,0.0,1,1.0,0,1.0,19.5,2020-21,Regular%20Season
1630207,Nate Hinton,1610612742,DAL,8,6,2,44.0,1,1,0,1.0,4,0.25,0,0.25,1.6,8,2,6,0.25,13,0.615,1,0.667,7.4,9,3,6,0.333,17,0.529,1,0.563,6.7,2020-21,Regular%20Season
1630233,Nathan Knight,1610612737,ATL,27,17,10,258.0,27,19,8,0.704,48,0.563,1,0.574,3.8,45,19,26,0.422,79,0.57,6,0.616,5.5,72,38,34,0.528,123,0.585,7,0.621,4.9,2020-21,Regular%20Season
1629675,Naz Reid,1610612750,MIN,67,21,46,1309.0,82,54,29,0.659,194,0.423,9,0.443,4.4,240,89,151,0.371,445,0.539,43,0.597,3.9,322,143,180,0.444,620,0.519,52,0.567,4.0,2020-21,Regular%20Season
202357,Nemanja Bjelica,1610612748,MIA,35,16,19,584.0,29,17,12,0.586,57,0.509,0,0.509,7.6,98,24,73,0.245,150,0.653,13,0.715,5.5,127,41,85,0.323,196,0.648,13,0.694,5.9,2020-21,Regular%20Season
203457,Nerlens Noel,1610612752,NYK,64,35,29,1547.0,142,86,53,0.606,325,0.437,12,0.454,6.0,265,75,189,0.283,542,0.489,66,0.557,4.4,407,161,242,0.396,849,0.479,78,0.528,5.0,2020-21,Regular%20Season
1629651,Nic Claxton,1610612751,BKN,32,23,9,594.0,43,30,12,0.698,119,0.361,0,0.361,5.1,123,42,81,0.341,203,0.606,16,0.658,4.3,166,72,93,0.434,312,0.532,16,0.561,4.5,2020-21,Regular%20Season
1630208,Nick Richards,1610612766,CHA,7,2,5,37.0,4,2,2,0.5,14,0.286,0,0.286,3.1,7,3,3,0.429,11,0.636,0,0.636,4.1,11,5,5,0.455,23,0.478,0,0.478,3.7,2020-21,Regular%20Season
1629638,Nickeil Alexander-Walker,1610612740,NOP,39,17,22,930.0,13,7,6,0.538,51,0.255,3,0.271,10.7,129,22,107,0.171,210,0.614,17,0.668,5.8,142,29,113,0.204,254,0.559,20,0.607,6.2,2020-21,Regular%20Season
1630185,Nico Mannion,1610612744,GSW,18,10,8,279.0,6,0,6,0.0,11,0.545,0,0.545,14.8,39,1,38,0.026,64,0.609,7,0.684,7.7,45,1,44,0.022,73,0.616,7,0.682,8.7,2020-21,Regular%20Season
201587,Nicolas Batum,1610612746,LAC,66,44,22,1811.0,50,29,20,0.58,117,0.427,3,0.439,7.8,266,57,209,0.214,380,0.7,30,0.76,6.2,316,86,229,0.272,476,0.664,33,0.713,6.5,2020-21,Regular%20Season
1629740,Nicolo Melli,1610612742,DAL,36,22,14,524.0,29,19,10,0.655,69,0.42,1,0.426,5.7,92,15,77,0.163,143,0.643,12,0.702,5.2,121,34,87,0.281,205,0.59,13,0.63,5.3,2020-21,Regular%20Season
203999,Nikola Jokic,1610612743,DEN,72,47,25,2488.0,205,151,52,0.737,420,0.488,11,0.501,5.0,575,181,392,0.315,884,0.65,69,0.706,4.4,780,332,444,0.426,1259,0.62,80,0.662,4.6,2020-21,Regular%20Season
202696,Nikola Vucevic,1610612741,CHI,70,26,44,2348.0,146,107,40,0.733,306,0.477,6,0.487,5.6,671,192,478,0.286,935,0.718,67,0.773,4.2,817,299,518,0.366,1189,0.687,73,0.732,4.4,2020-21,Regular%20Season
203943,Noah Vonleh,1610612751,BKN,1,1,0,3.0,0,0,0,0.0,2,0.0,0,0.0,0.0,1,0,1,0.0,1,1.0,0,1.0,3.4,1,0,1,0.0,3,0.333,0,0.333,3.4,2020-21,Regular%20Season
1626181,Norman Powell,1610612757,POR,67,32,35,2170.0,42,18,23,0.429,128,0.328,5,0.341,11.6,173,33,139,0.191,304,0.569,27,0.625,7.8,215,51,162,0.237,418,0.514,32,0.557,8.5,2020-21,Regular%20Season
203658,Norvel Pelle,1610612752,NYK,10,6,4,80.0,6,3,2,0.5,17,0.353,1,0.375,4.6,13,5,8,0.385,24,0.542,2,0.591,6.1,19,8,10,0.421,40,0.475,3,0.514,5.7,2020-21,Regular%20Season
1628384,OG Anunoby,1610612761,TOR,41,18,23,1394.0,54,33,21,0.611,153,0.353,3,0.36,8.3,183,52,132,0.284,306,0.598,19,0.638,6.2,237,85,153,0.359,440,0.539,22,0.567,6.7,2020-21,Regular%20Season
1630167,Obi Toppin,1610612752,NYK,52,32,20,611.0,26,17,9,0.654,69,0.377,1,0.382,6.2,112,24,86,0.214,171,0.655,16,0.723,4.7,138,41,95,0.297,222,0.622,17,0.673,5.0,2020-21,Regular%20Season
1630168,Onyeka Okongwu,1610612737,ATL,46,29,17,569.0,62,43,19,0.694,140,0.443,2,0.449,7.0,101,35,67,0.347,176,0.574,20,0.647,5.4,163,78,86,0.479,307,0.531,22,0.572,6.0,2020-21,Regular%20Season
1629052,Oshae Brissett,1610612754,IND,18,9,9,499.0,29,19,10,0.655,78,0.372,3,0.387,6.2,86,23,63,0.267,147,0.585,15,0.652,4.8,115,42,73,0.365,214,0.537,18,0.587,5.2,2020-21,Regular%20Season
203490,Otto Porter Jr.,1610612753,ORL,28,12,16,607.0,28,15,13,0.536,71,0.394,4,0.418,7.2,124,19,105,0.153,169,0.734,13,0.795,6.1,152,34,118,0.224,228,0.667,17,0.72,6.3,2020-21,Regular%20Season
200782,P.J. Tucker,1610612749,MIL,48,26,22,1278.0,51,21,30,0.412,133,0.383,4,0.395,11.5,153,36,114,0.235,272,0.563,28,0.627,7.2,204,57,144,0.279,386,0.528,32,0.576,8.3,2020-21,Regular%20Season
1629023,P.J. Washington,1610612766,CHA,64,31,33,1954.0,93,51,43,0.548,237,0.392,6,0.403,6.8,325,94,229,0.289,566,0.574,56,0.637,5.2,418,145,272,0.347,769,0.544,62,0.591,5.6,2020-21,Regular%20Season
1628408,PJ Dozier,1610612743,DEN,48,36,12,1059.0,35,21,14,0.6,97,0.361,3,0.372,9.9,147,28,117,0.19,230,0.639,23,0.71,7.5,182,49,131,0.269,312,0.583,26,0.636,7.9,2020-21,Regular%20Season
1627783,Pascal Siakam,1610612761,TOR,55,21,34,1970.0,95,46,49,0.484,206,0.461,3,0.468,9.0,310,71,239,0.229,463,0.67,37,0.728,6.3,405,117,288,0.289,651,0.622,40,0.663,6.9,2020-21,Regular%20Season
1626192,Pat Connaughton,1610612749,MIL,68,44,24,1552.0,63,32,32,0.508,132,0.477,3,0.488,8.2,269,55,216,0.204,436,0.617,40,0.679,5.2,332,87,248,0.262,557,0.596,43,0.646,5.8,2020-21,Regular%20Season
201976,Patrick Beverley,1610612746,LAC,31,19,12,738.0,29,15,14,0.517,71,0.408,4,0.433,10.9,90,11,80,0.122,158,0.57,9,0.604,9.5,119,26,94,0.218,228,0.522,13,0.553,9.8,2020-21,Regular%20Season
1627775,Patrick McCaw,1610612761,TOR,2,1,1,14.0,1,0,1,0.0,1,1.0,0,1.0,7.6,2,1,1,0.5,3,0.667,0,0.667,14.1,3,1,2,0.333,4,0.75,0,0.75,11.9,2020-21,Regular%20Season
202335,Patrick Patterson,1610612746,LAC,28,19,9,454.0,19,9,8,0.474,35,0.543,0,0.543,6.6,56,13,42,0.232,97,0.577,14,0.675,7.8,75,22,50,0.293,131,0.573,14,0.641,7.5,2020-21,Regular%20Season
1630172,Patrick Williams,1610612741,CHI,70,30,40,1973.0,66,42,23,0.636,161,0.41,2,0.415,6.8,261,50,212,0.192,384,0.68,26,0.729,6.0,327,92,235,0.281,518,0.631,28,0.667,6.1,2020-21,Regular%20Season
201988,Patty Mills,1610612759,SAS,53,27,26,1327.0,18,0,18,0.0,36,0.5,0,0.5,17.6,98,7,91,0.071,143,0.685,7,0.721,11.1,116,7,109,0.06,175,0.663,7,0.69,12.2,2020-21,Regular%20Season
202331,Paul George,1610612746,LAC,54,38,16,1821.0,45,17,28,0.378,122,0.369,7,0.391,10.5,314,55,257,0.175,483,0.65,50,0.725,6.0,359,72,285,0.201,589,0.61,57,0.675,6.5,2020-21,Regular%20Season
200794,Paul Millsap,1610612743,DEN,54,36,18,1137.0,73,39,34,0.534,185,0.395,7,0.41,6.2,184,49,135,0.266,303,0.607,28,0.669,5.2,257,88,169,0.342,473,0.543,35,0.587,5.5,2020-21,Regular%20Season
1630194,Paul Reed,1610612755,PHI,17,10,7,154.0,30,25,5,0.833,52,0.577,0,0.577,5.7,31,10,21,0.323,54,0.574,5,0.633,6.2,61,35,26,0.574,104,0.587,5,0.616,5.9,2020-21,Regular%20Season
1628778,Paul Watson,1610612761,TOR,19,9,10,272.0,4,2,2,0.5,15,0.267,0,0.267,11.0,41,8,33,0.195,73,0.562,6,0.612,5.9,45,10,35,0.222,84,0.536,6,0.577,6.4,2020-21,Regular%20Season
1630202,Payton Pritchard,1610612738,BOS,52,29,23,1082.0,33,18,15,0.545,82,0.402,1,0.407,8.3,125,12,113,0.096,228,0.548,30,0.631,6.8,158,30,128,0.19,308,0.513,31,0.57,7.1,2020-21,Regular%20Season
1630173,Precious Achiuwa,1610612748,MIA,54,27,27,715.0,73,47,25,0.644,175,0.417,1,0.42,4.8,135,38,97,0.281,265,0.509,39,0.597,4.7,208,85,122,0.409,433,0.48,40,0.529,4.8,2020-21,Regular%20Season
1626188,Quinn Cook,1610612739,CLE,11,4,7,116.0,2,1,1,0.5,7,0.286,1,0.333,0.9,15,1,14,0.067,20,0.75,2,0.833,7.0,17,2,15,0.118,27,0.63,3,0.708,6.3,2020-21,Regular%20Season
1629683,Quinndary Weatherspoon,1610612759,SAS,7,1,6,81.0,3,2,1,0.667,5,0.6,1,0.75,8.9,8,1,7,0.125,15,0.533,1,0.571,13.5,11,3,8,0.273,20,0.55,2,0.611,12.2,2020-21,Regular%20Season
1630181,R.J. Hampton,1610612753,ORL,41,16,25,859.0,28,12,16,0.429,75,0.373,5,0.4,10.2,150,22,128,0.147,216,0.694,20,0.765,7.1,178,34,144,0.191,288,0.618,25,0.677,7.6,2020-21,Regular%20Season
1629628,RJ Barrett,1610612752,NYK,71,40,31,2483.0,68,35,32,0.515,200,0.34,7,0.352,9.8,346,52,292,0.15,552,0.627,31,0.664,6.1,414,87,324,0.21,728,0.569,38,0.6,6.7,2020-21,Regular%20Season
200765,Rajon Rondo,1610612746,LAC,37,21,16,646.0,18,8,10,0.444,37,0.486,1,0.5,12.3,92,11,80,0.12,152,0.605,15,0.672,8.1,110,19,90,0.173,185,0.595,16,0.651,8.8,2020-21,Regular%20Season
203526,Raul Neto,1610612764,WAS,53,24,29,1245.0,28,7,21,0.25,72,0.389,4,0.412,15.2,128,20,108,0.156,218,0.587,18,0.64,8.4,156,27,129,0.173,287,0.544,22,0.589,9.6,2020-21,Regular%20Season
1629034,Ray Spalding,1610612745,HOU,2,0,2,19.0,2,1,1,0.5,5,0.4,0,0.4,8.7,2,0,2,0.0,4,0.5,0,0.5,6.5,4,1,3,0.25,9,0.444,0,0.444,7.6,2020-21,Regular%20Season
1629730,Rayjon Tucker,1610612755,PHI,7,3,4,51.0,1,1,0,1.0,5,0.2,1,0.25,2.2,10,3,7,0.3,14,0.714,0,0.714,4.4,11,4,7,0.364,17,0.647,1,0.688,4.2,2020-21,Regular%20Season
203493,Reggie Bullock Jr.,1610612752,NYK,65,38,27,1949.0,16,7,9,0.438,48,0.333,2,0.348,17.8,207,22,184,0.106,314,0.659,29,0.726,9.4,223,29,193,0.13,359,0.621,31,0.68,10.0,2020-21,Regular%20Season
202704,Reggie Jackson,1610612746,LAC,60,41,19,1498.0,24,15,9,0.625,63,0.381,10,0.453,10.3,168,19,151,0.113,284,0.592,26,0.651,8.3,192,34,160,0.177,342,0.561,36,0.627,8.5,2020-21,Regular%20Season
1629617,Reggie Perry,1610612751,BKN,22,15,7,204.0,27,19,8,0.704,58,0.466,2,0.482,4.9,46,17,30,0.37,82,0.561,10,0.639,4.3,73,36,38,0.493,135,0.541,12,0.593,4.5,2020-21,Regular%20Season
1626158,Richaun Holmes,1610612758,SAC,60,29,31,1758.0,144,94,49,0.653,335,0.43,6,0.438,5.3,360,130,229,0.361,649,0.555,83,0.636,4.4,504,224,278,0.444,952,0.529,89,0.584,4.6,2020-21,Regular%20Season
201937,Ricky Rubio,1610612750,MIN,66,23,43,1719.0,28,3,25,0.107,81,0.346,3,0.359,17.2,195,27,167,0.138,300,0.65,26,0.712,9.5,223,30,192,0.135,375,0.595,29,0.645,10.4,2020-21,Regular%20Season
203496,Robert Covington,1610612757,POR,70,42,28,2243.0,61,29,31,0.475,152,0.401,7,0.421,10.3,405,111,293,0.274,623,0.65,55,0.713,5.1,466,140,324,0.3,738,0.631,62,0.689,5.8,2020-21,Regular%20Season
1629606,Robert Franks,1610612753,ORL,4,0,4,67.0,6,2,4,0.333,12,0.5,1,0.545,5.8,8,1,6,0.125,17,0.471,1,0.5,5.6,14,3,10,0.214,25,0.56,2,0.609,5.7,2020-21,Regular%20Season
1629057,Robert Williams III,1610612738,BOS,52,29,23,985.0,133,96,36,0.722,230,0.578,4,0.588,5.2,225,77,149,0.342,343,0.656,23,0.703,5.4,358,173,185,0.483,545,0.657,27,0.691,5.4,2020-21,Regular%20Season
1630218,Robert Woodard II,1610612758,SAC,7,1,6,32.0,4,2,0,0.5,5,0.8,0,0.8,4.5,12,4,9,0.333,20,0.6,3,0.706,4.9,16,6,9,0.375,24,0.667,3,0.762,4.8,2020-21,Regular%20Season
201577,Robin Lopez,1610612764,WAS,65,32,33,1292.0,141,101,39,0.716,305,0.462,8,0.475,4.2,131,63,68,0.481,288,0.455,41,0.53,5.7,272,164,107,0.603,583,0.467,49,0.509,4.9,2020-21,Regular%20Season
1629066,Rodions Kurucs,1610612749,MIL,13,6,7,100.0,5,4,1,0.8,14,0.357,0,0.357,6.0,18,4,14,0.222,23,0.783,1,0.818,4.3,23,8,15,0.348,37,0.622,1,0.639,4.7,2020-21,Regular%20Season
203918,Rodney Hood,1610612761,TOR,45,23,22,830.0,23,11,12,0.478,47,0.489,4,0.535,8.3,80,16,64,0.2,126,0.635,12,0.702,7.8,103,27,76,0.262,165,0.624,16,0.691,7.9,2020-21,Regular%20Season
203585,Rodney McGruder,1610612765,DET,11,2,9,162.0,8,5,3,0.625,22,0.364,1,0.381,6.9,14,3,11,0.214,23,0.609,2,0.667,6.8,22,8,14,0.364,45,0.489,3,0.524,6.8,2020-21,Regular%20Season
1629641,Romeo Langford,1610612738,BOS,13,7,6,249.0,12,7,5,0.583,22,0.545,0,0.545,5.0,23,3,20,0.13,38,0.605,1,0.622,8.2,35,10,25,0.286,60,0.583,1,0.593,7.1,2020-21,Regular%20Season
1626178,Rondae Hollis-Jefferson,1610612757,POR,9,5,4,94.0,11,6,5,0.545,26,0.423,1,0.44,3.9,15,4,11,0.267,23,0.652,1,0.682,3.9,26,10,16,0.385,48,0.542,2,0.565,3.9,2020-21,Regular%20Season
1626220,Royce O'Neale,1610612762,UTA,71,51,20,2240.0,88,32,55,0.364,202,0.436,7,0.451,10.2,397,88,305,0.222,645,0.616,74,0.695,5.2,485,120,360,0.247,811,0.598,81,0.664,6.1,2020-21,Regular%20Season
200752,Rudy Gay,1610612759,SAS,63,29,34,1358.0,42,20,22,0.476,98,0.429,2,0.438,7.7,261,69,190,0.264,356,0.733,14,0.763,5.5,303,89,212,0.294,430,0.705,16,0.732,5.8,2020-21,Regular%20Season
203497,Rudy Gobert,1610612762,UTA,71,52,19,2187.0,240,170,72,0.708,542,0.443,6,0.448,4.8,720,172,545,0.239,1125,0.64,103,0.705,3.8,960,342,617,0.356,1625,0.591,109,0.633,4.0,2020-21,Regular%20Season
1629060,Rui Hachimura,1610612764,WAS,56,29,27,1776.0,49,27,23,0.551,149,0.329,5,0.34,7.9,263,45,216,0.171,391,0.673,39,0.747,5.5,312,72,239,0.231,517,0.603,44,0.66,5.9,2020-21,Regular%20Season
201566,Russell Westbrook,1610612764,WAS,65,30,35,2369.0,109,64,45,0.587,297,0.367,7,0.376,7.6,641,114,525,0.178,820,0.782,30,0.811,5.7,750,178,570,0.237,1044,0.718,37,0.745,5.9,2020-21,Regular%20Season
1627853,Ryan Arcidiacono,1610612741,CHI,34,17,17,386.0,5,3,2,0.6,14,0.357,1,0.385,14.7,62,9,53,0.145,83,0.747,7,0.816,7.8,67,12,55,0.179,97,0.691,8,0.753,8.3,2020-21,Regular%20Season
1630240,Saben Lee,1610612765,DET,38,10,28,698.0,20,6,13,0.3,50,0.4,0,0.4,12.6,77,8,68,0.104,117,0.658,10,0.72,7.6,97,14,81,0.144,162,0.599,10,0.638,8.6,2020-21,Regular%20Season
1630180,Saddiq Bey,1610612765,DET,67,19,48,1853.0,43,20,23,0.465,110,0.391,3,0.402,12.2,275,47,226,0.171,405,0.679,26,0.726,6.7,318,67,249,0.211,493,0.645,29,0.685,7.5,2020-21,Regular%20Season
1630241,Sam Merrill,1610612749,MIL,15,9,6,181.0,6,2,3,0.333,9,0.667,0,0.667,12.2,24,5,19,0.208,42,0.571,3,0.615,8.0,30,7,22,0.233,51,0.588,3,0.625,8.7,2020-21,Regular%20Season
1630253,Sean McDermott,1610612763,MEM,8,4,4,94.0,6,5,1,0.833,12,0.5,1,0.545,8.3,13,6,7,0.462,16,0.813,0,0.813,7.8,19,11,8,0.579,28,0.679,1,0.704,8.0,2020-21,Regular%20Season
1629635,Sekou Doumbouya,1610612765,DET,47,13,34,786.0,39,17,22,0.436,102,0.382,2,0.39,7.9,103,25,79,0.243,194,0.531,23,0.602,6.5,142,42,101,0.296,282,0.504,25,0.553,6.9,2020-21,Regular%20Season
1628400,Semi Ojeleye,1610612738,BOS,49,23,26,888.0,31,10,21,0.323,65,0.477,4,0.508,12.2,116,27,90,0.233,179,0.648,14,0.703,7.2,147,37,111,0.252,229,0.642,18,0.697,8.3,2020-21,Regular%20Season
201586,Serge Ibaka,1610612746,LAC,40,24,16,936.0,71,52,18,0.732,150,0.473,5,0.49,4.3,197,73,125,0.371,308,0.64,30,0.709,4.2,268,125,143,0.466,453,0.592,35,0.641,4.3,2020-21,Regular%20Season
203552,Seth Curry,1610612755,PHI,49,33,16,1410.0,10,3,7,0.3,38,0.263,2,0.278,15.6,126,18,107,0.143,179,0.704,14,0.764,9.5,136,21,114,0.154,212,0.642,16,0.694,9.9,2020-21,Regular%20Season
1628983,Shai Gilgeous-Alexander,1610612760,OKC,35,16,19,1180.0,19,12,7,0.632,71,0.268,2,0.275,9.0,147,21,127,0.143,211,0.697,9,0.728,7.1,166,33,134,0.199,269,0.617,11,0.643,7.3,2020-21,Regular%20Season
1629003,Shake Milton,1610612755,PHI,61,44,17,1422.0,33,12,21,0.364,85,0.388,5,0.413,11.5,115,20,94,0.174,215,0.535,20,0.59,8.5,148,32,115,0.216,295,0.502,25,0.548,9.2,2020-21,Regular%20Season
1627885,Shaquille Harrison,1610612743,DEN,18,13,5,261.0,7,2,5,0.286,17,0.412,1,0.438,12.8,40,4,36,0.1,57,0.702,4,0.755,8.0,47,6,41,0.128,74,0.635,5,0.681,8.7,2020-21,Regular%20Season
1628414,Sindarius Thornwell,1610612753,ORL,10,2,8,145.0,3,1,2,0.333,9,0.333,0,0.333,12.4,15,4,11,0.267,24,0.625,5,0.789,4.7,18,5,13,0.278,32,0.563,5,0.667,6.0,2020-21,Regular%20Season
1630219,Skylar Mays,1610612737,ATL,15,9,6,176.0,10,4,6,0.4,15,0.667,1,0.714,10.4,25,1,24,0.04,42,0.595,5,0.676,8.3,35,5,30,0.143,56,0.625,6,0.7,8.9,2020-21,Regular%20Season
203524,Solomon Hill,1610612737,ATL,63,36,27,1360.0,42,20,21,0.476,84,0.5,3,0.519,11.3,171,49,121,0.287,290,0.59,34,0.668,6.4,213,69,142,0.324,363,0.587,37,0.653,7.4,2020-21,Regular%20Season
203915,Spencer Dinwiddie,1610612751,BKN,3,2,1,64.0,0,0,0,0.0,1,0.0,0,0.0,0.0,13,2,11,0.154,20,0.65,0,0.65,7.7,13,2,11,0.154,21,0.619,0,0.619,7.7,2020-21,Regular%20Season
1626169,Stanley Johnson,1610612761,TOR,48,18,30,911.0,29,13,15,0.448,65,0.446,3,0.468,9.1,124,18,106,0.145,219,0.566,22,0.629,6.6,153,31,121,0.203,275,0.556,25,0.612,7.1,2020-21,Regular%20Season
201939,Stephen Curry,1610612744,GSW,63,37,26,2151.0,29,16,12,0.552,93,0.312,2,0.319,11.2,316,51,265,0.161,502,0.629,45,0.691,8.1,345,67,277,0.194,590,0.585,47,0.635,8.4,2020-21,Regular%20Season
1628425,Sterling Brown,1610612745,HOU,48,13,35,1198.0,38,19,16,0.5,90,0.422,6,0.452,12.7,186,46,134,0.247,316,0.589,33,0.657,5.8,224,65,150,0.29,399,0.561,39,0.622,6.9,2020-21,Regular%20Season
203500,Steven Adams,1610612740,NOP,58,26,32,1605.0,213,162,49,0.761,461,0.462,9,0.471,4.3,301,108,192,0.359,489,0.616,39,0.669,4.9,514,270,241,0.525,930,0.553,48,0.583,4.6,2020-21,Regular%20Season
1629004,Svi Mykhailiuk,1610612760,OKC,57,9,48,1218.0,24,5,18,0.208,61,0.393,2,0.407,17.8,139,22,116,0.158,197,0.706,22,0.794,8.9,163,27,134,0.166,253,0.644,24,0.712,10.1,2020-21,Regular%20Season
1628388,T.J. Leaf,1610612757,POR,4,3,1,21.0,0,0,0,0.0,5,0.0,0,0.0,0.0,5,1,4,0.2,8,0.625,1,0.714,5.6,5,1,4,0.2,12,0.417,1,0.455,5.6,2020-21,Regular%20Season
204456,T.J. McConnell,1610612754,IND,68,33,35,1784.0,55,19,35,0.345,124,0.444,2,0.451,13.6,201,27,174,0.134,323,0.622,26,0.677,9.4,256,46,209,0.18,443,0.578,28,0.617,10.3,2020-21,Regular%20Season
203933,T.J. Warren,1610612754,IND,4,3,1,117.0,2,2,0,1.0,5,0.4,0,0.4,5.3,12,2,10,0.167,17,0.706,2,0.8,7.7,14,4,10,0.286,22,0.636,2,0.7,7.3,2020-21,Regular%20Season
1629605,Tacko Fall,1610612738,BOS,16,12,4,126.0,16,11,6,0.688,35,0.457,0,0.457,5.6,36,12,24,0.333,54,0.667,3,0.706,4.2,52,23,30,0.442,88,0.591,3,0.612,4.7,2020-21,Regular%20Season
201959,Taj Gibson,1610612752,NYK,42,26,16,905.0,99,67,31,0.677,202,0.49,3,0.497,5.6,151,49,102,0.325,280,0.539,38,0.624,5.6,250,116,133,0.464,470,0.532,41,0.583,5.6,2020-21,Regular%20Season
1629659,Talen Horton-Tucker,1610612747,LAL,59,36,23,1228.0,25,7,18,0.28,82,0.305,0,0.305,10.8,144,25,118,0.174,246,0.585,25,0.652,6.0,169,32,136,0.189,313,0.54,25,0.587,6.8,2020-21,Regular%20Season
1627752,Taurean Prince,1610612739,CLE,38,13,25,855.0,19,12,8,0.632,47,0.404,0,0.404,8.1,123,30,93,0.244,173,0.711,7,0.741,7.4,142,42,101,0.296,216,0.657,7,0.679,7.5,2020-21,Regular%20Season
1629611,Terance Mann,1610612746,LAC,56,37,19,1178.0,56,31,25,0.554,120,0.467,5,0.487,6.7,184,44,141,0.239,296,0.622,23,0.674,6.4,240,75,166,0.313,405,0.593,28,0.637,6.5,2020-21,Regular%20Season
1629056,Terence Davis,1610612758,SAC,56,24,32,1040.0,20,11,8,0.55,82,0.244,1,0.247,8.7,134,23,111,0.172,216,0.62,14,0.663,7.5,154,34,119,0.221,286,0.538,15,0.568,7.6,2020-21,Regular%20Season
1628390,Terrance Ferguson,1610612755,PHI,1,1,0,4.0,0,0,0,0.0,0,0.0,0,0.0,0.0,1,1,0,1.0,1,1.0,0,1.0,3.0,1,1,0,1.0,1,1.0,0,1.0,3.0,2020-21,Regular%20Season
203082,Terrence Ross,1610612753,ORL,45,16,29,1318.0,15,6,11,0.4,49,0.306,2,0.319,14.4,143,19,124,0.133,207,0.691,15,0.745,8.3,158,25,135,0.158,250,0.632,17,0.678,9.0,2020-21,Regular%20Season
1626179,Terry Rozier,1610612766,CHA,68,32,36,2348.0,47,20,28,0.426,114,0.412,7,0.439,12.2,255,34,220,0.133,402,0.634,36,0.697,7.1,302,54,248,0.179,514,0.588,43,0.641,7.9,2020-21,Regular%20Season
201152,Thaddeus Young,1610612741,CHI,68,30,38,1652.0,168,107,59,0.637,339,0.496,10,0.511,5.8,255,49,206,0.192,411,0.62,43,0.693,6.0,423,156,265,0.369,715,0.592,53,0.639,5.9,2020-21,Regular%20Season
203648,Thanasis Antetokounmpo,1610612749,MIL,40,26,14,491.0,54,29,24,0.537,102,0.529,1,0.535,8.5,70,14,56,0.2,107,0.654,5,0.686,7.4,124,43,80,0.347,203,0.611,6,0.629,7.9,2020-21,Regular%20Season
1630177,Theo Maledon,1610612760,OKC,61,18,43,1701.0,25,6,19,0.24,57,0.439,2,0.455,14.8,186,25,161,0.134,322,0.578,27,0.631,8.1,211,31,180,0.147,375,0.563,29,0.61,8.9,2020-21,Regular%20Season
1629033,Theo Pinson,1610612752,NYK,5,3,2,8.0,0,0,0,0.0,0,0.0,0,0.0,0.0,5,3,2,0.6,6,0.833,0,0.833,4.9,5,3,2,0.6,6,0.833,0,0.833,4.9,2020-21,Regular%20Season
1628418,Thomas Bryant,1610612764,WAS,9,2,7,269.0,18,10,7,0.556,43,0.419,1,0.429,5.9,43,12,32,0.279,84,0.512,12,0.597,4.3,61,22,39,0.361,125,0.488,13,0.545,4.8,2020-21,Regular%20Season
1627748,Thon Maker,1610612739,CLE,6,1,5,67.0,8,3,5,0.375,13,0.615,0,0.615,8.4,10,2,8,0.2,21,0.476,4,0.588,6.6,18,5,13,0.278,32,0.563,4,0.643,7.4,2020-21,Regular%20Season
204025,Tim Frazier,1610612763,MEM,5,5,0,62.0,0,0,0,0.0,1,0.0,0,0.0,0.0,8,0,8,0.0,17,0.471,2,0.533,7.6,8,0,8,0.0,18,0.444,2,0.5,7.6,2020-21,Regular%20Season
203501,Tim Hardaway Jr.,1610612742,DAL,67,41,26,1917.0,20,11,9,0.55,71,0.282,4,0.299,9.5,209,37,171,0.177,354,0.59,35,0.655,7.4,229,48,180,0.21,413,0.554,39,0.612,7.6,2020-21,Regular%20Season
1627789,Timothe Luwawu-Cabarrot,1610612751,BKN,49,31,18,975.0,28,12,16,0.429,60,0.467,3,0.491,13.0,101,28,73,0.277,192,0.526,19,0.584,6.4,129,40,89,0.31,243,0.531,22,0.584,7.8,2020-21,Regular%20Season
202699,Tobias Harris,1610612755,PHI,62,44,18,2014.0,62,40,21,0.645,177,0.35,8,0.367,6.8,357,64,294,0.179,558,0.64,49,0.701,5.4,419,104,315,0.248,712,0.588,57,0.64,5.6,2020-21,Regular%20Season
203107,Tomas Satoransky,1610612741,CHI,52,22,30,1181.0,30,15,15,0.5,74,0.405,1,0.411,11.6,112,18,94,0.161,175,0.64,18,0.713,8.2,142,33,109,0.232,247,0.575,19,0.623,8.9,2020-21,Regular%20Season
1628396,Tony Bradley,1610612760,OKC,37,12,25,666.0,85,59,23,0.694,160,0.531,3,0.541,4.1,154,57,94,0.37,224,0.688,15,0.737,5.5,239,116,117,0.485,371,0.644,18,0.677,5.0,2020-21,Regular%20Season
203503,Tony Snell,1610612737,ATL,41,24,17,931.0,18,3,15,0.167,44,0.409,0,0.409,16.6,94,12,81,0.128,154,0.61,12,0.662,7.9,112,15,96,0.134,193,0.58,12,0.619,9.3,2020-21,Regular%20Season
1628470,Torrey Craig,1610612756,PHX,47,33,14,789.0,57,39,18,0.684,140,0.407,4,0.419,7.0,140,33,106,0.236,210,0.667,22,0.745,6.0,197,72,124,0.365,336,0.586,26,0.635,6.3,2020-21,Regular%20Season
1629027,Trae Young,1610612737,ATL,62,35,27,2099.0,38,7,31,0.184,131,0.29,4,0.299,11.6,207,18,186,0.087,313,0.661,21,0.709,10.6,245,25,217,0.102,441,0.556,25,0.589,10.7,2020-21,Regular%20Season
1630200,Tre Jones,1610612759,SAS,13,3,10,159.0,8,3,5,0.375,17,0.471,0,0.471,10.6,13,2,11,0.154,14,0.929,0,0.929,9.9,21,5,16,0.238,31,0.677,0,0.677,10.2,2020-21,Regular%20Season
1629682,Tremont Waters,1610612738,BOS,12,6,6,161.0,5,1,4,0.2,8,0.625,0,0.625,10.3,16,2,14,0.125,20,0.8,0,0.8,9.6,21,3,18,0.143,28,0.75,0,0.75,9.8,2020-21,Regular%20Season
1630235,Trent Forrest,1610612762,UTA,19,14,5,249.0,11,5,6,0.455,17,0.647,0,0.647,11.8,33,6,27,0.182,47,0.702,1,0.717,6.7,44,11,33,0.25,63,0.698,1,0.71,8.0,2020-21,Regular%20Season
2772,Trevor Ariza,1610612748,MIA,29,17,12,835.0,27,10,17,0.37,66,0.409,3,0.429,12.4,117,26,91,0.222,184,0.636,23,0.727,6.5,144,36,108,0.25,241,0.598,26,0.67,7.6,2020-21,Regular%20Season
203504,Trey Burke,1610612742,DAL,34,16,18,589.0,10,1,9,0.1,21,0.476,2,0.526,14.2,44,4,40,0.091,72,0.611,6,0.667,11.2,54,5,49,0.093,93,0.581,8,0.635,11.8,2020-21,Regular%20Season
1626168,Trey Lyles,1610612759,SAS,20,8,12,348.0,9,6,3,0.667,24,0.375,0,0.375,7.2,77,21,56,0.273,111,0.694,7,0.74,4.6,86,27,59,0.314,129,0.667,7,0.705,4.9,2020-21,Regular%20Season
202684,Tristan Thompson,1610612738,BOS,54,27,27,1287.0,169,130,36,0.769,399,0.424,13,0.438,4.5,270,70,201,0.259,415,0.651,41,0.722,5.4,439,200,237,0.456,796,0.552,54,0.592,5.1,2020-21,Regular%20Season
1628972,Troy Brown Jr.,1610612741,CHI,32,10,22,520.0,20,13,7,0.65,38,0.526,0,0.526,10.6,85,9,75,0.106,135,0.63,13,0.697,5.5,105,22,82,0.21,171,0.614,13,0.665,6.5,2020-21,Regular%20Season
1629660,Ty Jerome,1610612760,OKC,32,7,25,766.0,10,3,8,0.3,30,0.333,0,0.333,13.8,81,11,70,0.136,122,0.664,5,0.692,7.9,91,14,78,0.154,150,0.607,5,0.628,8.6,2020-21,Regular%20Season
1630234,Ty-Shon Alexander,1610612756,PHX,7,5,2,32.0,2,0,2,0.0,3,0.667,0,0.667,16.9,8,0,8,0.0,9,0.889,0,0.889,7.6,10,0,10,0.0,11,0.909,0,0.909,9.4,2020-21,Regular%20Season
1630189,Tyler Bey,1610612742,DAL,11,6,5,45.0,8,5,3,0.625,15,0.533,0,0.533,5.6,10,3,7,0.3,15,0.667,2,0.769,5.1,18,8,10,0.444,26,0.692,2,0.75,5.3,2020-21,Regular%20Season
1629076,Tyler Cook,1610612765,DET,24,6,18,392.0,26,11,15,0.423,63,0.413,4,0.441,7.4,66,7,60,0.106,102,0.647,7,0.695,5.9,92,18,75,0.196,156,0.59,11,0.634,6.3,2020-21,Regular%20Season
1629639,Tyler Herro,1610612748,MIA,54,29,25,1635.0,25,8,17,0.32,91,0.275,4,0.287,13.0,243,21,221,0.086,397,0.612,26,0.655,6.7,268,29,238,0.108,468,0.573,30,0.612,7.3,2020-21,Regular%20Season
204020,Tyler Johnson,1610612751,BKN,30,25,5,592.0,6,2,4,0.333,20,0.3,2,0.333,18.1,71,8,63,0.113,122,0.582,11,0.64,8.2,77,10,67,0.13,142,0.542,13,0.597,9.0,2020-21,Regular%20Season
1630179,Tyrell Terry,1610612742,DAL,5,2,3,30.0,0,0,0,0.0,0,0.0,0,0.0,0.0,6,0,6,0.0,12,0.5,1,0.545,5.0,6,0,6,0.0,12,0.5,1,0.545,5.0,2020-21,Regular%20Season
1630169,Tyrese Haliburton,1610612758,SAC,56,24,32,1682.0,39,16,22,0.41,86,0.453,3,0.47,12.8,134,17,116,0.127,209,0.641,8,0.667,10.1,173,33,138,0.191,294,0.588,11,0.611,10.7,2020-21,Regular%20Season
1630178,Tyrese Maxey,1610612755,PHI,43,30,13,780.0,11,3,8,0.273,37,0.297,5,0.344,14.3,93,14,78,0.151,140,0.664,14,0.738,8.6,104,17,86,0.163,175,0.594,19,0.667,9.2,2020-21,Regular%20Season
1626145,Tyus Jones,1610612763,MEM,56,32,24,1021.0,21,3,18,0.143,39,0.538,1,0.553,19.2,119,8,111,0.067,173,0.688,9,0.726,8.7,140,11,129,0.079,212,0.66,10,0.693,10.3,2020-21,Regular%20Season
1628962,Udoka Azubuike,1610612762,UTA,7,6,1,38.0,4,2,2,0.5,9,0.444,0,0.444,3.7,9,3,6,0.333,15,0.6,0,0.6,4.8,13,5,8,0.385,20,0.65,0,0.65,4.5,2020-21,Regular%20Season
2617,Udonis Haslem,1610612748,MIA,1,1,0,3.0,0,0,0,0.0,0,0.0,0,0.0,0.0,1,1,0,1.0,3,0.333,0,0.333,2.4,1,1,0,1.0,3,0.333,0,0.333,2.4,2020-21,Regular%20Season
1630176,Vernon Carey Jr.,1610612766,CHA,13,6,7,99.0,6,4,2,0.667,17,0.353,1,0.375,6.1,21,9,12,0.429,36,0.583,3,0.636,5.0,27,13,14,0.481,51,0.529,4,0.574,5.2,2020-21,Regular%20Season
203506,Victor Oladipo,1610612748,MIA,32,12,20,1045.0,12,5,7,0.417,53,0.226,1,0.231,11.5,146,24,122,0.164,236,0.619,21,0.679,7.6,158,29,129,0.184,289,0.547,22,0.592,7.9,2020-21,Regular%20Season
1629738,Vincent Poirier,1610612755,PHI,7,6,1,34.0,6,5,1,0.833,13,0.462,0,0.462,2.7,8,0,7,0.0,10,0.8,0,0.8,5.8,14,5,8,0.357,21,0.667,0,0.667,4.4,2020-21,Regular%20Season
1628427,Vlatko Cancar,1610612743,DEN,23,16,7,224.0,11,2,10,0.182,30,0.367,0,0.367,5.8,39,10,29,0.256,48,0.813,4,0.886,5.7,50,12,39,0.24,75,0.667,4,0.704,5.8,2020-21,Regular%20Season
201961,Wayne Ellington,1610612765,DET,41,12,29,922.0,12,3,9,0.25,24,0.5,0,0.5,17.2,73,7,64,0.096,129,0.566,11,0.619,10.5,85,10,73,0.118,151,0.563,11,0.607,11.5,2020-21,Regular%20Season
1628976,Wendell Carter Jr.,1610612753,ORL,54,21,33,1375.0,132,95,35,0.72,297,0.444,11,0.462,5.3,311,105,204,0.338,542,0.574,56,0.64,4.5,443,200,239,0.451,815,0.544,67,0.592,4.7,2020-21,Regular%20Season
1629117,Wenyen Gabriel,1610612740,NOP,19,7,12,236.0,20,14,6,0.7,35,0.571,1,0.588,4.6,34,9,25,0.265,59,0.576,7,0.654,8.8,54,23,31,0.426,91,0.593,8,0.651,7.2,2020-21,Regular%20Season
1628411,Wes Iwundu,1610612740,NOP,32,13,19,512.0,15,7,8,0.467,36,0.417,1,0.429,9.6,75,13,62,0.173,114,0.658,8,0.708,5.6,90,20,70,0.222,147,0.612,9,0.652,6.2,2020-21,Regular%20Season
202083,Wesley Matthews,1610612747,LAL,45,24,21,940.0,20,7,13,0.35,45,0.444,0,0.444,15.1,73,23,51,0.315,142,0.514,16,0.579,9.2,93,30,64,0.323,179,0.52,16,0.571,10.4,2020-21,Regular%20Season
203115,Will Barton,1610612743,DEN,55,37,18,1735.0,39,19,19,0.487,108,0.361,2,0.368,7.2,187,29,156,0.155,337,0.555,44,0.638,5.2,226,48,175,0.212,436,0.518,46,0.579,5.6,2020-21,Regular%20Season
1626161,Willie Cauley-Stein,1610612742,DAL,52,29,23,900.0,66,40,26,0.606,134,0.493,0,0.493,6.1,170,40,130,0.235,293,0.58,39,0.669,5.1,236,80,156,0.339,411,0.574,39,0.634,5.4,2020-21,Regular%20Season
1626195,Willy Hernangomez,1610612740,NOP,44,19,25,836.0,117,84,32,0.718,221,0.529,4,0.539,5.2,216,74,143,0.343,356,0.607,35,0.673,4.0,333,158,175,0.474,554,0.601,39,0.647,4.4,2020-21,Regular%20Season
1630214,Xavier Tillman,1610612763,MEM,56,30,26,1068.0,74,38,35,0.514,165,0.448,7,0.468,7.4,182,63,119,0.346,317,0.574,31,0.636,5.5,256,101,154,0.395,464,0.552,38,0.601,6.0,2020-21,Regular%20Season
1627812,Yogi Ferrell,1610612746,LAC,5,0,5,105.0,5,0,5,0.0,13,0.385,1,0.417,33.5,14,2,8,0.143,20,0.7,2,0.778,22.8,19,2,13,0.105,32,0.594,3,0.655,26.4,2020-21,Regular%20Season
1629139,Yuta Watanabe,1610612761,TOR,44,22,22,684.0,36,23,12,0.639,72,0.5,3,0.522,9.0,123,29,94,0.236,205,0.6,17,0.654,4.9,159,52,106,0.327,272,0.585,20,0.631,5.8,2020-21,Regular%20Season
203897,Zach LaVine,1610612741,CHI,57,25,32,2002.0,36,17,20,0.472,127,0.283,7,0.3,9.8,253,35,216,0.138,421,0.601,41,0.666,6.0,289,52,236,0.18,535,0.54,48,0.593,6.5,2020-21,Regular%20Season
1630192,Zeke Nnaji,1610612743,DEN,29,20,9,349.0,14,7,7,0.5,42,0.333,1,0.341,7.0,51,16,36,0.314,78,0.654,6,0.708,5.3,65,23,43,0.354,116,0.56,7,0.596,5.6,2020-21,Regular%20Season
1629627,Zion Williamson,1610612740,NOP,61,29,32,2026.0,167,126,41,0.754,404,0.413,11,0.425,5.0,274,70,203,0.255,442,0.62,33,0.67,5.9,441,196,244,0.444,819,0.538,44,0.569,5.5,2020-21,Regular%20Season
203932,Aaron Gordon,1610612743,DEN,10,4,6,299.0,21,16,4,0.762,46,0.457,1,0.467,4.6,33,12,21,0.364,54,0.611,4,0.66,5.0,54,28,25,0.519,95,0.568,5,0.6,4.8,2020-21,Playoffs
1630174,Aaron Nesmith,1610612738,BOS,5,1,4,75.0,2,2,0,1.0,10,0.2,1,0.222,9.7,11,1,10,0.091,23,0.478,5,0.611,3.5,13,3,10,0.231,31,0.419,6,0.52,4.5,2020-21,Playoffs
1627846,Abdel Nader,1610612756,PHX,3,2,1,21.0,0,0,0,0.0,2,0.0,1,0.0,0.0,5,0,5,0.0,7,0.714,1,0.833,5.3,5,0,5,0.0,8,0.625,2,0.833,5.3,2020-21,Playoffs
202692,Alec Burks,1610612752,NYK,5,1,4,128.0,5,1,4,0.2,10,0.5,1,0.556,8.0,20,4,16,0.2,31,0.645,3,0.714,6.5,25,5,20,0.2,41,0.61,4,0.676,6.8,2020-21,Playoffs
1627936,Alex Caruso,1610612747,LAL,5,2,3,97.0,2,1,1,0.5,6,0.333,0,0.333,13.7,6,2,4,0.333,11,0.545,2,0.667,5.8,8,3,5,0.375,17,0.471,2,0.533,7.8,2020-21,Playoffs
203458,Alex Len,1610612764,WAS,4,0,4,41.0,4,2,2,0.5,10,0.4,1,0.444,3.4,7,2,5,0.286,12,0.583,2,0.7,3.9,11,4,7,0.364,21,0.524,3,0.611,3.7,2020-21,Playoffs
1628035,Alfonzo McKinnie,1610612747,LAL,1,0,1,11.0,0,0,0,0.0,1,0.0,0,0.0,0.0,1,0,1,0.0,1,1.0,0,1.0,1.6,1,0,1,0.0,1,1.0,0,1.0,1.6,2020-21,Playoffs
1628993,Alize Johnson,1610612751,BKN,5,3,2,23.0,3,2,1,0.667,10,0.3,1,0.333,3.4,10,3,7,0.3,12,0.833,1,0.909,3.6,13,5,8,0.385,21,0.619,2,0.684,3.5,2020-21,Playoffs
1629599,Amir Coffey,1610612746,LAC,2,2,0,3.0,0,0,0,0.0,0,0.0,0,0.0,0.0,2,1,1,0.5,2,1.0,0,1.0,5.6,2,1,1,0.5,2,1.0,0,1.0,5.6,2020-21,Playoffs
203083,Andre Drummond,1610612747,LAL,5,2,3,105.0,19,17,2,0.895,33,0.576,0,0.576,4.3,36,5,31,0.139,53,0.679,6,0.766,4.9,55,22,33,0.4,82,0.671,6,0.724,4.7,2020-21,Playoffs
2738,Andre Iguodala,1610612748,MIA,4,0,4,71.0,3,2,1,0.667,4,0.75,0,0.75,5.8,9,3,6,0.333,15,0.6,2,0.692,6.6,12,5,7,0.417,19,0.632,2,0.706,6.4,2020-21,Playoffs
1629014,Anfernee Simons,1610612757,POR,5,2,3,87.0,3,1,2,0.333,3,1.0,0,1.0,16.6,13,3,10,0.231,18,0.722,1,0.765,9.2,16,4,12,0.25,21,0.762,1,0.8,10.6,2020-21,Playoffs
203076,Anthony Davis,1610612747,LAL,5,2,3,144.0,7,3,4,0.429,14,0.5,0,0.5,5.2,26,10,16,0.385,43,0.605,7,0.722,4.3,33,13,20,0.394,55,0.6,7,0.688,4.5,2020-21,Playoffs
1630264,Anthony Gill,1610612764,WAS,3,0,3,30.0,1,0,1,0.0,5,0.2,0,0.2,7.1,3,1,2,0.333,4,0.75,1,1.0,6.1,4,1,3,0.25,9,0.444,1,0.5,6.3,2020-21,Playoffs
203085,Austin Rivers,1610612743,DEN,8,4,4,254.0,1,1,0,1.0,4,0.25,0,0.25,2.2,16,1,15,0.063,27,0.593,2,0.64,10.4,17,2,15,0.118,31,0.548,2,0.586,9.9,2020-21,Playoffs
1626253,Axel Toupane,1610612749,MIL,2,2,0,7.0,2,1,1,0.5,5,0.4,1,0.5,14.1,2,1,1,0.5,2,1.0,0,1.0,6.6,4,2,2,0.5,7,0.571,1,0.667,10.4,2020-21,Playoffs
1628389,Bam Adebayo,1610612748,MIA,4,0,4,136.0,14,10,4,0.714,24,0.583,0,0.583,5.8,23,11,12,0.478,38,0.605,5,0.697,4.4,37,21,16,0.568,61,0.607,5,0.661,4.9,2020-21,Playoffs
203463,Ben McLemore,1610612747,LAL,2,1,1,20.0,1,0,1,0.0,2,0.5,0,0.5,17.6,6,2,4,0.333,7,0.857,0,0.857,6.5,7,2,5,0.286,9,0.778,0,0.778,8.1,2020-21,Playoffs
1627732,Ben Simmons,1610612755,PHI,12,7,5,402.0,25,15,10,0.6,49,0.51,0,0.51,6.4,70,11,59,0.157,91,0.769,2,0.787,9.5,95,26,69,0.274,132,0.72,2,0.731,8.6,2020-21,Playoffs
201933,Blake Griffin,1610612751,BKN,12,7,5,318.0,15,10,5,0.667,33,0.455,2,0.484,4.1,56,19,36,0.339,101,0.554,8,0.602,4.1,71,29,41,0.408,130,0.546,10,0.592,4.1,2020-21,Playoffs
1626246,Boban Marjanovic,1610612742,DAL,4,1,3,83.0,14,13,1,0.929,30,0.467,1,0.483,3.0,18,6,12,0.333,27,0.667,2,0.72,4.4,32,19,13,0.594,54,0.593,3,0.627,3.8,2020-21,Playoffs
1626171,Bobby Portis,1610612749,MIL,20,14,6,366.0,33,19,14,0.576,72,0.458,2,0.471,5.4,67,19,48,0.284,111,0.604,9,0.657,4.9,100,38,62,0.38,182,0.549,11,0.585,5.0,2020-21,Playoffs
203992,Bogdan Bogdanovic,1610612737,ATL,17,10,7,580.0,11,3,8,0.273,24,0.458,0,0.458,10.9,64,15,49,0.234,130,0.492,10,0.533,7.1,75,18,57,0.24,154,0.487,10,0.521,7.6,2020-21,Playoffs
202711,Bojan Bogdanovic,1610612762,UTA,11,6,5,390.0,6,1,5,0.167,16,0.375,2,0.429,20.4,41,3,38,0.073,65,0.631,3,0.661,6.5,47,4,43,0.085,81,0.58,5,0.618,8.2,2020-21,Playoffs
1629626,Bol Bol,1610612743,DEN,1,1,0,2.0,0,0,0,0.0,0,0.0,0,0.0,0.0,1,0,1,0.0,1,1.0,0,1.0,19.5,1,0,1,0.0,1,1.0,0,1.0,19.5,2020-21,Playoffs
203078,Bradley Beal,1610612764,WAS,5,1,4,195.0,6,3,3,0.5,17,0.353,1,0.375,10.0,25,6,19,0.24,39,0.641,2,0.676,6.3,31,9,22,0.29,54,0.574,3,0.608,7.0,2020-21,Playoffs
1629634,Brandon Clarke,1610612763,MEM,1,0,1,7.0,0,0,0,0.0,0,0.0,0,0.0,0.0,1,0,1,0.0,2,0.5,0,0.5,2.5,1,0,1,0.0,2,0.5,0,0.5,2.5,2020-21,Playoffs
201572,Brook Lopez,1610612749,MIL,23,16,7,667.0,48,36,12,0.75,97,0.495,1,0.5,6.3,87,44,43,0.506,152,0.572,16,0.64,6.2,135,80,55,0.593,244,0.553,17,0.595,6.2,2020-21,Playoffs
1628971,Bruce Brown,1610612751,BKN,12,7,5,277.0,23,13,10,0.565,51,0.451,2,0.469,8.8,38,9,29,0.237,66,0.576,4,0.613,7.1,61,22,39,0.361,115,0.53,6,0.56,7.8,2020-21,Playoffs
1628981,Bruno Fernando,1610612737,ATL,1,0,1,1.0,1,0,1,0.0,1,1.0,0,1.0,3.8,0,0,0,0.0,0,0.0,0,0.0,0.0,1,0,1,0.0,1,1.0,0,1.0,3.8,2020-21,Playoffs
1627854,Bryn Forbes,1610612749,MIL,15,10,5,234.0,2,1,1,0.5,7,0.286,0,0.286,16.4,26,7,18,0.269,39,0.667,5,0.765,7.1,28,8,19,0.286,45,0.622,5,0.7,7.8,2020-21,Playoffs
1629604,CJ Elleby,1610612757,POR,1,1,0,4.0,1,1,0,1.0,1,1.0,0,1.0,3.9,2,0,2,0.0,2,1.0,0,1.0,12.3,3,1,2,0.333,3,1.0,0,1.0,9.5,2020-21,Playoffs
203468,CJ McCollum,1610612757,POR,6,2,4,240.0,6,1,5,0.167,16,0.375,1,0.4,12.7,30,1,29,0.033,42,0.714,3,0.769,8.3,36,2,34,0.056,58,0.621,4,0.667,9.1,2020-21,Playoffs
1629629,Cam Reddish,1610612737,ATL,4,1,3,92.0,1,0,1,0.0,3,0.333,0,0.333,3.5,13,3,10,0.231,21,0.619,1,0.65,8.5,14,3,11,0.214,24,0.583,1,0.609,8.1,2020-21,Playoffs
1629661,Cameron Johnson,1610612756,PHX,21,13,8,443.0,16,7,9,0.438,28,0.571,0,0.571,10.2,50,14,36,0.28,96,0.521,11,0.588,7.8,66,21,45,0.318,123,0.537,11,0.589,8.4,2020-21,Playoffs
1626166,Cameron Payne,1610612756,PHX,21,14,7,414.0,6,0,6,0.0,28,0.214,0,0.214,13.5,49,7,42,0.143,83,0.59,7,0.645,6.6,55,7,48,0.127,107,0.514,7,0.55,7.4,2020-21,Playoffs
2546,Carmelo Anthony,1610612757,POR,6,2,4,143.0,2,0,2,0.0,5,0.4,0,0.4,21.1,17,5,12,0.294,28,0.607,2,0.654,8.1,19,5,14,0.263,31,0.613,2,0.655,9.5,2020-21,Playoffs
1629035,Carsen Edwards,1610612738,BOS,1,0,1,4.0,0,0,0,0.0,0,0.0,0,0.0,0.0,1,0,1,0.0,1,1.0,0,1.0,9.3,1,0,1,0.0,1,1.0,0,1.0,9.3,2020-21,Playoffs
1630216,Cassius Winston,1610612764,WAS,1,0,1,5.0,1,0,1,0.0,2,0.5,0,0.5,8.6,1,0,1,0.0,2,0.5,1,1.0,13.5,2,0,2,0.0,4,0.5,1,0.667,11.0,2020-21,Playoffs
1628990,Chandler Hutchison,1610612764,WAS,2,0,2,18.0,0,0,0,0.0,2,0.0,0,0.0,0.0,3,1,2,0.333,3,1.0,0,1.0,3.3,3,1,2,0.333,5,0.6,0,0.6,3.3,2020-21,Playoffs
1629185,Chris Chiozza,1610612751,BKN,1,1,0,6.0,0,0,0,0.0,0,0.0,0,0.0,0.0,1,0,1,0.0,4,0.25,0,0.25,11.0,1,0,1,0.0,4,0.25,0,0.25,11.0,2020-21,Playoffs
101108,Chris Paul,1610612756,PHX,19,12,7,649.0,9,1,8,0.111,21,0.429,1,0.45,20.5,61,6,55,0.098,110,0.555,12,0.622,9.2,70,7,63,0.1,130,0.538,13,0.598,10.7,2020-21,Playoffs
203991,Clint Capela,1610612737,ATL,18,10,8,569.0,61,44,17,0.721,132,0.462,1,0.466,5.3,140,42,98,0.3,204,0.686,19,0.757,4.5,201,86,115,0.428,323,0.622,20,0.663,4.7,2020-21,Playoffs
203081,Damian Lillard,1610612757,POR,6,2,4,248.0,1,0,1,0.0,10,0.1,0,0.1,8.7,25,3,22,0.12,49,0.51,2,0.532,8.0,26,3,23,0.115,58,0.448,2,0.464,8.0,2020-21,Playoffs
1629655,Daniel Gafford,1610612764,WAS,5,1,4,117.0,14,9,5,0.643,27,0.519,0,0.519,3.0,15,7,8,0.467,33,0.455,3,0.5,4.1,29,16,13,0.552,57,0.509,3,0.537,3.6,2020-21,Playoffs
1630187,Daniel Oturu,1610612746,LAC,4,3,1,8.0,2,2,0,1.0,3,0.667,0,0.667,1.1,2,1,1,0.5,2,1.0,0,1.0,2.3,4,3,1,0.75,5,0.8,0,0.8,1.7,2020-21,Playoffs
201568,Danilo Gallinari,1610612737,ATL,18,10,8,442.0,8,5,3,0.625,20,0.4,0,0.4,10.7,62,18,44,0.29,114,0.544,14,0.62,5.8,70,23,47,0.329,131,0.534,14,0.598,6.3,2020-21,Playoffs
201980,Danny Green,1610612755,PHI,8,6,2,198.0,9,4,5,0.444,19,0.474,0,0.474,6.9,12,5,7,0.417,23,0.522,4,0.632,6.3,21,9,12,0.429,42,0.5,4,0.553,6.6,2020-21,Playoffs
203967,Dario Saric,1610612756,PHX,13,10,3,139.0,9,6,3,0.667,25,0.36,1,0.375,8.8,26,6,20,0.231,45,0.578,3,0.619,5.3,35,12,23,0.343,67,0.522,4,0.556,6.2,2020-21,Playoffs
202722,Davis Bertans,1610612764,WAS,3,1,2,75.0,0,0,0,0.0,0,0.0,0,0.0,0.0,11,0,11,0.0,18,0.611,0,0.611,5.4,11,0,11,0.0,18,0.611,0,0.611,5.4,2020-21,Playoffs
1629631,De'Andre Hunter,1610612737,ATL,5,4,1,152.0,2,1,1,0.5,11,0.182,0,0.182,12.0,18,3,15,0.167,29,0.621,2,0.667,8.5,20,4,16,0.2,38,0.526,2,0.556,8.9,2020-21,Playoffs
1629001,De'Anthony Melton,1610612763,MEM,5,1,4,83.0,4,2,2,0.5,8,0.5,0,0.5,6.1,12,4,8,0.333,25,0.48,1,0.5,6.1,16,6,10,0.375,33,0.485,1,0.5,6.1,2020-21,Playoffs
202326,DeMarcus Cousins,1610612746,LAC,5,1,4,54.0,6,5,1,0.833,17,0.353,0,0.353,3.4,8,4,4,0.5,19,0.421,3,0.5,5.9,14,9,5,0.643,34,0.412,3,0.452,4.9,2020-21,Playoffs
1629028,Deandre Ayton,1610612756,PHX,22,14,8,801.0,67,45,22,0.672,168,0.399,3,0.406,5.6,193,58,135,0.301,275,0.702,18,0.751,4.3,260,103,157,0.396,425,0.612,21,0.644,4.6,2020-21,Playoffs
203471,Dennis Schroder,1610612747,LAL,6,2,4,196.0,1,0,1,0.0,6,0.167,1,0.2,18.9,17,4,13,0.235,26,0.654,2,0.708,8.9,18,4,14,0.222,32,0.563,3,0.621,9.4,2020-21,Playoffs
202324,Derrick Favors,1610612762,UTA,10,5,5,133.0,19,17,2,0.895,41,0.463,0,0.463,3.8,27,14,13,0.519,50,0.54,4,0.587,3.8,46,31,15,0.674,89,0.517,4,0.541,3.8,2020-21,Playoffs
1627884,Derrick Jones Jr.,1610612757,POR,1,0,1,5.0,0,1,0,0.0,1,0.0,0,0.0,2.3,0,0,0,0.0,0,0.0,0,0.0,0.0,0,1,0,0.0,1,0.0,0,0.0,2.3,2020-21,Playoffs
201565,Derrick Rose,1610612752,NYK,5,1,4,175.0,4,1,3,0.25,9,0.444,0,0.444,13.7,16,4,12,0.25,28,0.571,2,0.615,7.3,20,5,15,0.25,37,0.541,2,0.571,8.5,2020-21,Playoffs
1630217,Desmond Bane,1610612763,MEM,5,1,4,99.0,2,0,2,0.0,2,1.0,0,1.0,24.8,15,6,9,0.4,21,0.714,2,0.789,6.6,17,6,11,0.353,23,0.739,2,0.81,8.7,2020-21,Playoffs
1626164,Devin Booker,1610612756,PHX,22,14,8,888.0,15,8,7,0.533,46,0.326,0,0.326,10.5,109,19,90,0.174,172,0.634,16,0.699,8.1,124,27,97,0.218,217,0.571,16,0.617,8.4,2020-21,Playoffs
203473,Dewayne Dedmon,1610612748,MIA,4,0,4,57.0,8,7,1,0.875,16,0.5,0,0.5,4.1,10,3,7,0.3,20,0.5,0,0.5,4.3,18,10,8,0.556,36,0.5,0,0.5,4.2,2020-21,Playoffs
1628415,Dillon Brooks,1610612763,MEM,5,1,4,175.0,5,3,2,0.6,15,0.333,0,0.333,10.1,16,1,15,0.063,24,0.667,2,0.727,11.7,21,4,17,0.19,38,0.553,2,0.583,11.3,2020-21,Playoffs
1628378,Donovan Mitchell,1610612762,UTA,10,6,4,346.0,3,2,1,0.667,16,0.188,1,0.2,14.0,39,2,37,0.051,62,0.629,4,0.672,8.8,42,4,38,0.095,77,0.545,5,0.583,9.2,2020-21,Playoffs
1628978,Donte DiVincenzo,1610612749,MIL,3,3,0,70.0,2,1,1,0.5,8,0.25,0,0.25,7.5,17,2,15,0.118,24,0.708,2,0.773,4.4,19,3,16,0.158,32,0.594,2,0.633,4.7,2020-21,Playoffs
1627827,Dorian Finney-Smith,1610612742,DAL,7,3,4,271.0,17,12,5,0.706,38,0.447,0,0.447,5.1,29,5,24,0.172,45,0.644,1,0.659,6.7,46,17,29,0.37,81,0.568,1,0.575,6.1,2020-21,Playoffs
1629130,Duncan Robinson,1610612748,MIA,4,0,4,100.0,0,0,0,0.0,0,0.0,0,0.0,0.0,11,1,10,0.091,17,0.647,0,0.647,6.9,11,1,10,0.091,17,0.647,0,0.647,6.9,2020-21,Playoffs
2730,Dwight Howard,1610612755,PHI,12,7,5,149.0,26,20,6,0.769,64,0.406,1,0.413,3.1,49,17,32,0.347,82,0.598,7,0.653,3.2,75,37,38,0.493,139,0.54,8,0.573,3.2,2020-21,Playoffs
203939,Dwight Powell,1610612742,DAL,4,3,1,38.0,5,3,2,0.6,7,0.714,0,0.714,6.9,8,2,6,0.25,14,0.571,2,0.667,5.5,13,5,8,0.385,21,0.619,2,0.684,6.0,2020-21,Playoffs
202734,E'Twaun Moore,1610612756,PHX,6,5,1,36.0,0,0,0,0.0,4,0.0,1,0.0,0.0,10,2,8,0.2,11,0.909,0,0.909,10.1,10,2,8,0.2,13,0.769,1,0.833,10.1,2020-21,Playoffs
1629091,Elijah Bryant,1610612749,MIL,5,4,1,36.0,2,0,2,0.0,3,0.667,0,0.667,10.5,10,4,6,0.4,14,0.714,0,0.714,6.5,12,4,8,0.333,17,0.706,0,0.706,7.2,2020-21,Playoffs
202683,Enes Freedom,1610612757,POR,5,2,3,56.0,6,5,1,0.833,16,0.375,0,0.375,2.8,7,1,6,0.143,14,0.5,0,0.5,4.2,13,6,7,0.462,30,0.433,0,0.433,3.6,2020-21,Playoffs
203095,Evan Fournier,1610612738,BOS,4,1,3,139.0,5,2,3,0.4,11,0.455,0,0.455,12.5,13,1,12,0.077,22,0.591,4,0.722,9.0,18,3,15,0.167,33,0.545,4,0.621,10.0,2020-21,Playoffs
1630267,Facundo Campazzo,1610612743,DEN,9,4,5,248.0,7,3,4,0.429,13,0.538,1,0.583,15.0,23,0,23,0.0,37,0.622,4,0.697,10.2,30,3,27,0.1,50,0.6,5,0.667,11.3,2020-21,Playoffs
1626163,Frank Kaminsky,1610612756,PHX,5,3,2,48.0,2,0,2,0.0,8,0.25,0,0.25,5.2,12,5,7,0.417,17,0.706,1,0.75,4.1,14,5,9,0.357,24,0.583,1,0.609,4.3,2020-21,Playoffs
1627788,Furkan Korkmaz,1610612755,PHI,9,4,5,156.0,4,1,3,0.25,7,0.571,1,0.667,8.2,20,2,18,0.1,27,0.741,0,0.741,10.2,24,3,21,0.125,33,0.727,1,0.75,9.9,2020-21,Playoffs
1629216,Gabe Vincent,1610612748,MIA,1,0,1,6.0,0,0,0,0.0,0,0.0,0,0.0,0.0,1,0,1,0.0,2,0.5,0,0.5,1.4,1,0,1,0.0,2,0.5,0,0.5,1.4,2020-21,Playoffs
1629726,Garrison Mathews,1610612764,WAS,2,0,2,11.0,0,0,0,0.0,1,0.0,0,0.0,0.0,2,0,2,0.0,2,1.0,0,1.0,14.1,2,0,2,0.0,2,1.0,0,1.0,14.1,2020-21,Playoffs
201588,George Hill,1610612755,PHI,11,7,4,193.0,5,2,3,0.4,12,0.417,0,0.417,7.5,11,3,8,0.273,25,0.44,1,0.458,7.6,16,5,11,0.313,36,0.444,1,0.457,7.5,2020-21,Playoffs
1627777,Georges Niang,1610612762,UTA,8,3,5,92.0,2,1,1,0.5,7,0.286,0,0.286,12.7,17,2,15,0.118,22,0.773,1,0.81,7.0,19,3,16,0.158,29,0.655,1,0.679,7.7,2020-21,Playoffs
203507,Giannis Antetokounmpo,1610612749,MIL,21,14,7,800.0,59,34,25,0.576,112,0.527,5,0.551,7.2,210,43,166,0.205,288,0.729,20,0.784,4.8,269,77,191,0.286,386,0.697,25,0.745,5.3,2020-21,Playoffs
201609,Goran Dragic,1610612748,MIA,4,0,4,117.0,1,1,0,1.0,5,0.2,1,0.25,4.1,6,0,6,0.0,18,0.333,6,0.5,10.4,7,1,6,0.143,22,0.318,7,0.467,9.5,2020-21,Playoffs
1629684,Grant Williams,1610612738,BOS,4,1,3,56.0,3,2,1,0.667,11,0.273,1,0.3,6.6,7,5,2,0.714,12,0.583,1,0.636,4.2,10,7,3,0.7,23,0.435,2,0.476,4.9,2020-21,Playoffs
1628960,Grayson Allen,1610612763,MEM,5,1,4,116.0,3,0,3,0.0,6,0.5,0,0.5,18.0,10,4,6,0.4,20,0.5,2,0.556,6.6,13,4,9,0.308,25,0.52,2,0.565,9.3,2020-21,Playoffs
1628385,Harry Giles III,1610612757,POR,1,0,1,4.0,2,1,1,0.5,2,1.0,0,1.0,6.8,1,0,1,0.0,2,0.5,0,0.5,3.6,3,1,2,0.333,3,1.0,0,1.0,5.8,2020-21,Playoffs
1630193,Immanuel Quickley,1610612752,NYK,3,1,2,49.0,0,0,0,0.0,3,0.0,0,0.0,0.0,7,0,7,0.0,10,0.7,1,0.778,8.5,7,0,7,0.0,12,0.583,1,0.636,8.5,2020-21,Playoffs
202397,Ish Smith,1610612764,WAS,5,1,4,111.0,1,0,1,0.0,6,0.167,0,0.167,26.4,15,2,13,0.133,23,0.652,4,0.789,7.9,16,2,14,0.125,29,0.552,4,0.64,9.1,2020-21,Playoffs
1627826,Ivica Zubac,1610612746,LAC,14,7,7,279.0,43,37,6,0.86,97,0.443,3,0.457,4.3,56,19,37,0.339,92,0.609,8,0.667,5.1,99,56,43,0.566,186,0.532,11,0.566,4.7,2020-21,Playoffs
1629630,Ja Morant,1610612763,MEM,5,1,4,203.0,7,2,5,0.286,20,0.35,0,0.35,9.2,17,3,14,0.176,29,0.586,3,0.654,10.7,24,5,19,0.208,49,0.49,3,0.522,10.3,2020-21,Playoffs
203210,JaMychal Green,1610612743,DEN,10,4,6,190.0,17,12,5,0.706,51,0.333,3,0.354,3.5,35,12,23,0.343,52,0.673,0,0.673,4.6,52,24,28,0.462,102,0.51,3,0.525,4.2,2020-21,Playoffs
201580,JaVale McGee,1610612743,DEN,3,0,3,34.0,3,2,0,0.667,7,0.429,0,0.429,2.1,9,3,6,0.333,15,0.6,0,0.6,4.1,12,5,6,0.417,21,0.571,0,0.571,3.7,2020-21,Playoffs
203953,Jabari Parker,1610612738,BOS,4,0,4,59.0,2,1,1,0.5,6,0.333,0,0.333,3.1,13,2,11,0.154,19,0.684,0,0.684,5.0,15,3,12,0.2,24,0.625,0,0.625,4.7,2020-21,Playoffs
203109,Jae Crowder,1610612756,PHX,21,13,8,700.0,10,6,4,0.6,27,0.37,1,0.385,11.4,124,39,84,0.315,198,0.626,23,0.709,5.0,134,45,88,0.336,223,0.601,24,0.673,5.5,2020-21,Playoffs
1628973,Jalen Brunson,1610612742,DAL,6,2,4,104.0,6,2,4,0.333,10,0.6,0,0.6,13.2,12,1,11,0.083,24,0.5,2,0.545,8.7,18,3,15,0.167,34,0.529,2,0.563,10.2,2020-21,Playoffs
1630188,Jalen Smith,1610612756,PHX,3,2,1,12.0,2,2,0,1.0,5,0.4,0,0.4,3.1,3,2,1,0.667,4,0.75,1,1.0,12.4,5,4,1,0.8,9,0.556,1,0.625,8.7,2020-21,Playoffs
201935,James Harden,1610612751,BKN,9,6,3,322.0,7,1,6,0.143,17,0.412,0,0.412,15.5,50,10,40,0.2,83,0.602,6,0.649,7.2,57,11,46,0.193,98,0.582,6,0.62,8.2,2020-21,Playoffs
1628991,Jaren Jackson Jr.,1610612763,MEM,5,1,4,137.0,9,5,4,0.556,20,0.45,0,0.45,5.7,19,10,9,0.526,43,0.442,4,0.487,5.0,28,15,13,0.536,62,0.452,4,0.483,5.2,2020-21,Playoffs
1629714,Jarrell Brantley,1610612762,UTA,1,1,0,2.0,0,0,0,0.0,0,0.0,0,0.0,0.0,1,0,1,0.0,2,0.5,0,0.5,16.7,1,0,1,0.0,2,0.5,0,0.5,16.7,2020-21,Playoffs
1630206,Jay Scrubb,1610612746,LAC,1,1,0,0.0,0,0,0,0.0,0,0.0,0,0.0,0.0,1,0,1,0.0,1,1.0,0,1.0,17.0,1,0,1,0.0,1,1.0,0,1.0,17.0,2020-21,Playoffs
1628369,Jayson Tatum,1610612738,BOS,5,1,4,185.0,3,3,0,1.0,13,0.231,4,0.333,6.5,26,5,21,0.192,37,0.703,0,0.703,5.6,29,8,21,0.276,49,0.592,4,0.644,5.7,2020-21,Playoffs
201145,Jeff Green,1610612751,BKN,5,2,3,136.0,4,3,1,0.75,11,0.364,0,0.364,6.7,13,4,9,0.308,28,0.464,3,0.52,9.0,17,7,10,0.412,39,0.436,3,0.472,8.5,2020-21,Playoffs
201952,Jeff Teague,1610612749,MIL,7,4,3,68.0,2,1,1,0.5,2,1.0,0,1.0,12.5,6,0,6,0.0,11,0.545,1,0.6,8.8,8,1,7,0.125,12,0.667,1,0.727,9.7,2020-21,Playoffs
1628975,Jevon Carter,1610612756,PHX,2,2,0,10.0,0,0,0,0.0,0,0.0,0,0.0,0.0,2,0,2,0.0,3,0.667,1,1.0,12.7,2,0,2,0.0,3,0.667,1,1.0,12.7,2020-21,Playoffs
202710,Jimmy Butler,1610612748,MIA,4,0,4,154.0,6,4,2,0.667,13,0.462,1,0.5,2.8,24,6,18,0.25,40,0.6,3,0.649,6.8,30,10,20,0.333,53,0.566,4,0.612,6.0,2020-21,Playoffs
203925,Joe Harris,1610612751,BKN,12,7,5,434.0,5,2,3,0.4,18,0.278,1,0.294,10.4,38,12,26,0.316,71,0.535,8,0.603,7.5,43,14,29,0.326,86,0.5,9,0.558,7.8,2020-21,Playoffs
204060,Joe Ingles,1610612762,UTA,9,5,4,265.0,1,0,1,0.0,7,0.143,0,0.143,7.7,33,0,33,0.0,47,0.702,2,0.733,10.0,34,0,34,0.0,53,0.642,2,0.667,9.9,2020-21,Playoffs
203954,Joel Embiid,1610612755,PHI,11,6,5,357.0,16,11,5,0.688,40,0.4,0,0.4,6.2,100,48,52,0.48,173,0.578,21,0.658,4.4,116,59,57,0.509,206,0.563,21,0.627,4.7,2020-21,Playoffs
1628381,John Collins,1610612737,ATL,18,10,8,576.0,36,20,16,0.556,104,0.346,1,0.35,7.4,121,32,89,0.264,212,0.571,24,0.644,5.0,157,52,105,0.331,301,0.522,25,0.569,5.5,2020-21,Playoffs
1629723,John Konchar,1610612763,MEM,1,0,1,3.0,0,0,0,0.0,0,0.0,0,0.0,0.0,1,0,1,0.0,2,0.5,0,0.5,12.0,1,0,1,0.0,2,0.5,0,0.5,12.0,2020-21,Playoffs
202685,Jonas Valanciunas,1610612763,MEM,5,1,4,166.0,20,15,5,0.75,46,0.435,1,0.444,3.5,29,9,20,0.31,64,0.453,8,0.518,3.7,49,24,25,0.49,109,0.45,9,0.49,3.6,2020-21,Playoffs
203903,Jordan Clarkson,1610612762,UTA,10,5,5,276.0,6,3,3,0.5,22,0.273,2,0.3,9.3,28,1,27,0.036,42,0.667,1,0.683,9.0,34,4,30,0.118,63,0.54,3,0.567,9.0,2020-21,Playoffs
1629670,Jordan Nwora,1610612749,MIL,3,3,0,22.0,5,2,3,0.4,8,0.625,1,0.714,10.6,4,1,3,0.25,5,0.8,0,0.8,8.9,9,3,6,0.333,12,0.75,1,0.818,9.8,2020-21,Playoffs
1626196,Josh Richardson,1610612742,DAL,6,3,3,88.0,3,2,1,0.667,7,0.429,0,0.429,7.2,8,3,5,0.375,13,0.615,2,0.727,7.8,11,5,6,0.455,19,0.579,2,0.647,7.6,2020-21,Playoffs
201950,Jrue Holiday,1610612749,MIL,23,16,7,912.0,32,17,15,0.531,93,0.344,3,0.356,10.1,100,17,83,0.17,149,0.671,11,0.725,8.2,132,34,98,0.258,236,0.559,14,0.595,8.7,2020-21,Playoffs
203944,Julius Randle,1610612752,NYK,5,1,4,180.0,11,4,7,0.364,22,0.5,1,0.524,11.3,47,14,33,0.298,60,0.783,2,0.81,6.8,58,18,40,0.31,81,0.716,3,0.744,7.7,2020-21,Playoffs
1628382,Justin Jackson,1610612749,MIL,2,1,1,8.0,1,1,0,1.0,1,1.0,0,1.0,7.6,1,0,1,0.0,1,1.0,0,1.0,14.2,2,1,1,0.5,2,1.0,0,1.0,10.9,2020-21,Playoffs
1626159,Justise Winslow,1610612763,MEM,1,0,1,3.0,0,0,0,0.0,1,0.0,0,0.0,0.0,1,0,1,0.0,1,1.0,0,1.0,7.4,1,0,1,0.0,2,0.5,0,0.5,7.4,2020-21,Playoffs
203994,Jusuf Nurkic,1610612757,POR,6,2,4,173.0,18,9,8,0.5,43,0.419,2,0.439,5.9,44,10,34,0.227,65,0.677,7,0.759,3.9,62,19,42,0.306,105,0.59,9,0.646,4.5,2020-21,Playoffs
1629752,Juwan Morgan,1610612762,UTA,1,1,0,2.0,1,1,0,1.0,1,1.0,0,1.0,2.1,1,0,1,0.0,1,1.0,0,1.0,3.1,2,1,1,0.5,2,1.0,0,1.0,2.6,2020-21,Playoffs
202695,Kawhi Leonard,1610612746,LAC,11,6,5,432.0,22,16,6,0.727,43,0.512,1,0.524,5.7,63,12,51,0.19,103,0.612,8,0.663,6.0,85,28,57,0.329,139,0.612,9,0.654,5.9,2020-21,Playoffs
202689,Kemba Walker,1610612760,OKC,3,1,2,91.0,0,0,0,0.0,4,0.0,1,0.0,0.0,12,3,9,0.25,24,0.5,2,0.545,6.9,12,3,9,0.25,28,0.429,3,0.48,6.9,2020-21,Playoffs
1629134,Kendrick Nunn,1610612748,MIA,3,0,3,68.0,0,0,0,0.0,1,0.0,0,0.0,0.0,6,2,4,0.333,10,0.6,0,0.6,12.4,6,2,4,0.333,11,0.545,0,0.545,12.4,2020-21,Playoffs
203484,Kentavious Caldwell-Pope,1610612747,LAL,5,2,3,146.0,2,0,2,0.0,2,1.0,0,1.0,4.0,12,3,9,0.25,20,0.6,2,0.667,10.5,14,3,11,0.214,22,0.636,2,0.7,9.6,2020-21,Playoffs
201142,Kevin Durant,1610612751,BKN,12,7,5,485.0,5,2,3,0.4,26,0.192,0,0.192,12.7,106,39,68,0.368,165,0.642,18,0.721,5.2,111,41,71,0.369,183,0.607,18,0.673,5.5,2020-21,Playoffs
1628989,Kevin Huerter,1610612737,ATL,17,10,7,535.0,11,4,7,0.364,25,0.44,0,0.44,13.1,58,12,46,0.207,89,0.652,6,0.699,8.8,69,16,53,0.232,108,0.639,6,0.676,9.5,2020-21,Playoffs
1628995,Kevin Knox II,1610612752,NYK,1,0,1,4.0,0,0,0,0.0,0,0.0,0,0.0,0.0,1,0,1,0.0,2,0.5,0,0.5,10.6,1,0,1,0.0,2,0.5,0,0.5,10.6,2020-21,Playoffs
203114,Khris Middleton,1610612749,MIL,23,16,7,922.0,25,11,14,0.44,62,0.403,3,0.424,14.6,149,26,123,0.174,212,0.703,17,0.764,6.3,174,37,137,0.213,270,0.644,20,0.696,7.5,2020-21,Playoffs
1627739,Kris Dunn,1610612737,ATL,4,2,2,32.0,0,0,0,0.0,0,0.0,0,0.0,0.0,5,1,4,0.2,10,0.5,0,0.5,7.7,5,1,4,0.2,10,0.5,0,0.5,7.7,2020-21,Playoffs
204001,Kristaps Porzingis,1610612742,DAL,7,3,4,233.0,7,2,5,0.286,20,0.35,0,0.35,11.4,31,4,27,0.129,48,0.646,3,0.689,5.0,38,6,32,0.158,66,0.576,3,0.603,6.2,2020-21,Playoffs
203937,Kyle Anderson,1610612763,MEM,4,1,3,123.0,4,3,1,0.75,11,0.364,0,0.364,4.4,21,2,19,0.095,26,0.808,2,0.875,6.2,25,5,20,0.2,32,0.781,2,0.833,5.9,2020-21,Playoffs
1628398,Kyle Kuzma,1610612747,LAL,6,2,4,129.0,4,3,1,0.75,15,0.267,1,0.286,5.3,19,5,14,0.263,27,0.704,1,0.731,5.5,23,8,15,0.348,41,0.561,2,0.59,5.5,2020-21,Playoffs
202681,Kyrie Irving,1610612751,BKN,9,6,3,325.0,12,9,3,0.75,26,0.462,1,0.48,4.3,40,11,29,0.275,63,0.635,5,0.69,8.4,52,20,32,0.385,88,0.591,6,0.634,7.5,2020-21,Playoffs
1629013,Landry Shamet,1610612751,BKN,9,6,3,153.0,3,1,2,0.333,13,0.231,1,0.25,11.0,18,1,17,0.056,29,0.621,3,0.692,10.5,21,2,19,0.095,39,0.538,4,0.6,10.5,2020-21,Playoffs
204038,Langston Galloway,1610612756,PHX,2,2,0,15.0,0,0,0,0.0,0,0.0,0,0.0,0.0,2,1,1,0.5,2,1.0,0,1.0,11.0,2,1,1,0.5,2,1.0,0,1.0,11.0,2020-21,Playoffs
2544,LeBron James,1610612747,LAL,6,2,4,224.0,7,4,3,0.571,16,0.438,0,0.438,10.7,36,9,27,0.25,55,0.655,2,0.679,7.7,43,13,30,0.302,67,0.642,2,0.662,8.2,2020-21,Playoffs
101150,Lou Williams,1610612737,ATL,13,6,7,218.0,2,2,0,1.0,9,0.222,0,0.222,6.3,24,3,21,0.125,39,0.615,1,0.632,9.0,26,5,21,0.192,45,0.578,1,0.591,8.8,2020-21,Playoffs
1629029,Luka Doncic,1610612742,DAL,7,3,4,281.0,4,0,4,0.0,13,0.308,0,0.308,5.5,51,3,48,0.059,77,0.662,7,0.729,6.1,55,3,52,0.055,88,0.625,7,0.679,6.1,2020-21,Playoffs
1628379,Luke Kennard,1610612746,LAC,10,7,3,168.0,5,1,4,0.2,6,0.833,0,0.833,20.5,9,2,7,0.222,24,0.375,3,0.429,7.2,14,3,11,0.214,30,0.467,3,0.519,12.0,2020-21,Playoffs
1628436,Luke Kornet,1610612738,BOS,2,0,2,5.0,0,0,0,0.0,0,0.0,0,0.0,0.0,3,1,2,0.333,4,0.75,0,0.75,6.5,3,1,2,0.333,4,0.75,0,0.75,6.5,2020-21,Playoffs
1629603,Mamadi Diakite,1610612749,MIL,4,3,1,25.0,1,1,0,1.0,8,0.125,1,0.143,1.6,6,3,3,0.5,10,0.6,0,0.6,3.6,7,4,3,0.571,18,0.389,1,0.412,3.3,2020-21,Playoffs
201188,Marc Gasol,1610612747,LAL,5,2,3,87.0,4,3,1,0.75,9,0.444,0,0.444,4.2,15,4,11,0.267,23,0.652,3,0.75,4.4,19,7,12,0.368,32,0.594,3,0.655,4.4,2020-21,Playoffs
202694,Marcus Morris Sr.,1610612746,LAC,18,10,8,582.0,13,4,9,0.308,24,0.542,1,0.565,15.7,68,15,53,0.221,134,0.507,14,0.567,6.9,81,19,62,0.235,158,0.513,15,0.566,8.3,2020-21,Playoffs
203935,Marcus Smart,1610612738,BOS,5,1,4,183.0,4,2,2,0.5,13,0.308,0,0.308,9.0,18,3,15,0.167,31,0.581,4,0.667,7.8,22,5,17,0.227,44,0.5,4,0.55,8.0,2020-21,Playoffs
202693,Markieff Morris,1610612747,LAL,4,1,3,38.0,4,3,1,0.75,8,0.5,0,0.5,3.6,0,0,0,0.0,4,0.0,1,0.0,0.0,4,3,1,0.75,12,0.333,1,0.364,3.6,2020-21,Playoffs
1630210,Markus Howard,1610612743,DEN,4,2,2,72.0,1,0,1,0.0,3,0.333,0,0.333,15.5,6,1,5,0.167,9,0.667,1,0.75,9.5,7,1,6,0.143,12,0.583,1,0.636,10.3,2020-21,Playoffs
1629680,Matisse Thybulle,1610612755,PHI,8,4,4,148.0,4,1,3,0.25,13,0.308,0,0.308,16.7,13,1,12,0.077,20,0.65,3,0.765,9.9,17,2,15,0.118,28,0.607,3,0.68,11.5,2020-21,Playoffs
1629744,Matt Thomas,1610612762,UTA,1,0,1,3.0,0,0,0,0.0,1,0.0,0,0.0,0.0,1,0,1,0.0,1,1.0,0,1.0,16.3,1,0,1,0.0,2,0.5,0,0.5,16.3,2020-21,Playoffs
1628467,Maxi Kleber,1610612742,DAL,6,3,3,178.0,5,1,4,0.2,16,0.313,1,0.333,12.0,20,6,14,0.3,34,0.588,4,0.667,4.7,25,7,18,0.28,47,0.532,5,0.595,6.1,2020-21,Playoffs
1629008,Michael Porter Jr.,1610612743,DEN,10,4,6,332.0,12,8,4,0.667,40,0.3,0,0.3,4.6,50,8,42,0.16,78,0.641,6,0.694,4.9,62,16,46,0.258,115,0.539,6,0.569,4.9,2020-21,Playoffs
1628969,Mikal Bridges,1610612756,PHX,22,14,8,707.0,20,12,8,0.6,40,0.5,1,0.513,9.7,74,13,61,0.176,132,0.561,13,0.622,6.1,94,25,69,0.266,168,0.56,14,0.61,6.9,2020-21,Playoffs
201144,Mike Conley,1610612762,UTA,5,3,2,164.0,3,0,3,0.0,6,0.5,0,0.5,17.8,18,4,14,0.222,28,0.643,2,0.692,8.5,21,4,17,0.19,34,0.618,2,0.656,9.8,2020-21,Playoffs
1628455,Mike James,1610612751,BKN,6,4,2,97.0,2,2,0,1.0,5,0.4,0,0.4,11.8,14,4,10,0.286,23,0.609,2,0.667,6.7,16,6,10,0.375,28,0.571,2,0.615,7.4,2020-21,Playoffs
203118,Mike Scott,1610612755,PHI,2,1,1,23.0,1,1,0,1.0,2,0.5,0,0.5,3.1,2,0,2,0.0,4,0.5,0,0.5,5.8,3,1,2,0.333,6,0.5,0,0.5,4.9,2020-21,Playoffs
1629671,Miye Oni,1610612762,UTA,2,2,0,13.0,3,1,2,0.333,4,0.75,0,0.75,16.0,0,0,0,0.0,3,0.0,0,0.0,0.0,3,1,2,0.333,6,0.5,0,0.5,16.0,2020-21,Playoffs
1628420,Monte Morris,1610612743,DEN,8,4,4,222.0,7,2,5,0.286,11,0.636,0,0.636,13.9,17,4,13,0.235,33,0.515,2,0.548,10.6,24,6,18,0.25,44,0.545,2,0.571,11.6,2020-21,Playoffs
1626149,Montrezl Harrell,1610612747,LAL,4,0,4,39.0,5,3,2,0.6,10,0.5,0,0.5,3.0,5,1,4,0.2,8,0.625,0,0.625,4.9,10,4,6,0.4,17,0.588,0,0.588,3.9,2020-21,Playoffs
1629642,Nassir Little,1610612757,POR,1,1,0,5.0,0,0,0,0.0,0,0.0,0,0.0,0.0,1,0,1,0.0,2,0.5,0,0.5,2.1,1,0,1,0.0,2,0.5,0,0.5,2.1,2020-21,Playoffs
1630233,Nathan Knight,1610612737,ATL,4,2,2,12.0,0,0,0,0.0,3,0.0,0,0.0,0.0,6,0,6,0.0,9,0.667,0,0.667,7.2,6,0,6,0.0,11,0.545,0,0.545,7.2,2020-21,Playoffs
202357,Nemanja Bjelica,1610612748,MIA,2,0,2,30.0,1,1,0,1.0,3,0.333,0,0.333,3.1,4,1,3,0.25,8,0.5,0,0.5,5.7,5,2,3,0.4,11,0.455,0,0.455,5.2,2020-21,Playoffs
203457,Nerlens Noel,1610612752,NYK,5,1,4,92.0,10,8,2,0.8,27,0.37,0,0.37,3.3,10,4,6,0.4,32,0.313,4,0.357,5.0,20,12,8,0.6,59,0.339,4,0.364,4.2,2020-21,Playoffs
1629651,Nic Claxton,1610612751,BKN,9,6,3,125.0,14,11,3,0.786,28,0.5,1,0.519,6.1,19,6,13,0.316,33,0.576,2,0.613,4.9,33,17,16,0.515,60,0.55,3,0.579,5.4,2020-21,Playoffs
201587,Nicolas Batum,1610612746,LAC,18,9,9,540.0,19,6,13,0.316,43,0.442,3,0.475,11.8,86,16,69,0.186,133,0.647,13,0.717,6.6,105,22,82,0.21,169,0.621,16,0.686,7.5,2020-21,Playoffs
1629740,Nicolo Melli,1610612742,DAL,2,1,1,13.0,2,2,0,1.0,5,0.4,1,0.5,7.0,4,0,4,0.0,5,0.8,0,0.8,8.7,6,2,4,0.333,10,0.6,1,0.667,8.2,2020-21,Playoffs
203999,Nikola Jokic,1610612743,DEN,10,4,6,345.0,37,25,12,0.676,64,0.578,1,0.587,4.6,79,29,50,0.367,128,0.617,14,0.693,4.2,116,54,62,0.466,188,0.617,15,0.671,4.4,2020-21,Playoffs
1626181,Norman Powell,1610612757,POR,4,2,2,139.0,3,2,1,0.667,11,0.273,0,0.273,8.6,10,1,9,0.1,16,0.625,0,0.625,8.0,13,3,10,0.231,25,0.52,0,0.52,8.2,2020-21,Playoffs
1630167,Obi Toppin,1610612752,NYK,5,1,4,65.0,4,2,2,0.5,8,0.5,1,0.571,14.7,9,0,9,0.0,15,0.6,2,0.692,3.5,13,2,11,0.154,22,0.591,3,0.684,6.9,2020-21,Playoffs
1630168,Onyeka Okongwu,1610612737,ATL,17,9,8,163.0,21,14,7,0.667,48,0.438,0,0.438,6.3,27,11,16,0.407,53,0.509,5,0.563,5.3,48,25,23,0.521,96,0.5,5,0.527,5.7,2020-21,Playoffs
200782,P.J. Tucker,1610612749,MIL,23,16,7,681.0,48,34,14,0.708,118,0.407,2,0.414,6.4,63,15,48,0.238,120,0.525,9,0.568,7.2,111,49,62,0.441,233,0.476,11,0.5,6.8,2020-21,Playoffs
1626192,Pat Connaughton,1610612749,MIL,23,16,7,546.0,29,18,11,0.621,51,0.569,1,0.58,8.8,72,16,56,0.222,136,0.529,19,0.615,5.5,101,34,67,0.337,183,0.552,20,0.62,6.5,2020-21,Playoffs
201976,Patrick Beverley,1610612746,LAC,15,8,7,299.0,11,6,5,0.545,22,0.5,0,0.5,13.9,30,8,22,0.267,56,0.536,8,0.625,10.2,41,14,27,0.341,76,0.539,8,0.603,11.2,2020-21,Playoffs
202331,Paul George,1610612746,LAC,19,10,9,776.0,17,8,9,0.471,59,0.288,2,0.298,12.0,166,33,133,0.199,264,0.629,20,0.68,5.3,183,41,142,0.224,310,0.59,22,0.635,5.9,2020-21,Playoffs
200794,Paul Millsap,1610612743,DEN,9,4,5,109.0,9,5,4,0.556,21,0.429,0,0.429,6.3,26,9,17,0.346,35,0.743,2,0.788,4.5,35,14,21,0.4,55,0.636,2,0.66,4.9,2020-21,Playoffs
1630194,Paul Reed,1610612755,PHI,2,2,0,9.0,3,2,1,0.667,5,0.6,0,0.6,8.2,5,3,2,0.6,8,0.625,0,0.625,3.8,8,5,3,0.625,13,0.615,0,0.615,5.5,2020-21,Playoffs
1630202,Payton Pritchard,1610612738,BOS,3,0,3,55.0,2,1,2,0.5,6,0.333,0,0.333,19.2,7,2,5,0.286,11,0.636,0,0.636,8.4,9,3,7,0.333,17,0.529,0,0.529,11.7,2020-21,Playoffs
1630173,Precious Achiuwa,1610612748,MIA,3,0,3,12.0,0,0,0,0.0,3,0.0,0,0.0,0.0,6,2,4,0.333,6,1.0,0,1.0,4.4,6,2,4,0.333,9,0.667,0,0.667,4.4,2020-21,Playoffs
1629628,RJ Barrett,1610612752,NYK,5,1,4,162.0,4,2,2,0.5,8,0.5,0,0.5,9.8,32,3,29,0.094,41,0.78,3,0.842,6.5,36,5,31,0.139,48,0.75,3,0.8,6.8,2020-21,Playoffs
200765,Rajon Rondo,1610612746,LAC,10,4,6,193.0,4,1,3,0.25,16,0.25,0,0.25,11.6,30,5,25,0.167,38,0.789,1,0.811,8.7,34,6,28,0.176,52,0.654,1,0.667,9.1,2020-21,Playoffs
203526,Raul Neto,1610612764,WAS,4,1,3,83.0,3,0,3,0.0,6,0.5,0,0.5,28.1,8,1,7,0.125,19,0.421,0,0.421,9.9,11,1,10,0.091,23,0.478,0,0.478,14.9,2020-21,Playoffs
203493,Reggie Bullock Jr.,1610612752,NYK,5,1,4,162.0,5,2,3,0.4,8,0.625,0,0.625,4.0,12,4,8,0.333,21,0.571,2,0.632,9.2,17,6,11,0.353,29,0.586,2,0.63,7.6,2020-21,Playoffs
202704,Reggie Jackson,1610612746,LAC,18,10,8,605.0,7,2,5,0.286,25,0.28,0,0.28,19.9,53,10,43,0.189,102,0.52,11,0.582,9.0,60,12,48,0.2,125,0.48,11,0.526,10.3,2020-21,Playoffs
1629617,Reggie Perry,1610612751,BKN,4,2,2,21.0,4,3,1,0.75,6,0.667,0,0.667,9.5,2,0,2,0.0,6,0.333,0,0.333,3.9,6,3,3,0.5,12,0.5,0,0.5,7.6,2020-21,Playoffs
203496,Robert Covington,1610612757,POR,6,2,4,228.0,9,3,6,0.333,21,0.429,0,0.429,10.6,38,6,32,0.158,69,0.551,6,0.603,4.2,47,9,38,0.191,84,0.56,6,0.603,5.5,2020-21,Playoffs
1629057,Robert Williams III,1610612738,BOS,2,0,2,39.0,8,5,3,0.625,12,0.667,0,0.667,6.9,7,2,5,0.286,11,0.636,1,0.7,7.3,15,7,8,0.467,22,0.682,1,0.714,7.1,2020-21,Playoffs
201577,Robin Lopez,1610612764,WAS,3,1,2,48.0,4,2,2,0.5,7,0.571,1,0.667,2.8,5,1,4,0.2,15,0.333,1,0.357,17.0,9,3,6,0.333,20,0.45,2,0.5,10.7,2020-21,Playoffs
1629641,Romeo Langford,1610612738,BOS,4,1,3,109.0,5,3,2,0.6,8,0.625,0,0.625,12.2,5,1,4,0.2,12,0.417,5,0.714,8.3,10,4,6,0.4,20,0.5,5,0.667,10.2,2020-21,Playoffs
1626178,Rondae Hollis-Jefferson,1610612757,POR,4,1,3,31.0,3,2,1,0.667,7,0.429,0,0.429,2.9,5,0,5,0.0,8,0.625,1,0.714,7.7,8,2,6,0.25,15,0.533,1,0.571,5.9,2020-21,Playoffs
1626220,Royce O'Neale,1610612762,UTA,11,6,5,404.0,16,8,8,0.5,43,0.372,0,0.372,8.2,64,12,52,0.188,102,0.627,10,0.696,4.9,80,20,60,0.25,140,0.571,10,0.615,5.5,2020-21,Playoffs
203497,Rudy Gobert,1610612762,UTA,11,6,5,376.0,43,32,11,0.744,107,0.402,2,0.41,4.5,92,21,71,0.228,155,0.594,18,0.672,4.1,135,53,82,0.393,255,0.529,20,0.574,4.2,2020-21,Playoffs
1629060,Rui Hachimura,1610612764,WAS,5,1,4,173.0,5,1,4,0.2,16,0.313,1,0.333,8.9,31,3,28,0.097,42,0.738,2,0.775,6.1,36,4,32,0.111,53,0.679,3,0.72,6.5,2020-21,Playoffs
201566,Russell Westbrook,1610612764,WAS,5,1,4,186.0,14,12,2,0.857,33,0.424,0,0.424,3.4,38,2,36,0.053,52,0.731,2,0.76,7.1,52,14,38,0.269,77,0.675,2,0.693,6.1,2020-21,Playoffs
1630241,Sam Merrill,1610612749,MIL,3,2,1,16.0,1,1,0,1.0,3,0.333,0,0.333,2.5,4,1,3,0.25,6,0.667,0,0.667,9.5,5,2,3,0.4,8,0.625,0,0.625,8.1,2020-21,Playoffs
201586,Serge Ibaka,1610612746,LAC,1,0,1,13.0,1,1,0,1.0,1,1.0,0,1.0,1.2,3,1,2,0.333,8,0.375,1,0.429,4.8,4,2,2,0.5,9,0.444,1,0.5,3.9,2020-21,Playoffs
203552,Seth Curry,1610612755,PHI,8,3,5,271.0,4,0,4,0.0,8,0.5,1,0.571,23.4,24,2,22,0.083,35,0.686,0,0.686,8.8,28,2,26,0.071,42,0.667,1,0.683,10.9,2020-21,Playoffs
1629003,Shake Milton,1610612755,PHI,5,3,2,63.0,0,0,0,0.0,3,0.0,0,0.0,0.0,9,2,7,0.222,12,0.75,1,0.818,10.1,9,2,7,0.222,14,0.643,1,0.692,10.1,2020-21,Playoffs
1627885,Shaquille Harrison,1610612743,DEN,5,2,3,32.0,0,0,0,0.0,3,0.0,0,0.0,0.0,8,2,6,0.25,13,0.615,1,0.667,6.7,8,2,6,0.25,16,0.5,1,0.533,6.7,2020-21,Playoffs
1630219,Skylar Mays,1610612737,ATL,2,1,1,10.0,0,0,0,0.0,0,0.0,0,0.0,0.0,2,0,2,0.0,2,1.0,0,1.0,4.7,2,0,2,0.0,2,1.0,0,1.0,4.7,2020-21,Playoffs
203524,Solomon Hill,1610612737,ATL,10,5,5,126.0,3,2,1,0.667,13,0.231,0,0.231,4.2,16,3,13,0.188,32,0.5,4,0.571,7.7,19,5,14,0.263,44,0.432,4,0.475,7.2,2020-21,Playoffs
1628388,T.J. Leaf,1610612757,POR,2,1,1,7.0,2,1,1,0.5,2,1.0,0,1.0,2.7,1,1,0,1.0,2,0.5,0,0.5,2.6,3,2,1,0.667,4,0.75,0,0.75,2.7,2020-21,Playoffs
1629605,Tacko Fall,1610612738,BOS,1,0,1,1.0,0,0,0,0.0,1,0.0,0,0.0,0.0,1,0,1,0.0,1,1.0,0,1.0,3.0,1,0,1,0.0,1,1.0,0,1.0,3.0,2020-21,Playoffs
201959,Taj Gibson,1610612752,NYK,5,1,4,138.0,16,11,5,0.688,36,0.444,3,0.485,4.7,19,8,11,0.421,41,0.463,6,0.543,5.0,35,19,16,0.543,75,0.467,9,0.53,4.9,2020-21,Playoffs
1629659,Talen Horton-Tucker,1610612747,LAL,3,0,3,43.0,2,1,1,0.5,6,0.333,1,0.4,4.7,12,2,9,0.167,15,0.8,0,0.8,7.2,14,3,10,0.214,19,0.737,1,0.778,6.8,2020-21,Playoffs
1629611,Terance Mann,1610612746,LAC,16,9,7,365.0,17,11,6,0.647,30,0.567,1,0.586,5.6,35,7,28,0.2,72,0.486,10,0.565,5.2,52,18,34,0.346,102,0.51,11,0.571,5.3,2020-21,Playoffs
203648,Thanasis Antetokounmpo,1610612749,MIL,6,4,2,25.0,3,1,2,0.333,9,0.333,0,0.333,14.7,7,1,6,0.143,9,0.778,1,0.875,6.4,10,2,8,0.2,17,0.588,1,0.625,8.9,2020-21,Playoffs
203501,Tim Hardaway Jr.,1610612742,DAL,7,3,4,262.0,5,3,2,0.6,18,0.278,0,0.278,13.7,18,3,15,0.167,43,0.419,7,0.5,7.0,23,6,17,0.261,60,0.383,7,0.434,8.5,2020-21,Playoffs
1627789,Timothe Luwawu-Cabarrot,1610612751,BKN,3,2,1,17.0,0,0,0,0.0,0,0.0,0,0.0,0.0,3,2,1,0.667,4,0.75,0,0.75,5.7,3,2,1,0.667,4,0.75,0,0.75,5.7,2020-21,Playoffs
202699,Tobias Harris,1610612755,PHI,12,7,5,438.0,10,8,2,0.8,45,0.222,0,0.222,5.8,92,16,76,0.174,137,0.672,9,0.719,5.8,102,24,78,0.235,172,0.593,9,0.626,5.8,2020-21,Playoffs
203503,Tony Snell,1610612737,ATL,3,1,2,37.0,0,0,0,0.0,1,0.0,0,0.0,0.0,5,1,4,0.2,8,0.625,0,0.625,4.7,5,1,4,0.2,9,0.556,0,0.556,4.7,2020-21,Playoffs
1628470,Torrey Craig,1610612756,PHX,15,9,6,213.0,19,16,3,0.842,42,0.452,1,0.463,5.4,44,6,38,0.136,65,0.677,7,0.759,5.1,63,22,41,0.349,101,0.624,8,0.677,5.2,2020-21,Playoffs
1629027,Trae Young,1610612737,ATL,14,9,5,527.0,7,6,1,0.857,38,0.184,2,0.194,4.9,38,3,35,0.079,73,0.521,5,0.559,11.7,45,9,36,0.2,109,0.413,7,0.441,10.6,2020-21,Playoffs
2772,Trevor Ariza,1610612748,MIA,3,0,3,76.0,2,1,1,0.5,9,0.222,0,0.222,14.8,21,5,16,0.238,33,0.636,4,0.724,5.0,23,6,17,0.261,37,0.622,4,0.697,5.9,2020-21,Playoffs
203504,Trey Burke,1610612742,DAL,1,0,1,9.0,1,0,1,0.0,1,1.0,0,1.0,10.6,0,0,0,0.0,1,0.0,1,0.0,0.0,1,0,1,0.0,2,0.5,1,1.0,10.6,2020-21,Playoffs
202684,Tristan Thompson,1610612738,BOS,5,1,4,132.0,29,21,8,0.724,53,0.547,0,0.547,3.4,20,2,18,0.1,28,0.714,2,0.769,6.1,49,23,26,0.469,81,0.605,2,0.62,4.5,2020-21,Playoffs
1629639,Tyler Herro,1610612748,MIA,4,0,4,93.0,1,0,1,0.0,2,0.5,0,0.5,17.0,12,1,11,0.083,19,0.632,1,0.667,9.3,13,1,12,0.077,20,0.65,1,0.684,9.9,2020-21,Playoffs
204020,Tyler Johnson,1610612751,BKN,2,1,1,16.0,2,0,2,0.0,2,1.0,0,1.0,21.1,4,0,4,0.0,4,1.0,0,1.0,9.5,6,0,6,0.0,6,1.0,0,1.0,13.4,2020-21,Playoffs
1630178,Tyrese Maxey,1610612755,PHI,9,5,4,143.0,1,0,1,0.0,4,0.25,1,0.333,34.5,21,6,15,0.286,32,0.656,4,0.75,7.8,22,6,16,0.273,36,0.611,5,0.71,9.0,2020-21,Playoffs
1626145,Tyus Jones,1610612763,MEM,4,1,3,38.0,1,0,1,0.0,2,0.5,0,0.5,3.4,6,1,5,0.167,8,0.75,1,0.857,10.6,7,1,6,0.143,10,0.7,1,0.778,9.6,2020-21,Playoffs
1628962,Udoka Azubuike,1610612762,UTA,1,0,1,1.0,0,0,0,0.0,0,0.0,0,0.0,0.0,1,1,0,1.0,1,1.0,0,1.0,3.0,1,1,0,1.0,1,1.0,0,1.0,3.0,2020-21,Playoffs
1628427,Vlatko Cancar,1610612743,DEN,3,0,3,16.0,0,0,0,0.0,0,0.0,0,0.0,0.0,3,0,3,0.0,3,1.0,0,1.0,7.5,3,0,3,0.0,3,1.0,0,1.0,7.5,2020-21,Playoffs
202083,Wesley Matthews,1610612747,LAL,4,1,3,80.0,5,4,1,0.8,7,0.714,0,0.714,6.3,5,1,4,0.2,9,0.556,1,0.625,11.4,10,5,5,0.5,16,0.625,1,0.667,8.9,2020-21,Playoffs
203115,Will Barton,1610612743,DEN,3,0,3,83.0,1,0,1,0.0,3,0.333,0,0.333,7.5,12,3,9,0.25,23,0.522,4,0.632,6.7,13,3,10,0.231,26,0.5,4,0.591,6.7,2020-21,Playoffs
1626161,Willie Cauley-Stein,1610612742,DAL,4,2,2,53.0,3,3,0,1.0,8,0.375,0,0.375,3.2,13,3,10,0.231,20,0.65,3,0.765,5.6,16,6,10,0.375,28,0.571,3,0.64,5.1,2020-21,Playoffs
1630214,Xavier Tillman,1610612763,MEM,2,1,1,11.0,1,1,0,1.0,4,0.25,0,0.25,2.1,2,1,1,0.5,5,0.4,0,0.4,4.0,3,2,1,0.667,9,0.333,0,0.333,3.3,2020-21,Playoffs
1627812,Yogi Ferrell,1610612746,LAC,3,3,0,7.0,0,0,0,0.0,1,0.0,0,0.0,0.0,3,1,2,0.333,3,1.0,0,1.0,7.7,3,1,2,0.333,4,0.75,0,0.75,7.7,2020-21,Playoffs
1630192,Zeke Nnaji,1610612743,DEN,1,0,1,5.0,1,0,1,0.0,1,1.0,0,1.0,25.1,1,0,1,0.0,2,0.5,1,1.0,3.6,2,0,2,0.0,3,0.667,1,1.0,14.4,2020-21,Playoffs
203932,Aaron Gordon,1610612743,DEN,74,45,29,2348.0,125,80,42,0.64,211,0.592,7,0.613,7.3,314,79,235,0.252,437,0.719,20,0.753,6.2,439,159,277,0.362,632,0.695,27,0.726,6.5,2021-22,Regular%20Season
1630565,Aaron Henry,1610612755,PHI,1,1,0,5.0,0,0,0,0.0,0,0.0,0,0.0,0.0,1,0,1,0.0,1,1.0,0,1.0,9.3,1,0,1,0.0,1,1.0,0,1.0,9.3,2021-22,Regular%20Season
1628988,Aaron Holiday,1610612756,PHX,49,27,22,853.0,24,6,18,0.25,59,0.407,3,0.429,15.6,98,7,91,0.071,132,0.742,8,0.79,9.2,122,13,109,0.107,189,0.646,11,0.685,10.5,2021-22,Regular%20Season
1630174,Aaron Nesmith,1610612738,BOS,32,19,13,440.0,15,4,11,0.267,40,0.375,2,0.395,10.1,74,15,59,0.203,130,0.569,16,0.649,5.3,89,19,70,0.213,165,0.539,18,0.605,6.2,2021-22,Regular%20Season
1630598,Aaron Wiggins,1610612760,OKC,47,12,35,1180.0,51,24,27,0.471,122,0.418,7,0.443,7.1,127,29,98,0.228,218,0.583,24,0.655,7.1,178,53,125,0.298,334,0.533,31,0.587,7.1,2021-22,Regular%20Season
1627846,Abdel Nader,1610612756,PHX,11,9,2,132.0,4,4,0,1.0,18,0.222,1,0.235,2.9,23,6,17,0.261,34,0.676,4,0.767,5.8,27,10,17,0.37,48,0.563,5,0.628,5.3,2021-22,Regular%20Season
1629678,Admiral Schofield,1610612753,ORL,26,6,20,394.0,17,11,6,0.647,47,0.362,3,0.386,6.5,72,11,60,0.153,103,0.699,12,0.791,5.2,89,22,66,0.247,142,0.627,15,0.701,5.5,2021-22,Regular%20Season
201143,Al Horford,1610612738,BOS,68,46,22,1974.0,106,69,36,0.651,215,0.493,13,0.525,7.7,420,136,283,0.324,616,0.682,46,0.737,5.7,526,205,319,0.39,811,0.649,59,0.699,6.1,2021-22,Regular%20Season
202692,Alec Burks,1610612752,NYK,80,36,44,2280.0,45,12,33,0.267,128,0.352,4,0.363,15.3,343,67,276,0.195,511,0.671,41,0.73,6.5,388,79,309,0.204,620,0.626,45,0.675,7.5,2021-22,Regular%20Season
1630758,Aleem Ford,1610612753,ORL,4,2,2,67.0,2,1,1,0.5,3,0.667,0,0.667,9.2,13,1,12,0.077,22,0.591,3,0.684,8.1,15,2,13,0.133,25,0.6,3,0.682,8.2,2021-22,Regular%20Season
1630197,Aleksej Pokusevski,1610612760,OKC,58,18,40,1206.0,73,43,30,0.589,146,0.5,7,0.525,6.3,244,47,197,0.193,371,0.658,40,0.737,5.0,317,90,227,0.284,499,0.635,47,0.701,5.3,2021-22,Regular%20Season
1627936,Alex Caruso,1610612741,CHI,39,23,16,1087.0,33,17,17,0.515,94,0.351,5,0.371,9.6,114,20,92,0.175,188,0.606,14,0.655,8.5,147,37,109,0.252,275,0.535,19,0.574,8.8,2021-22,Regular%20Season
203458,Alex Len,1610612758,SAC,37,16,21,611.0,52,37,15,0.712,124,0.419,3,0.43,4.7,109,39,71,0.358,215,0.507,35,0.606,5.7,161,76,86,0.472,334,0.482,38,0.544,5.4,2021-22,Regular%20Season
1628035,Alfonzo McKinnie,1610612741,CHI,13,6,7,169.0,13,6,7,0.462,25,0.52,1,0.542,8.8,20,4,16,0.2,32,0.625,1,0.645,6.7,33,10,23,0.303,55,0.6,2,0.623,7.5,2021-22,Regular%20Season
1628993,Alize Johnson,1610612740,NOP,16,10,6,142.0,28,20,8,0.714,70,0.4,1,0.406,5.6,33,8,25,0.242,55,0.6,3,0.635,4.0,61,28,33,0.459,121,0.504,4,0.521,4.8,2021-22,Regular%20Season
1630578,Alperen Sengun,1610612745,HOU,71,17,54,1475.0,138,102,34,0.739,323,0.427,9,0.439,5.4,255,74,180,0.29,453,0.563,49,0.631,4.7,393,176,214,0.448,749,0.525,58,0.569,5.0,2021-22,Regular%20Season
1629599,Amir Coffey,1610612746,LAC,57,28,29,1449.0,26,6,19,0.231,75,0.347,1,0.351,13.7,169,25,143,0.148,254,0.665,28,0.748,7.9,195,31,162,0.159,319,0.611,29,0.672,8.7,2021-22,Regular%20Season
203083,Andre Drummond,1610612751,BKN,73,42,31,1437.0,229,174,55,0.76,428,0.535,7,0.544,3.9,451,151,300,0.335,625,0.722,33,0.762,3.9,680,325,355,0.478,1004,0.677,40,0.705,3.9,2021-22,Regular%20Season
2738,Andre Iguodala,1610612744,GSW,28,18,10,552.0,21,13,8,0.619,38,0.553,1,0.568,9.2,76,22,55,0.289,113,0.673,7,0.717,7.6,97,35,63,0.361,146,0.664,8,0.703,7.9,2021-22,Regular%20Season
203952,Andrew Wiggins,1610612744,GSW,70,45,25,2235.0,85,50,34,0.588,187,0.455,5,0.467,6.8,236,52,184,0.22,447,0.528,34,0.571,6.7,321,102,218,0.318,625,0.514,39,0.548,6.7,2021-22,Regular%20Season
1629014,Anfernee Simons,1610612757,POR,50,22,28,1498.0,26,8,18,0.308,67,0.388,1,0.394,15.8,125,21,104,0.168,218,0.573,23,0.641,7.6,151,29,122,0.192,280,0.539,24,0.59,9.0,2021-22,Regular%20Season
203076,Anthony Davis,1610612747,LAL,40,17,23,1404.0,106,83,22,0.783,205,0.517,7,0.535,5.1,288,107,180,0.372,442,0.652,31,0.701,5.0,394,190,202,0.482,630,0.625,38,0.666,5.0,2021-22,Regular%20Season
1630162,Anthony Edwards,1610612750,MIN,69,37,32,2396.0,62,18,42,0.29,134,0.463,3,0.473,12.4,281,44,235,0.157,446,0.63,48,0.706,6.8,343,62,277,0.181,575,0.597,51,0.655,7.8,2021-22,Regular%20Season
1630264,Anthony Gill,1610612764,WAS,31,11,20,424.0,33,22,11,0.667,71,0.465,1,0.471,7.2,52,8,44,0.154,84,0.619,11,0.712,8.7,85,30,55,0.353,153,0.556,12,0.603,8.1,2021-22,Regular%20Season
1630237,Anthony Lamb,1610612745,HOU,1,0,1,4.0,0,0,0,0.0,0,0.0,0,0.0,0.0,1,0,1,0.0,2,0.5,0,0.5,6.0,1,0,1,0.0,2,0.5,0,0.5,6.0,2021-22,Regular%20Season
1629717,Armoni Brooks,1610612761,TOR,40,17,23,724.0,20,3,17,0.15,32,0.625,0,0.625,18.8,83,9,74,0.108,124,0.669,8,0.716,7.1,103,12,91,0.117,152,0.678,8,0.715,9.4,2021-22,Regular%20Season
1630559,Austin Reaves,1610612747,LAL,54,25,29,1326.0,45,19,27,0.422,104,0.433,2,0.441,9.4,148,24,124,0.162,262,0.565,21,0.614,7.6,193,43,151,0.223,352,0.548,23,0.587,8.1,2021-22,Regular%20Season
203085,Austin Rivers,1610612743,DEN,54,32,22,1279.0,19,3,15,0.158,47,0.404,3,0.432,17.6,95,18,77,0.189,176,0.54,20,0.609,8.3,114,21,92,0.184,218,0.523,23,0.585,9.8,2021-22,Regular%20Season
202340,Avery Bradley,1610612747,LAL,55,25,30,1303.0,31,10,21,0.323,80,0.388,3,0.403,8.9,105,17,88,0.162,184,0.571,16,0.625,10.1,136,27,109,0.199,256,0.531,19,0.574,9.8,2021-22,Regular%20Season
1630245,Ayo Dosunmu,1610612741,CHI,67,39,28,1874.0,27,10,17,0.37,85,0.318,3,0.329,12.2,187,37,150,0.198,302,0.619,35,0.7,8.2,214,47,167,0.22,386,0.554,38,0.615,8.7,2021-22,Regular%20Season
1629168,BJ Johnson,1610612753,ORL,4,2,2,65.0,6,4,2,0.667,9,0.667,0,0.667,3.6,9,2,7,0.222,15,0.6,0,0.6,5.5,15,6,9,0.4,23,0.652,0,0.652,4.7,2021-22,Regular%20Season
1628389,Bam Adebayo,1610612748,MIA,56,36,20,1825.0,137,88,48,0.642,316,0.434,9,0.446,6.5,427,118,307,0.276,609,0.701,50,0.764,5.5,564,206,355,0.365,894,0.631,59,0.675,5.8,2021-22,Regular%20Season
203463,Ben McLemore,1610612757,POR,52,16,36,1139.0,12,5,7,0.417,60,0.2,2,0.207,13.0,91,25,65,0.275,183,0.497,18,0.552,7.5,103,30,72,0.291,234,0.44,20,0.481,8.2,2021-22,Regular%20Season
202687,Bismack Biyombo,1610612756,PHX,32,26,6,480.0,62,43,18,0.694,129,0.481,3,0.492,5.2,102,31,71,0.304,163,0.626,19,0.708,5.3,164,74,89,0.451,279,0.588,22,0.638,5.3,2021-22,Regular%20Season
201933,Blake Griffin,1610612751,BKN,53,26,27,940.0,60,45,14,0.75,129,0.465,2,0.472,5.9,168,56,112,0.333,278,0.604,33,0.686,4.8,228,101,126,0.443,397,0.574,35,0.63,5.1,2021-22,Regular%20Season
1626246,Boban Marjanovic,1610612742,DAL,14,7,7,97.0,8,7,0,0.875,22,0.364,1,0.381,4.2,31,7,25,0.226,40,0.775,4,0.861,3.7,39,14,25,0.359,61,0.639,5,0.696,3.8,2021-22,Regular%20Season
1626171,Bobby Portis,1610612749,MIL,72,46,26,2028.0,180,137,43,0.761,403,0.447,13,0.462,5.7,477,110,367,0.231,733,0.651,62,0.711,4.7,657,247,410,0.376,1090,0.603,75,0.647,5.0,2021-22,Regular%20Season
203992,Bogdan Bogdanovic,1610612737,ATL,63,33,30,1849.0,29,17,12,0.586,78,0.372,1,0.377,9.6,221,41,180,0.186,363,0.609,32,0.668,7.1,250,58,192,0.232,432,0.579,33,0.627,7.4,2021-22,Regular%20Season
202711,Bojan Bogdanovic,1610612762,UTA,68,44,24,2104.0,58,24,34,0.414,164,0.354,3,0.36,10.3,238,47,192,0.197,389,0.612,42,0.686,7.2,296,71,226,0.24,538,0.55,45,0.6,7.8,2021-22,Regular%20Season
1629626,Bol Bol,1610612753,ORL,10,3,7,72.0,4,1,3,0.25,6,0.667,0,0.667,11.9,16,4,12,0.25,17,0.941,1,1.0,7.1,20,5,15,0.25,20,1.0,1,1.053,8.1,2021-22,Regular%20Season
1630538,Bones Hyland,1610612743,DEN,64,36,28,1242.0,14,1,13,0.071,74,0.189,4,0.2,17.4,174,20,153,0.115,284,0.613,26,0.674,6.9,188,21,166,0.112,345,0.545,30,0.597,7.6,2021-22,Regular%20Season
202954,Brad Wanamaker,1610612764,WAS,20,8,12,296.0,6,1,4,0.167,22,0.273,0,0.273,17.4,33,4,30,0.121,55,0.6,5,0.66,10.2,39,5,34,0.128,77,0.506,5,0.542,11.2,2021-22,Regular%20Season
203078,Bradley Beal,1610612764,WAS,40,17,23,1439.0,38,14,24,0.368,85,0.447,6,0.481,9.9,151,35,116,0.232,240,0.629,22,0.693,7.4,189,49,140,0.259,322,0.587,28,0.643,7.9,2021-22,Regular%20Season
1630527,Brandon Boston Jr.,1610612746,LAC,35,19,16,652.0,16,8,8,0.5,41,0.39,1,0.4,7.7,92,15,78,0.163,156,0.59,15,0.652,6.7,108,23,86,0.213,195,0.554,16,0.603,6.9,2021-22,Regular%20Season
1629634,Brandon Clarke,1610612763,MEM,61,43,18,1209.0,134,103,31,0.769,282,0.475,9,0.491,4.3,204,57,147,0.279,364,0.56,53,0.656,5.5,338,160,178,0.473,628,0.538,62,0.597,5.0,2021-22,Regular%20Season
1629164,Brandon Goodwin,1610612739,CLE,25,14,11,437.0,14,4,10,0.286,33,0.424,0,0.424,14.4,53,10,43,0.189,80,0.663,6,0.716,8.0,67,14,53,0.209,112,0.598,6,0.632,9.3,2021-22,Regular%20Season
1627742,Brandon Ingram,1610612740,NOP,54,28,26,1834.0,33,11,22,0.333,89,0.371,2,0.379,12.1,276,69,206,0.25,420,0.657,43,0.732,6.2,309,80,228,0.259,502,0.616,45,0.676,6.9,2021-22,Regular%20Season
202688,Brandon Knight,1610612742,DAL,4,1,3,58.0,0,0,0,0.0,3,0.0,0,0.0,0.0,8,2,6,0.25,11,0.727,0,0.727,8.6,8,2,6,0.25,13,0.615,0,0.615,8.6,2021-22,Regular%20Season
1630314,Brandon Williams,1610612757,POR,21,2,19,584.0,19,6,13,0.316,56,0.339,4,0.365,16.9,55,9,46,0.164,104,0.529,4,0.55,10.4,74,15,59,0.203,155,0.477,8,0.503,12.0,2021-22,Regular%20Season
1630296,Braxton Key,1610612765,DET,11,5,6,197.0,13,8,5,0.615,24,0.542,0,0.542,7.6,37,12,26,0.324,63,0.587,5,0.638,5.8,50,20,31,0.4,84,0.595,5,0.633,6.2,2021-22,Regular%20Season
1630271,Brodric Thomas,1610612738,BOS,7,6,1,45.0,2,2,0,1.0,4,0.5,0,0.5,6.2,8,3,5,0.375,13,0.615,1,0.667,5.7,10,5,5,0.5,17,0.588,1,0.625,5.8,2021-22,Regular%20Season
201572,Brook Lopez,1610612749,MIL,13,10,3,298.0,19,12,7,0.632,41,0.463,2,0.487,7.7,34,11,23,0.324,78,0.436,9,0.493,7.1,53,23,30,0.434,117,0.453,11,0.5,7.3,2021-22,Regular%20Season
1628971,Bruce Brown,1610612751,BKN,71,37,34,1769.0,100,55,44,0.55,260,0.385,10,0.4,7.1,245,48,197,0.196,398,0.616,33,0.671,5.8,345,103,241,0.299,643,0.537,43,0.575,6.1,2021-22,Regular%20Season
1628981,Bruno Fernando,1610612745,HOU,21,9,12,133.0,18,16,2,0.889,47,0.383,2,0.4,3.5,37,8,29,0.216,59,0.627,6,0.698,4.4,55,24,31,0.436,101,0.545,8,0.591,4.1,2021-22,Regular%20Season
1627854,Bryn Forbes,1610612743,DEN,49,19,30,962.0,10,3,7,0.3,44,0.227,4,0.25,24.5,83,11,72,0.133,136,0.61,9,0.654,8.9,93,14,79,0.151,176,0.528,13,0.571,10.6,2021-22,Regular%20Season
1627741,Buddy Hield,1610612754,IND,79,25,54,2443.0,66,26,40,0.394,179,0.369,8,0.386,11.2,284,41,243,0.144,524,0.542,54,0.604,7.4,350,67,283,0.191,689,0.508,62,0.558,8.1,2021-22,Regular%20Season
1629604,CJ Elleby,1610612757,POR,54,15,39,1146.0,66,34,32,0.515,141,0.468,2,0.475,7.7,161,26,134,0.161,277,0.581,21,0.629,6.6,227,60,166,0.264,404,0.562,23,0.596,6.9,2021-22,Regular%20Season
203468,CJ McCollum,1610612740,NOP,61,28,33,2111.0,53,14,39,0.264,125,0.424,9,0.457,13.4,216,27,187,0.125,329,0.657,22,0.704,9.6,269,41,226,0.152,450,0.598,31,0.642,10.4,2021-22,Regular%20Season
1630595,Cade Cunningham,1610612765,DET,61,19,42,2012.0,57,33,24,0.579,153,0.373,5,0.385,8.7,292,61,231,0.209,463,0.631,33,0.679,6.6,349,94,255,0.269,607,0.575,38,0.613,6.9,2021-22,Regular%20Season
1628997,Caleb Martin,1610612748,MIA,58,35,23,1350.0,70,29,41,0.414,159,0.44,6,0.458,8.9,160,29,131,0.181,289,0.554,31,0.62,6.8,230,58,172,0.252,439,0.524,37,0.572,7.5,2021-22,Regular%20Season
1629629,Cam Reddish,1610612752,NYK,38,17,21,884.0,25,6,19,0.24,52,0.481,0,0.481,14.8,80,11,69,0.138,129,0.62,10,0.672,8.5,105,17,88,0.162,179,0.587,10,0.621,10.0,2021-22,Regular%20Season
1630560,Cam Thomas,1610612751,BKN,54,25,29,1109.0,16,4,12,0.25,58,0.276,1,0.281,13.6,145,28,117,0.193,250,0.58,18,0.625,7.6,161,32,129,0.199,298,0.54,19,0.577,8.2,2021-22,Regular%20Season
1629661,Cameron Johnson,1610612756,PHX,63,47,16,1653.0,41,18,23,0.439,108,0.38,4,0.394,10.3,225,47,176,0.209,350,0.643,30,0.703,7.2,266,65,199,0.244,445,0.598,34,0.647,7.7,2021-22,Regular%20Season
1630787,Cameron McGriff,1610612757,POR,3,0,3,46.0,6,3,3,0.5,10,0.6,0,0.6,7.7,9,4,5,0.444,13,0.692,0,0.692,8.5,15,7,8,0.467,22,0.682,0,0.682,8.2,2021-22,Regular%20Season
1628419,Cameron Oliver,1610612737,ATL,2,1,1,43.0,2,2,0,1.0,5,0.4,0,0.4,2.5,4,1,3,0.25,8,0.5,2,0.667,7.5,6,3,3,0.5,12,0.5,2,0.6,5.8,2021-22,Regular%20Season
1626166,Cameron Payne,1610612756,PHX,56,44,12,1253.0,23,9,15,0.391,68,0.338,3,0.354,12.6,147,11,136,0.075,225,0.653,11,0.687,9.3,170,20,151,0.118,290,0.586,14,0.616,9.8,2021-22,Regular%20Season
1627747,Caris LeVert,1610612739,CLE,54,21,33,1657.0,43,25,17,0.581,123,0.35,5,0.364,8.7,171,29,142,0.17,293,0.584,29,0.648,8.0,214,54,159,0.252,407,0.526,34,0.574,8.1,2021-22,Regular%20Season
1630637,Carlik Jones,1610612743,DEN,2,1,1,15.0,1,1,0,1.0,3,0.333,0,0.333,2.2,2,1,1,0.5,4,0.5,2,1.0,5.5,3,2,1,0.667,7,0.429,2,0.6,4.4,2021-22,Regular%20Season
2546,Carmelo Anthony,1610612747,LAL,69,27,42,1793.0,62,32,30,0.516,128,0.484,4,0.5,8.0,226,57,167,0.252,376,0.601,27,0.648,5.7,288,89,197,0.309,481,0.599,31,0.64,6.2,2021-22,Regular%20Season
1629035,Carsen Edwards,1610612765,DET,3,1,2,70.0,2,1,1,0.5,6,0.333,2,0.5,12.1,4,0,4,0.0,11,0.364,0,0.364,12.6,6,1,5,0.167,17,0.353,2,0.4,12.5,2021-22,Regular%20Season
1630199,Cassius Stanley,1610612765,DET,7,2,5,147.0,5,4,1,0.8,13,0.385,1,0.417,5.8,14,4,10,0.286,24,0.583,2,0.636,6.3,19,8,11,0.421,35,0.543,3,0.594,6.2,2021-22,Regular%20Season
1630216,Cassius Winston,1610612764,WAS,1,0,1,8.0,0,0,0,0.0,0,0.0,0,0.0,0.0,1,0,1,0.0,2,0.5,0,0.5,12.3,1,0,1,0.0,2,0.5,0,0.5,12.3,2021-22,Regular%20Season
1627760,Cat Barber,1610612737,ATL,2,0,2,11.0,1,1,0,1.0,1,1.0,0,1.0,1.5,2,0,2,0.0,2,1.0,0,1.0,6.6,3,1,2,0.333,3,1.0,0,1.0,4.9,2021-22,Regular%20Season
1626224,Cedi Osman,1610612739,CLE,56,30,26,1304.0,25,13,13,0.52,69,0.362,3,0.379,10.6,121,14,107,0.116,212,0.571,23,0.64,8.1,146,27,120,0.185,279,0.523,26,0.577,8.6,2021-22,Regular%20Season
1628990,Chandler Hutchison,1610612756,PHX,4,3,1,12.0,0,0,0,0.0,0,0.0,0,0.0,0.0,5,1,4,0.2,4,1.25,0,1.25,4.7,5,1,4,0.2,4,1.25,0,1.25,4.7,2021-22,Regular%20Season
1629646,Charles Bassey,1610612755,PHI,18,9,9,156.0,22,18,4,0.818,49,0.449,1,0.458,3.4,40,17,23,0.425,73,0.548,7,0.606,3.8,62,35,27,0.565,120,0.517,8,0.554,3.7,2021-22,Regular%20Season
1629718,Charlie Brown Jr.,1610612755,PHI,9,5,4,140.0,14,8,6,0.571,29,0.483,1,0.5,4.9,18,3,15,0.167,29,0.621,3,0.692,4.1,32,11,21,0.344,55,0.582,4,0.627,4.5,2021-22,Regular%20Season
1630602,Chaundee Brown Jr.,1610612737,ATL,5,1,4,104.0,1,0,1,0.0,7,0.143,0,0.143,20.3,15,0,15,0.0,19,0.789,2,0.882,7.8,16,0,16,0.0,25,0.64,2,0.696,8.5,2021-22,Regular%20Season
1627767,Cheick Diallo,1610612765,DET,2,0,2,28.0,4,3,1,0.75,13,0.308,0,0.308,3.6,8,3,5,0.375,10,0.8,0,0.8,3.6,12,6,6,0.5,22,0.545,0,0.545,3.6,2021-22,Regular%20Season
1629002,Chimezie Metu,1610612758,SAC,59,22,37,1276.0,34,16,18,0.471,108,0.315,5,0.33,9.5,301,67,234,0.223,429,0.702,27,0.749,4.4,335,83,252,0.248,522,0.642,32,0.684,5.0,2021-22,Regular%20Season
1628449,Chris Boucher,1610612761,TOR,79,47,32,1683.0,179,122,52,0.682,391,0.458,14,0.475,4.5,315,88,223,0.279,515,0.612,50,0.677,4.6,494,210,275,0.425,888,0.556,64,0.6,4.6,2021-22,Regular%20Season
1629185,Chris Chiozza,1610612744,GSW,16,9,7,281.0,9,4,5,0.444,15,0.6,0,0.6,14.7,26,6,19,0.231,44,0.591,4,0.65,6.4,35,10,24,0.286,58,0.603,4,0.648,8.6,2021-22,Regular%20Season
1630537,Chris Duarte,1610612754,IND,54,21,33,1518.0,41,21,22,0.512,116,0.353,6,0.373,9.6,185,21,163,0.114,308,0.601,23,0.649,7.5,226,42,185,0.186,418,0.541,29,0.581,7.9,2021-22,Regular%20Season
101108,Chris Paul,1610612756,PHX,63,51,12,2085.0,19,5,14,0.263,51,0.373,1,0.38,13.2,251,46,206,0.183,423,0.593,36,0.649,8.6,270,51,220,0.189,470,0.574,37,0.624,9.0,2021-22,Regular%20Season
1629735,Chris Silva,1610612748,MIA,7,4,3,83.0,13,7,6,0.538,34,0.382,0,0.382,4.2,23,4,18,0.174,34,0.676,5,0.793,3.9,36,11,24,0.306,65,0.554,5,0.6,4.1,2021-22,Regular%20Season
1626174,Christian Wood,1610612745,HOU,67,18,49,2084.0,110,72,38,0.655,273,0.403,7,0.414,5.2,576,159,417,0.276,827,0.696,42,0.734,4.7,686,231,455,0.337,1043,0.658,49,0.69,4.8,2021-22,Regular%20Season
1629643,Chuma Okeke,1610612753,ORL,70,21,49,1749.0,47,21,26,0.447,118,0.398,4,0.412,9.8,300,80,218,0.267,428,0.701,21,0.737,6.7,347,101,244,0.291,518,0.67,25,0.704,7.1,2021-22,Regular%20Season
203991,Clint Capela,1610612737,ATL,74,40,34,2042.0,279,192,84,0.688,541,0.516,11,0.526,4.7,598,172,426,0.288,892,0.67,77,0.734,4.5,877,364,510,0.415,1394,0.629,88,0.672,4.5,2021-22,Regular%20Season
1629632,Coby White,1610612741,CHI,57,30,27,1588.0,17,5,13,0.294,67,0.254,2,0.262,15.9,165,32,133,0.194,277,0.596,23,0.65,7.1,182,37,146,0.203,339,0.537,25,0.58,7.9,2021-22,Regular%20Season
1628998,Cody Martin,1610612766,CHA,65,38,27,1763.0,82,35,46,0.427,170,0.482,5,0.497,10.3,202,43,158,0.213,352,0.574,35,0.637,7.4,284,78,204,0.275,508,0.559,40,0.607,8.2,2021-22,Regular%20Season
203469,Cody Zeller,1610612757,POR,26,12,14,346.0,50,32,17,0.64,112,0.446,5,0.467,4.7,75,22,53,0.293,114,0.658,11,0.728,5.3,125,54,70,0.432,225,0.556,16,0.598,5.0,2021-22,Regular%20Season
1630175,Cole Anthony,1610612753,ORL,64,18,46,2057.0,32,15,17,0.469,105,0.305,7,0.327,10.9,316,45,271,0.142,521,0.607,63,0.69,6.4,348,60,288,0.172,616,0.565,70,0.637,6.8,2021-22,Regular%20Season
1629012,Collin Sexton,1610612739,CLE,11,7,4,316.0,13,7,6,0.538,25,0.52,1,0.542,8.3,23,3,20,0.13,36,0.639,2,0.676,10.8,36,10,26,0.278,60,0.6,3,0.632,9.9,2021-22,Regular%20Season
1630557,Corey Kispert,1610612764,WAS,72,28,44,1752.0,53,18,35,0.34,102,0.52,2,0.53,10.1,156,20,135,0.128,269,0.58,30,0.653,8.3,209,38,170,0.182,365,0.573,32,0.628,8.8,2021-22,Regular%20Season
202709,Cory Joseph,1610612765,DET,59,16,43,1488.0,29,12,18,0.414,85,0.341,3,0.354,12.0,145,30,114,0.207,264,0.549,24,0.604,8.1,174,42,132,0.241,344,0.506,27,0.549,8.8,2021-22,Regular%20Season
1626156,D'Angelo Russell,1610612750,MIN,65,39,26,2077.0,25,6,19,0.24,75,0.333,1,0.338,16.5,191,28,163,0.147,316,0.604,22,0.65,8.3,216,34,182,0.157,387,0.558,23,0.593,9.2,2021-22,Regular%20Season
201571,D.J. Augustin,1610612747,LAL,39,10,29,634.0,11,1,9,0.091,18,0.611,0,0.611,18.1,57,3,54,0.053,92,0.62,6,0.663,11.2,68,4,63,0.059,109,0.624,6,0.66,12.2,2021-22,Regular%20Season
1628391,D.J. Wilson,1610612761,TOR,3,1,2,53.0,1,1,0,1.0,3,0.333,0,0.333,2.8,15,3,12,0.2,28,0.536,1,0.556,5.0,16,4,12,0.25,31,0.516,1,0.533,4.9,2021-22,Regular%20Season
1629610,DaQuan Jeffries,1610612763,MEM,1,1,0,4.0,0,0,0,0.0,0,0.0,0,0.0,0.0,1,1,0,1.0,1,1.0,0,1.0,7.6,1,1,0,1.0,1,1.0,0,1.0,7.6,2021-22,Regular%20Season
1630227,Daishen Nix,1610612745,HOU,15,1,14,206.0,7,3,4,0.429,20,0.35,0,0.35,8.5,26,7,19,0.269,43,0.605,1,0.619,5.8,33,10,23,0.303,61,0.541,1,0.55,6.4,2021-22,Regular%20Season
1630625,Dalano Banton,1610612761,TOR,53,28,25,621.0,38,28,11,0.737,90,0.422,3,0.437,5.6,86,20,66,0.233,150,0.573,12,0.623,6.9,124,48,77,0.387,238,0.521,15,0.556,6.5,2021-22,Regular%20Season
1627745,Damian Jones,1610612758,SAC,51,17,34,997.0,75,44,29,0.587,175,0.429,5,0.441,6.0,170,43,125,0.253,296,0.574,30,0.639,5.3,245,87,154,0.355,452,0.542,35,0.588,5.5,2021-22,Regular%20Season
203081,Damian Lillard,1610612757,POR,27,11,16,981.0,13,5,8,0.385,50,0.26,0,0.26,16.4,107,15,92,0.14,150,0.713,8,0.754,8.4,120,20,100,0.167,195,0.615,8,0.642,9.2,2021-22,Regular%20Season
1627814,Damion Lee,1610612744,GSW,56,37,19,1185.0,26,15,11,0.577,71,0.366,0,0.366,11.5,172,31,140,0.18,281,0.612,30,0.685,7.1,198,46,151,0.232,346,0.572,30,0.627,7.7,2021-22,Regular%20Season
1628422,Damyean Dotson,1610612752,NYK,2,1,1,21.0,0,0,0,0.0,0,0.0,0,0.0,0.0,2,0,2,0.0,2,1.0,0,1.0,1.6,2,0,2,0.0,2,1.0,0,1.0,1.6,2021-22,Regular%20Season
1629655,Daniel Gafford,1610612764,WAS,71,29,42,1436.0,155,107,46,0.69,398,0.389,14,0.404,4.1,252,86,165,0.341,489,0.515,73,0.606,4.0,407,193,211,0.474,862,0.472,87,0.525,4.0,2021-22,Regular%20Season
1630187,Daniel Oturu,1610612761,TOR,3,1,2,27.0,1,1,0,1.0,3,0.333,0,0.333,0.2,4,1,3,0.25,8,0.5,1,0.571,3.1,5,2,3,0.4,11,0.455,1,0.5,2.5,2021-22,Regular%20Season
1628464,Daniel Theis,1610612738,BOS,46,19,27,966.0,59,39,21,0.661,134,0.44,5,0.457,6.0,169,43,124,0.254,298,0.567,40,0.655,5.2,228,82,145,0.36,427,0.534,45,0.597,5.4,2021-22,Regular%20Season
201568,Danilo Gallinari,1610612737,ATL,65,35,30,1649.0,35,16,18,0.457,79,0.443,3,0.461,9.2,273,53,219,0.194,419,0.652,28,0.698,5.8,308,69,237,0.224,483,0.638,31,0.681,6.2,2021-22,Regular%20Season
201980,Danny Green,1610612755,PHI,54,32,22,1195.0,32,13,19,0.406,84,0.381,3,0.395,11.1,125,18,107,0.144,227,0.551,25,0.619,7.6,157,31,126,0.197,299,0.525,28,0.579,8.3,2021-22,Regular%20Season
1627863,Danuel House Jr.,1610612762,UTA,38,17,21,699.0,18,4,14,0.222,52,0.346,2,0.36,11.4,93,18,74,0.194,162,0.574,14,0.628,7.8,111,22,88,0.198,207,0.536,16,0.581,8.4,2021-22,Regular%20Season
1629647,Darius Bazley,1610612760,OKC,69,19,50,1924.0,71,41,30,0.577,201,0.353,7,0.366,7.7,365,84,279,0.23,546,0.668,42,0.724,4.8,436,125,309,0.287,719,0.606,49,0.651,5.3,2021-22,Regular%20Season
1629636,Darius Garland,1610612739,CLE,66,36,30,2353.0,39,15,24,0.385,109,0.358,5,0.375,11.2,185,15,170,0.081,288,0.642,24,0.701,11.1,224,30,194,0.134,393,0.57,29,0.615,11.1,2021-22,Regular%20Season
201954,Darren Collison,1610612747,LAL,2,1,1,27.0,0,0,0,0.0,0,0.0,0,0.0,0.0,4,1,3,0.25,5,0.8,0,0.8,8.6,4,1,3,0.25,5,0.8,0,0.8,8.6,2021-22,Regular%20Season
1630561,David Duke Jr.,1610612751,BKN,18,8,10,318.0,30,22,8,0.733,57,0.526,4,0.566,7.0,37,13,23,0.351,55,0.673,3,0.712,7.6,67,35,31,0.522,110,0.609,7,0.65,7.3,2021-22,Regular%20Season
1628021,David Nwaba,1610612745,HOU,45,6,39,599.0,41,25,16,0.61,98,0.418,4,0.436,7.7,110,17,93,0.155,176,0.625,19,0.701,6.5,151,42,109,0.278,259,0.583,23,0.64,6.9,2021-22,Regular%20Season
1630558,Davion Mitchell,1610612758,SAC,64,24,40,1814.0,31,5,25,0.161,83,0.373,4,0.392,14.8,131,18,112,0.137,239,0.548,19,0.595,9.6,162,23,137,0.142,315,0.514,23,0.555,10.6,2021-22,Regular%20Season
202722,Davis Bertans,1610612742,DAL,45,29,16,708.0,12,5,7,0.417,37,0.324,1,0.333,13.4,105,27,77,0.257,167,0.629,19,0.709,6.2,117,32,84,0.274,194,0.603,20,0.672,6.9,2021-22,Regular%20Season
1628432,Davon Reed,1610612743,DEN,39,24,15,625.0,14,5,9,0.357,41,0.341,1,0.35,11.3,94,19,75,0.202,152,0.618,12,0.671,6.3,108,24,84,0.222,180,0.6,13,0.647,7.0,2021-22,Regular%20Season
1630549,Day'Ron Sharpe,1610612751,BKN,27,10,17,381.0,81,66,14,0.815,144,0.563,2,0.57,3.7,79,28,51,0.354,139,0.568,16,0.642,4.8,160,94,65,0.588,279,0.573,18,0.613,4.2,2021-22,Regular%20Season
1628368,De'Aaron Fox,1610612758,SAC,57,21,36,2023.0,24,5,19,0.208,99,0.242,7,0.261,15.1,203,27,175,0.133,320,0.634,33,0.707,8.9,227,32,194,0.141,406,0.559,40,0.62,9.6,2021-22,Regular%20Season
1629631,De'Andre Hunter,1610612737,ATL,52,28,24,1548.0,26,10,16,0.385,76,0.342,2,0.351,10.9,150,45,105,0.3,259,0.579,27,0.647,6.3,176,55,121,0.313,327,0.538,29,0.591,7.0,2021-22,Regular%20Season
1629001,De'Anthony Melton,1610612763,MEM,69,47,22,1583.0,63,29,34,0.46,146,0.432,2,0.438,9.9,257,49,207,0.191,377,0.682,30,0.741,6.2,320,78,241,0.244,504,0.635,32,0.678,6.9,2021-22,Regular%20Season
201599,DeAndre Jordan,1610612755,PHI,48,26,22,622.0,83,57,25,0.687,153,0.542,4,0.557,4.7,181,48,131,0.265,252,0.718,21,0.784,5.1,264,105,156,0.398,394,0.67,25,0.715,4.9,2021-22,Regular%20Season
1627761,DeAndre' Bembry,1610612749,MIL,48,29,19,962.0,42,28,15,0.667,103,0.408,4,0.424,7.3,121,21,100,0.174,216,0.56,25,0.634,6.5,163,49,115,0.301,314,0.519,29,0.572,6.7,2021-22,Regular%20Season
201942,DeMar DeRozan,1610612741,CHI,75,43,32,2710.0,56,26,30,0.464,151,0.371,7,0.389,11.9,336,58,277,0.173,517,0.65,45,0.712,7.4,392,84,307,0.214,653,0.6,52,0.652,8.0,2021-22,Regular%20Season
202326,DeMarcus Cousins,1610612743,DEN,46,31,15,709.0,74,49,25,0.662,160,0.463,6,0.481,5.0,196,61,135,0.311,282,0.695,18,0.742,4.5,270,110,160,0.407,422,0.64,24,0.678,4.6,2021-22,Regular%20Season
1629731,Dean Wade,1610612739,CLE,46,25,21,945.0,31,12,19,0.387,65,0.477,2,0.492,7.7,119,28,91,0.235,215,0.553,33,0.654,5.9,150,40,110,0.267,271,0.554,35,0.636,6.2,2021-22,Regular%20Season
1629028,Deandre Ayton,1610612756,PHX,57,45,12,1705.0,149,102,44,0.685,292,0.51,5,0.519,5.9,444,133,308,0.3,687,0.646,70,0.72,4.3,593,235,352,0.396,947,0.626,75,0.68,4.7,2021-22,Regular%20Season
1629686,Deividas Sirvydis,1610612765,DET,2,1,1,22.0,0,0,0,0.0,2,0.0,0,0.0,0.0,6,1,5,0.167,8,0.75,0,0.75,3.3,6,1,5,0.167,10,0.6,0,0.6,3.3,2021-22,Regular%20Season
1627749,Dejounte Murray,1610612759,SAS,68,30,38,2366.0,80,38,40,0.475,248,0.323,14,0.342,9.7,483,80,406,0.166,751,0.643,71,0.71,5.7,563,118,446,0.21,955,0.59,85,0.647,6.2,2021-22,Regular%20Season
1626153,Delon Wright,1610612737,ATL,69,38,31,1357.0,50,28,22,0.56,103,0.485,5,0.51,7.6,170,23,147,0.135,269,0.632,24,0.694,7.6,220,51,169,0.232,369,0.596,29,0.647,7.6,2021-22,Regular%20Season
1630166,Deni Avdija,1610612764,WAS,81,34,47,1981.0,52,27,25,0.519,165,0.315,4,0.323,8.1,373,87,284,0.233,595,0.627,76,0.719,4.1,425,114,309,0.268,720,0.59,80,0.664,4.6,2021-22,Regular%20Season
203471,Dennis Schroder,1610612745,HOU,62,32,30,1790.0,33,5,28,0.152,91,0.363,2,0.371,17.7,176,17,158,0.097,310,0.568,24,0.615,9.0,209,22,186,0.105,399,0.524,26,0.56,10.4,2021-22,Regular%20Season
1628372,Dennis Smith Jr.,1610612757,POR,31,13,18,594.0,20,10,10,0.5,55,0.364,3,0.385,10.2,68,8,60,0.118,115,0.591,8,0.636,8.1,88,18,70,0.205,165,0.533,11,0.571,8.6,2021-22,Regular%20Season
1627756,Denzel Valentine,1610612762,UTA,14,7,7,190.0,9,3,6,0.333,19,0.474,0,0.474,11.3,33,5,28,0.152,54,0.611,6,0.688,5.1,42,8,34,0.19,69,0.609,6,0.667,6.4,2021-22,Regular%20Season
202324,Derrick Favors,1610612760,OKC,39,15,24,652.0,58,41,17,0.707,122,0.475,3,0.487,5.9,126,49,77,0.389,217,0.581,22,0.646,4.4,184,90,94,0.489,338,0.544,25,0.588,4.9,2021-22,Regular%20Season
1627884,Derrick Jones Jr.,1610612741,CHI,49,27,22,896.0,60,36,23,0.6,141,0.426,5,0.441,6.4,109,23,86,0.211,184,0.592,21,0.669,5.7,169,59,109,0.349,316,0.535,26,0.583,5.9,2021-22,Regular%20Season
201565,Derrick Rose,1610612752,NYK,25,10,15,612.0,21,10,11,0.476,44,0.477,3,0.512,11.4,57,11,46,0.193,113,0.504,12,0.564,8.9,78,21,57,0.269,157,0.497,15,0.549,9.6,2021-22,Regular%20Season
1628476,Derrick Walton Jr.,1610612765,DET,2,1,1,71.0,2,1,1,0.5,4,0.5,0,0.5,23.5,8,1,6,0.125,14,0.571,2,0.667,5.4,10,2,7,0.2,18,0.556,2,0.625,9.4,2021-22,Regular%20Season
1628401,Derrick White,1610612738,BOS,72,40,32,2123.0,38,17,21,0.447,103,0.369,4,0.384,12.6,223,48,174,0.215,378,0.59,31,0.643,8.4,261,65,195,0.249,465,0.561,35,0.607,9.0,2021-22,Regular%20Season
1630217,Desmond Bane,1610612763,MEM,75,53,22,2244.0,46,19,27,0.413,160,0.288,8,0.303,13.1,288,48,238,0.167,465,0.619,37,0.673,6.1,334,67,265,0.201,596,0.56,45,0.606,7.1,2021-22,Regular%20Season
1626164,Devin Booker,1610612756,PHX,66,55,11,2273.0,42,18,23,0.429,121,0.347,5,0.362,10.0,290,42,248,0.145,480,0.604,39,0.658,7.6,332,60,271,0.181,593,0.56,44,0.605,7.9,2021-22,Regular%20Season
1629962,Devin Cannady,1610612753,ORL,2,1,1,54.0,1,0,1,0.0,3,0.333,0,0.333,6.2,5,0,5,0.0,7,0.714,0,0.714,6.2,6,0,6,0.0,10,0.6,0,0.6,6.2,2021-22,Regular%20Season
1630170,Devin Vassell,1610612759,SAS,69,28,41,1902.0,44,26,18,0.591,91,0.484,5,0.512,10.1,262,69,193,0.263,416,0.63,28,0.675,5.8,306,95,211,0.31,498,0.614,33,0.658,6.4,2021-22,Regular%20Season
1629653,Devon Dotson,1610612741,CHI,6,2,4,44.0,1,0,1,0.0,1,1.0,0,1.0,13.0,8,2,6,0.25,10,0.8,1,0.889,8.7,9,2,7,0.222,11,0.818,1,0.9,9.2,2021-22,Regular%20Season
1629719,Devontae Cacok,1610612759,SAS,14,4,10,114.0,8,8,0,1.0,29,0.276,0,0.276,3.2,34,6,28,0.176,42,0.81,2,0.85,4.0,42,14,28,0.333,66,0.636,2,0.656,3.8,2021-22,Regular%20Season
1628984,Devonte' Graham,1610612740,NOP,69,31,38,1982.0,37,9,28,0.243,85,0.435,4,0.457,16.7,139,19,121,0.137,218,0.638,15,0.685,10.0,176,28,149,0.159,300,0.587,19,0.626,11.4,2021-22,Regular%20Season
203473,Dewayne Dedmon,1610612748,MIA,66,43,23,1056.0,105,68,37,0.648,270,0.389,6,0.398,5.3,281,78,201,0.278,439,0.64,40,0.704,4.3,386,146,238,0.378,682,0.566,46,0.607,4.6,2021-22,Regular%20Season
1629712,Didi Louzada,1610612757,POR,8,0,8,128.0,5,1,4,0.2,12,0.417,0,0.417,11.6,12,2,10,0.167,25,0.48,1,0.5,9.5,17,3,14,0.176,35,0.486,1,0.5,10.1,2021-22,Regular%20Season
1628415,Dillon Brooks,1610612763,MEM,30,20,10,828.0,27,11,15,0.407,70,0.386,3,0.403,11.1,72,13,59,0.181,125,0.576,7,0.61,8.3,99,24,74,0.242,194,0.51,10,0.538,9.0,2021-22,Regular%20Season
1627734,Domantas Sabonis,1610612758,SAC,62,21,41,2136.0,201,137,64,0.682,457,0.44,13,0.453,4.9,551,142,406,0.258,813,0.678,57,0.729,4.2,752,279,470,0.371,1231,0.611,70,0.648,4.4,2021-22,Regular%20Season
1628378,Donovan Mitchell,1610612762,UTA,64,39,25,2165.0,55,22,32,0.4,129,0.426,3,0.437,12.0,227,41,186,0.181,345,0.658,19,0.696,9.2,282,63,218,0.223,467,0.604,22,0.634,9.7,2021-22,Regular%20Season
1628978,Donte DiVincenzo,1610612758,SAC,41,21,20,994.0,40,20,20,0.5,87,0.46,2,0.471,9.2,130,18,112,0.138,232,0.56,23,0.622,6.7,170,38,132,0.224,313,0.543,25,0.59,7.3,2021-22,Regular%20Season
1627827,Dorian Finney-Smith,1610612742,DAL,80,51,29,2644.0,122,64,58,0.525,262,0.466,8,0.48,9.2,253,61,190,0.241,473,0.535,55,0.605,6.3,375,125,248,0.333,707,0.53,63,0.582,7.2,2021-22,Regular%20Season
203926,Doug McDermott,1610612759,SAS,43,17,26,1054.0,18,10,8,0.556,49,0.367,3,0.391,7.6,97,21,76,0.216,155,0.626,13,0.683,7.5,115,31,84,0.27,201,0.572,16,0.622,7.5,2021-22,Regular%20Season
203110,Draymond Green,1610612744,GSW,45,33,12,1329.0,45,21,23,0.467,131,0.344,4,0.354,9.6,291,85,205,0.292,452,0.644,46,0.717,5.1,336,106,228,0.315,550,0.611,50,0.672,5.7,2021-22,Regular%20Season
1629234,Drew Eubanks,1610612757,POR,66,17,49,1223.0,130,78,51,0.6,277,0.469,5,0.478,5.5,252,71,181,0.282,404,0.624,28,0.67,3.9,382,149,232,0.39,653,0.585,33,0.616,4.5,2021-22,Regular%20Season
1630613,Duane Washington Jr.,1610612754,IND,33,7,26,758.0,4,2,3,0.5,30,0.133,1,0.138,15.8,79,17,62,0.215,138,0.572,13,0.632,8.0,83,19,65,0.229,166,0.5,14,0.546,8.5,2021-22,Regular%20Season
1629130,Duncan Robinson,1610612748,MIA,69,46,23,1849.0,24,6,18,0.25,53,0.453,0,0.453,17.1,179,23,156,0.128,313,0.572,33,0.639,8.1,203,29,174,0.143,359,0.565,33,0.623,9.1,2021-22,Regular%20Season
2730,Dwight Howard,1610612747,LAL,60,21,39,971.0,118,85,33,0.72,279,0.423,9,0.437,5.0,238,71,165,0.298,359,0.663,27,0.717,4.2,356,156,198,0.438,615,0.579,36,0.615,4.4,2021-22,Regular%20Season
203939,Dwight Powell,1610612742,DAL,82,52,30,1798.0,173,94,81,0.543,413,0.419,11,0.43,6.1,231,64,167,0.277,435,0.531,36,0.579,5.8,404,158,248,0.391,826,0.489,47,0.519,6.0,2021-22,Regular%20Season
1629685,Dylan Windler,1610612739,CLE,31,17,14,386.0,21,10,11,0.476,39,0.538,0,0.538,9.2,68,17,51,0.25,110,0.618,12,0.694,5.3,89,27,62,0.303,145,0.614,12,0.669,6.2,2021-22,Regular%20Season
202334,Ed Davis,1610612739,CLE,18,9,9,161.0,14,4,10,0.286,41,0.341,2,0.359,6.5,50,8,42,0.16,75,0.667,5,0.714,5.8,64,12,52,0.188,113,0.566,7,0.604,5.9,2021-22,Regular%20Season
203901,Elfrid Payton,1610612756,PHX,38,30,8,468.0,21,10,11,0.476,42,0.5,0,0.5,8.9,65,15,50,0.231,95,0.684,5,0.722,7.1,86,25,61,0.291,136,0.632,5,0.656,7.5,2021-22,Regular%20Season
1630190,Elijah Hughes,1610612757,POR,24,8,16,379.0,6,1,5,0.167,12,0.5,0,0.5,9.0,52,10,42,0.192,87,0.598,11,0.684,6.9,58,11,47,0.19,95,0.611,11,0.69,7.1,2021-22,Regular%20Season
1629150,Emanuel Terry,1610612756,PHX,3,2,1,18.0,8,6,1,0.75,13,0.615,0,0.615,2.8,7,4,3,0.571,7,1.0,0,1.0,4.4,15,10,4,0.667,20,0.75,0,0.75,3.6,2021-22,Regular%20Season
202683,Enes Freedom,1610612738,BOS,32,19,13,395.0,61,49,12,0.803,142,0.43,6,0.449,4.2,96,24,73,0.25,150,0.64,14,0.706,5.0,157,73,85,0.465,282,0.557,20,0.599,4.7,2021-22,Regular%20Season
202339,Eric Bledsoe,1610612757,POR,50,26,24,1260.0,28,9,18,0.321,58,0.483,3,0.509,12.3,149,24,124,0.161,234,0.637,25,0.713,8.8,177,33,142,0.186,291,0.608,28,0.673,9.4,2021-22,Regular%20Season
201569,Eric Gordon,1610612745,HOU,48,16,32,1413.0,15,4,11,0.267,56,0.268,1,0.273,14.3,98,12,85,0.122,166,0.59,14,0.645,10.4,113,16,96,0.142,208,0.543,15,0.585,10.9,2021-22,Regular%20Season
1629672,Eric Paschall,1610612762,UTA,46,28,18,663.0,30,19,12,0.633,79,0.38,1,0.385,7.0,76,16,60,0.211,130,0.585,17,0.673,6.8,106,35,72,0.33,198,0.535,18,0.589,6.8,2021-22,Regular%20Season
1630647,Eugene Omoruyi,1610612742,DAL,4,1,3,18.0,2,1,1,0.5,4,0.5,0,0.5,7.8,5,0,5,0.0,5,1.0,0,1.0,6.7,7,1,6,0.143,8,0.875,0,0.875,7.0,2021-22,Regular%20Season
203095,Evan Fournier,1610612752,NYK,71,33,38,2120.0,33,8,25,0.242,76,0.434,5,0.465,15.5,169,41,127,0.243,289,0.585,27,0.645,9.7,202,49,152,0.243,361,0.56,32,0.614,10.7,2021-22,Regular%20Season
1630596,Evan Mobley,1610612739,CLE,69,40,29,2331.0,143,95,49,0.664,310,0.461,7,0.472,6.6,427,114,310,0.267,726,0.588,73,0.654,4.9,570,209,359,0.367,1007,0.566,80,0.615,5.3,2021-22,Regular%20Season
1630267,Facundo Campazzo,1610612743,DEN,47,26,21,1042.0,23,6,17,0.261,49,0.469,0,0.469,19.0,94,11,82,0.117,160,0.588,11,0.631,9.3,117,17,99,0.145,205,0.571,11,0.603,11.3,2021-22,Regular%20Season
1630624,Feron Hunt,1610612752,NYK,1,1,0,7.0,1,0,1,0.0,3,0.333,1,0.5,5.2,0,0,0,0.0,1,0.0,1,0.0,0.0,1,0,1,0.0,4,0.25,2,0.5,5.2,2021-22,Regular%20Season
1628402,Frank Jackson,1610612765,DET,43,7,36,1001.0,19,3,16,0.158,52,0.365,3,0.388,16.6,68,19,49,0.279,136,0.5,18,0.576,8.4,87,22,65,0.253,184,0.473,21,0.534,10.2,2021-22,Regular%20Season
1626163,Frank Kaminsky,1610612756,PHX,8,7,1,175.0,11,6,5,0.545,23,0.478,0,0.478,6.6,30,10,20,0.333,66,0.455,10,0.536,3.7,41,16,25,0.39,88,0.466,10,0.526,4.5,2021-22,Regular%20Season
1628373,Frank Ntilikina,1610612742,DAL,38,20,18,584.0,12,5,7,0.417,28,0.429,4,0.5,17.1,67,9,58,0.134,106,0.632,7,0.677,9.7,79,14,65,0.177,130,0.608,11,0.664,10.8,2021-22,Regular%20Season
1630532,Franz Wagner,1610612753,ORL,75,19,56,2371.0,84,33,50,0.393,219,0.384,7,0.396,10.6,272,57,213,0.21,418,0.651,28,0.697,8.1,356,90,263,0.253,625,0.57,35,0.603,8.7,2021-22,Regular%20Season
1627832,Fred VanVleet,1610612761,TOR,63,37,26,2393.0,44,15,29,0.341,129,0.341,3,0.349,13.3,245,28,215,0.114,429,0.571,36,0.623,9.5,289,43,244,0.149,554,0.522,39,0.561,10.1,2021-22,Regular%20Season
1630273,Freddie Gillespie,1610612753,ORL,9,1,8,119.0,13,8,5,0.615,38,0.342,0,0.342,3.8,23,10,13,0.435,42,0.548,1,0.561,5.7,36,18,18,0.5,79,0.456,1,0.462,5.0,2021-22,Regular%20Season
1627788,Furkan Korkmaz,1610612755,PHI,54,35,19,1245.0,22,6,16,0.273,69,0.319,3,0.333,16.1,153,17,135,0.111,240,0.638,20,0.695,9.2,175,23,151,0.131,296,0.591,23,0.641,10.0,2021-22,Regular%20Season
1629216,Gabe Vincent,1610612748,MIA,55,36,19,1412.0,22,8,14,0.364,65,0.338,3,0.355,16.0,104,18,87,0.173,199,0.523,21,0.584,9.5,126,26,101,0.206,261,0.483,24,0.532,10.6,2021-22,Regular%20Season
1628221,Gabe York,1610612754,IND,2,0,2,21.0,0,0,0,0.0,0,0.0,0,0.0,0.0,2,1,1,0.5,3,0.667,0,0.667,9.2,2,1,1,0.5,3,0.667,0,0.667,9.2,2021-22,Regular%20Season
1630466,Gabriel Deck,1610612760,OKC,5,2,3,45.0,1,1,0,1.0,2,0.5,0,0.5,4.4,5,3,2,0.6,6,0.833,0,0.833,2.3,6,4,2,0.667,8,0.75,0,0.75,2.7,2021-22,Regular%20Season
1630994,Gabriel Lundberg,1610612756,PHX,2,0,2,39.0,2,1,1,0.5,6,0.333,2,0.5,9.3,5,0,5,0.0,8,0.625,2,0.833,5.7,7,1,6,0.143,14,0.5,4,0.7,6.7,2021-22,Regular%20Season
202066,Garrett Temple,1610612740,NOP,49,17,32,971.0,29,14,16,0.483,78,0.372,3,0.387,13.0,112,17,94,0.152,197,0.569,21,0.636,8.5,141,31,110,0.22,262,0.538,24,0.592,9.4,2021-22,Regular%20Season
1629726,Garrison Mathews,1610612745,HOU,60,19,41,1595.0,32,10,22,0.313,82,0.39,2,0.4,14.5,158,35,122,0.222,271,0.583,19,0.627,7.7,190,45,144,0.237,341,0.557,21,0.594,8.8,2021-22,Regular%20Season
1629109,Gary Clark,1610612740,NOP,29,14,15,332.0,23,15,8,0.652,43,0.535,0,0.535,8.8,60,15,45,0.25,88,0.682,4,0.714,6.3,83,30,53,0.361,125,0.664,4,0.686,7.0,2021-22,Regular%20Season
203914,Gary Harris,1610612753,ORL,51,14,37,1483.0,36,8,28,0.222,76,0.474,0,0.474,11.6,86,7,79,0.081,150,0.573,16,0.642,10.0,122,15,107,0.123,225,0.542,16,0.584,10.5,2021-22,Regular%20Season
1627780,Gary Payton II,1610612744,GSW,64,42,22,1184.0,72,47,25,0.653,177,0.407,6,0.421,5.9,174,40,132,0.23,292,0.596,28,0.659,6.0,246,87,157,0.354,452,0.544,34,0.589,6.0,2021-22,Regular%20Season
1629018,Gary Trent Jr.,1610612761,TOR,65,40,25,2295.0,26,11,15,0.423,88,0.295,3,0.306,12.8,165,22,142,0.133,261,0.632,22,0.69,8.5,191,33,157,0.173,346,0.552,25,0.595,9.1,2021-22,Regular%20Season
201588,George Hill,1610612749,MIL,50,34,16,1191.0,38,17,21,0.447,91,0.418,4,0.437,10.2,117,18,99,0.154,203,0.576,14,0.619,8.3,155,35,120,0.226,292,0.531,18,0.566,8.8,2021-22,Regular%20Season
1628994,George King,1610612742,DAL,3,1,2,17.0,0,0,0,0.0,2,0.0,0,0.0,0.0,5,3,2,0.6,8,0.625,0,0.625,4.2,5,3,2,0.6,9,0.556,0,0.556,4.2,2021-22,Regular%20Season
1627777,Georges Niang,1610612755,PHI,65,42,23,1553.0,25,12,13,0.48,79,0.316,3,0.329,10.0,178,31,146,0.174,321,0.555,31,0.614,7.4,203,43,159,0.212,382,0.531,34,0.583,7.7,2021-22,Regular%20Season
1630686,Georgios Kalaitzakis,1610612760,OKC,7,3,4,198.0,6,5,1,0.833,14,0.429,2,0.5,7.7,15,1,14,0.067,30,0.5,6,0.625,7.6,21,6,15,0.286,42,0.5,8,0.618,7.6,2021-22,Regular%20Season
203507,Giannis Antetokounmpo,1610612749,MIL,67,45,22,2204.0,134,88,46,0.657,323,0.415,5,0.421,6.3,644,149,493,0.231,928,0.694,80,0.759,4.7,778,237,539,0.305,1200,0.648,85,0.698,5.0,2021-22,Regular%20Season
1629048,Goga Bitadze,1610612754,IND,45,16,29,712.0,79,65,15,0.823,181,0.436,5,0.449,4.1,98,25,73,0.255,203,0.483,24,0.547,5.0,177,90,88,0.508,374,0.473,29,0.513,4.6,2021-22,Regular%20Season
201609,Goran Dragic,1610612751,BKN,21,10,11,497.0,13,5,9,0.385,31,0.419,1,0.433,11.4,52,11,41,0.212,80,0.65,10,0.743,9.2,65,16,50,0.246,110,0.591,11,0.657,9.7,2021-22,Regular%20Season
202330,Gordon Hayward,1610612766,CHA,48,26,22,1529.0,38,22,16,0.579,132,0.288,6,0.302,9.3,184,31,153,0.168,302,0.609,27,0.669,7.6,222,53,169,0.239,413,0.538,33,0.584,7.9,2021-22,Regular%20Season
203476,Gorgui Dieng,1610612737,ATL,34,15,19,337.0,32,21,11,0.656,54,0.593,4,0.64,6.7,89,24,65,0.27,134,0.664,13,0.736,5.0,121,45,76,0.372,180,0.672,17,0.742,5.5,2021-22,Regular%20Season
1629684,Grant Williams,1610612738,BOS,74,49,25,1822.0,64,35,29,0.547,202,0.317,9,0.332,7.6,210,57,153,0.271,393,0.534,38,0.592,5.8,274,92,182,0.336,580,0.472,47,0.514,6.3,2021-22,Regular%20Season
1628960,Grayson Allen,1610612749,MIL,65,42,23,1782.0,32,11,20,0.344,90,0.356,5,0.376,12.7,190,24,165,0.126,309,0.615,25,0.669,8.1,222,35,185,0.158,399,0.556,30,0.602,8.7,2021-22,Regular%20Season
1630535,Greg Brown III,1610612757,POR,40,12,28,617.0,38,18,21,0.474,89,0.427,0,0.427,8.1,97,26,71,0.268,154,0.63,9,0.669,5.2,135,44,92,0.326,234,0.577,9,0.6,6.1,2021-22,Regular%20Season
202328,Greg Monroe,1610612750,MIN,14,7,7,195.0,30,21,9,0.7,62,0.484,1,0.492,4.9,34,12,22,0.353,65,0.523,8,0.596,6.5,64,33,31,0.516,122,0.525,9,0.566,5.8,2021-22,Regular%20Season
1628977,Hamidou Diallo,1610612765,DET,55,14,41,1215.0,67,36,31,0.537,143,0.469,3,0.479,7.2,204,32,172,0.157,300,0.68,29,0.753,5.9,271,68,203,0.251,421,0.644,32,0.697,6.2,2021-22,Regular%20Season
203084,Harrison Barnes,1610612758,SAC,76,26,50,2550.0,82,41,39,0.5,216,0.38,5,0.389,8.5,340,74,264,0.218,546,0.623,50,0.685,6.5,422,115,303,0.273,737,0.573,55,0.619,6.9,2021-22,Regular%20Season
202355,Hassan Whiteside,1610612762,UTA,65,40,25,1162.0,166,135,30,0.813,349,0.476,10,0.49,4.3,328,98,230,0.299,513,0.639,41,0.695,4.1,494,233,260,0.472,836,0.591,51,0.629,4.2,2021-22,Regular%20Season
1629755,Hassani Gravett,1610612753,ORL,6,2,4,141.0,1,0,1,0.0,5,0.2,0,0.2,23.1,20,4,16,0.2,37,0.541,3,0.588,8.4,21,4,17,0.19,42,0.5,3,0.538,9.1,2021-22,Regular%20Season
1629312,Haywood Highsmith,1610612748,MIA,13,8,5,143.0,10,8,2,0.8,22,0.455,0,0.455,4.0,16,4,12,0.25,27,0.593,2,0.64,6.3,26,12,14,0.462,48,0.542,2,0.565,5.5,2021-22,Regular%20Season
1630529,Herbert Jones,1610612740,NOP,74,33,41,2236.0,97,38,58,0.392,223,0.435,6,0.447,10.0,193,50,143,0.259,345,0.559,42,0.637,8.4,290,88,201,0.303,549,0.528,48,0.579,9.0,2021-22,Regular%20Season
1629649,Ignas Brazdeikis,1610612753,ORL,31,5,26,479.0,23,11,12,0.478,47,0.489,3,0.523,8.1,49,12,37,0.245,87,0.563,5,0.598,6.7,72,23,49,0.319,130,0.554,8,0.59,7.1,2021-22,Regular%20Season
1630193,Immanuel Quickley,1610612752,NYK,67,28,39,1641.0,31,9,22,0.29,77,0.403,0,0.403,13.0,214,18,195,0.084,329,0.65,16,0.684,8.0,245,27,217,0.11,401,0.611,16,0.636,8.6,2021-22,Regular%20Season
1629067,Isaac Bonga,1610612761,TOR,6,4,2,27.0,4,2,2,0.5,7,0.571,0,0.571,3.4,3,0,3,0.0,11,0.273,2,0.333,7.7,7,2,5,0.286,17,0.412,2,0.467,5.2,2021-22,Regular%20Season
1630171,Isaac Okoro,1610612739,CLE,65,33,32,1927.0,72,30,41,0.417,171,0.421,8,0.442,10.2,129,30,100,0.233,241,0.535,19,0.581,10.6,201,60,141,0.299,411,0.489,27,0.523,10.4,2021-22,Regular%20Season
1628392,Isaiah Hartenstein,1610612746,LAC,65,35,30,1181.0,117,82,33,0.701,262,0.447,7,0.459,5.3,215,74,140,0.344,388,0.554,39,0.616,5.1,332,156,173,0.47,630,0.527,46,0.568,5.1,2021-22,Regular%20Season
1630543,Isaiah Jackson,1610612754,IND,32,7,25,535.0,60,44,16,0.733,118,0.508,5,0.531,3.4,89,37,53,0.416,182,0.489,21,0.553,3.8,149,81,69,0.544,294,0.507,26,0.556,3.6,2021-22,Regular%20Season
1630198,Isaiah Joe,1610612755,PHI,31,22,9,468.0,6,0,6,0.0,11,0.545,0,0.545,22.5,50,5,45,0.1,103,0.485,14,0.562,6.8,56,5,51,0.089,113,0.496,14,0.566,8.4,2021-22,Regular%20Season
1630587,Isaiah Livers,1610612765,DET,17,7,10,374.0,15,8,7,0.533,33,0.455,1,0.469,11.5,42,10,32,0.238,73,0.575,8,0.646,7.5,57,18,39,0.316,99,0.576,9,0.633,8.5,2021-22,Regular%20Season
1629676,Isaiah Roby,1610612760,OKC,42,10,32,922.0,75,51,23,0.68,165,0.455,2,0.46,6.5,142,40,103,0.282,256,0.555,23,0.609,5.0,217,91,126,0.419,411,0.528,25,0.562,5.5,2021-22,Regular%20Season
1630191,Isaiah Stewart,1610612765,DET,70,21,49,1795.0,222,158,63,0.712,549,0.404,20,0.42,4.3,387,92,293,0.238,647,0.598,72,0.673,4.3,609,250,356,0.411,1156,0.527,92,0.572,4.3,2021-22,Regular%20Season
202738,Isaiah Thomas,1610612766,CHA,17,9,8,275.0,4,2,2,0.5,15,0.267,1,0.286,8.5,25,1,24,0.04,41,0.61,2,0.641,10.8,29,3,26,0.103,55,0.527,3,0.558,10.5,2021-22,Regular%20Season
1630225,Isaiah Todd,1610612764,WAS,8,1,7,64.0,3,0,3,0.0,9,0.333,0,0.333,15.5,9,0,9,0.0,15,0.6,1,0.643,7.0,12,0,12,0.0,22,0.545,1,0.571,9.1,2021-22,Regular%20Season
202397,Ish Smith,1610612764,WAS,51,20,31,968.0,25,10,14,0.4,52,0.481,4,0.521,9.2,114,16,96,0.14,197,0.579,17,0.633,8.8,139,26,110,0.187,248,0.56,21,0.612,8.9,2021-22,Regular%20Season
1630688,Ish Wainright,1610612756,PHX,21,16,5,245.0,26,15,11,0.577,44,0.591,1,0.605,8.1,27,9,18,0.333,55,0.491,5,0.54,6.8,53,24,29,0.453,92,0.576,6,0.616,7.4,2021-22,Regular%20Season
1627826,Ivica Zubac,1610612746,LAC,75,39,36,1842.0,217,169,45,0.779,503,0.431,8,0.438,3.7,427,163,263,0.382,700,0.61,70,0.678,4.2,644,332,308,0.516,1171,0.55,78,0.589,4.0,2021-22,Regular%20Season
1630550,JT Thor,1610612766,CHA,21,12,9,224.0,11,1,10,0.091,28,0.393,1,0.407,10.1,32,6,26,0.188,50,0.64,3,0.681,6.8,43,7,36,0.163,72,0.597,4,0.632,7.7,2021-22,Regular%20Season
1629630,Ja Morant,1610612763,MEM,55,35,20,1838.0,74,40,34,0.541,200,0.37,9,0.387,9.5,242,30,211,0.124,354,0.684,35,0.759,7.6,316,70,245,0.222,548,0.577,44,0.627,8.0,2021-22,Regular%20Season
203210,JaMychal Green,1610612743,DEN,67,36,31,1085.0,81,58,24,0.716,200,0.405,3,0.411,5.3,200,52,145,0.26,294,0.68,23,0.738,5.1,281,110,169,0.391,478,0.588,26,0.622,5.2,2021-22,Regular%20Season
201580,JaVale McGee,1610612756,PHX,74,57,17,1172.0,163,128,35,0.785,333,0.489,5,0.497,4.4,333,116,216,0.348,509,0.654,44,0.716,3.6,496,244,251,0.492,811,0.612,49,0.651,3.8,2021-22,Regular%20Season
203953,Jabari Parker,1610612738,BOS,8,2,6,93.0,5,2,3,0.4,13,0.385,0,0.385,4.9,23,6,17,0.261,38,0.605,3,0.657,7.7,28,8,20,0.286,48,0.583,3,0.622,7.2,2021-22,Regular%20Season
1630183,Jaden McDaniels,1610612750,MIN,69,40,29,1785.0,76,32,43,0.421,188,0.404,4,0.413,9.3,217,50,168,0.23,385,0.564,35,0.62,6.4,293,82,211,0.28,544,0.539,39,0.58,7.1,2021-22,Regular%20Season
1630531,Jaden Springer,1610612755,PHI,1,1,0,4.0,1,1,0,1.0,1,1.0,0,1.0,3.6,1,0,1,0.0,1,1.0,0,1.0,16.0,2,1,1,0.5,2,1.0,0,1.0,9.8,2021-22,Regular%20Season
203109,Jae Crowder,1610612756,PHX,65,52,13,1839.0,30,15,15,0.5,92,0.326,3,0.337,11.0,324,71,254,0.219,492,0.659,41,0.718,5.6,354,86,269,0.243,557,0.636,44,0.69,6.1,2021-22,Regular%20Season
1630256,Jae'Sean Tate,1610612745,HOU,77,19,58,2045.0,135,86,48,0.637,310,0.435,6,0.444,7.3,285,71,213,0.249,495,0.576,51,0.642,6.5,420,157,261,0.374,788,0.533,57,0.575,6.8,2021-22,Regular%20Season
1630186,Jahmi'us Ramsey,1610612758,SAC,6,1,5,69.0,4,1,3,0.25,6,0.667,1,0.8,10.2,9,1,8,0.111,13,0.692,0,0.692,11.3,13,2,11,0.154,19,0.684,1,0.722,11.0,2021-22,Regular%20Season
1627774,Jake Layman,1610612750,MIN,16,5,11,164.0,6,4,2,0.667,17,0.353,3,0.429,4.7,30,7,23,0.233,43,0.698,6,0.811,6.4,36,11,25,0.306,57,0.632,9,0.75,6.1,2021-22,Regular%20Season
1627751,Jakob Poeltl,1610612759,SAS,68,30,38,1970.0,262,195,65,0.744,488,0.537,8,0.546,5.0,372,169,201,0.454,712,0.522,78,0.587,4.4,634,364,266,0.574,1184,0.535,86,0.577,4.6,2021-22,Regular%20Season
1628973,Jalen Brunson,1610612742,DAL,77,48,29,2472.0,43,14,27,0.326,131,0.328,16,0.374,15.1,266,33,233,0.124,456,0.583,55,0.663,8.2,309,47,260,0.152,580,0.533,71,0.607,9.1,2021-22,Regular%20Season
1630224,Jalen Green,1610612745,HOU,65,12,53,2077.0,33,16,16,0.485,120,0.275,5,0.287,10.6,193,25,169,0.13,327,0.59,29,0.648,6.8,226,41,185,0.181,445,0.508,34,0.55,7.4,2021-22,Regular%20Season
1630552,Jalen Johnson,1610612737,ATL,12,9,3,92.0,2,1,1,0.5,7,0.286,0,0.286,14.3,24,7,17,0.292,37,0.649,0,0.649,3.5,26,8,18,0.308,41,0.634,0,0.634,4.3,2021-22,Regular%20Season
1629667,Jalen McDaniels,1610612766,CHA,47,30,17,829.0,36,16,20,0.444,82,0.439,4,0.462,11.1,131,31,100,0.237,223,0.587,18,0.639,5.4,167,47,120,0.281,300,0.557,22,0.601,6.6,2021-22,Regular%20Season
1630188,Jalen Smith,1610612754,IND,46,25,21,881.0,93,68,25,0.731,204,0.456,4,0.465,4.9,200,41,157,0.205,328,0.61,28,0.667,4.2,293,109,182,0.372,516,0.568,32,0.605,4.5,2021-22,Regular%20Season
1630591,Jalen Suggs,1610612753,ORL,46,14,32,1273.0,26,17,9,0.654,105,0.248,2,0.252,10.3,144,26,117,0.181,265,0.543,39,0.637,6.6,170,43,126,0.253,365,0.466,41,0.525,7.2,2021-22,Regular%20Season
1630547,James Bouknight,1610612766,CHA,21,9,12,276.0,22,10,12,0.455,48,0.458,1,0.468,7.3,30,6,24,0.2,61,0.492,9,0.577,6.9,52,16,36,0.308,105,0.495,10,0.547,7.1,2021-22,Regular%20Season
203516,James Ennis III,1610612743,DEN,5,3,2,48.0,5,4,1,0.8,12,0.417,0,0.417,5.5,7,2,5,0.286,12,0.583,2,0.7,5.5,12,6,6,0.5,23,0.522,2,0.571,5.5,2021-22,Regular%20Season
201935,James Harden,1610612755,PHI,65,40,25,2420.0,55,29,27,0.527,232,0.237,5,0.242,10.2,445,57,386,0.128,670,0.664,57,0.726,6.7,500,86,413,0.172,853,0.586,62,0.632,7.1,2021-22,Regular%20Season
201949,James Johnson,1610612751,BKN,58,28,30,1144.0,51,33,18,0.647,117,0.436,3,0.447,6.8,164,46,118,0.28,281,0.584,27,0.646,6.3,215,79,136,0.367,390,0.551,30,0.597,6.4,2021-22,Regular%20Season
1630691,Jamorko Pickett,1610612765,DET,9,3,6,163.0,6,3,3,0.5,14,0.429,1,0.462,11.6,26,7,18,0.269,43,0.605,3,0.65,5.4,32,10,21,0.313,56,0.571,4,0.615,6.6,2021-22,Regular%20Season
1630215,Jared Butler,1610612762,UTA,20,13,7,262.0,5,2,3,0.4,12,0.417,0,0.417,7.2,40,10,30,0.25,53,0.755,3,0.8,10.0,45,12,33,0.267,64,0.703,3,0.738,9.7,2021-22,Regular%20Season
1629607,Jared Harper,1610612740,NOP,2,1,1,28.0,2,0,2,0.0,2,1.0,0,1.0,17.5,0,0,0,0.0,1,0.0,0,0.0,0.0,2,0,2,0.0,3,0.667,0,0.667,17.5,2021-22,Regular%20Season
1628991,Jaren Jackson Jr.,1610612763,MEM,77,52,25,2100.0,117,68,48,0.581,295,0.397,18,0.422,7.9,331,103,227,0.311,568,0.583,50,0.639,5.8,448,171,275,0.382,845,0.53,68,0.577,6.4,2021-22,Regular%20Season
1629020,Jarred Vanderbilt,1610612750,MIN,72,41,31,1861.0,215,147,67,0.684,462,0.465,17,0.483,4.9,409,91,318,0.222,587,0.697,46,0.756,4.9,624,238,385,0.381,1008,0.619,63,0.66,4.9,2021-22,Regular%20Season
1628386,Jarrett Allen,1610612739,CLE,56,35,21,1810.0,192,137,54,0.714,398,0.482,15,0.501,5.7,410,134,275,0.327,644,0.637,51,0.691,4.5,602,271,329,0.45,1008,0.597,66,0.639,4.9,2021-22,Regular%20Season
1629633,Jarrett Culver,1610612763,MEM,22,16,6,271.0,13,10,3,0.769,30,0.433,1,0.448,6.8,34,5,30,0.147,54,0.63,4,0.68,8.4,47,15,33,0.319,80,0.588,5,0.627,7.9,2021-22,Regular%20Season
1629600,Jarron Cumberland,1610612757,POR,1,0,1,6.0,1,0,1,0.0,1,1.0,0,1.0,9.6,2,1,1,0.5,5,0.4,1,0.5,5.1,3,1,2,0.333,6,0.5,1,0.6,6.6,2021-22,Regular%20Season
1629602,Javin DeLaurier,1610612749,MIL,1,1,0,3.0,0,0,0,0.0,0,0.0,0,0.0,0.0,1,0,1,0.0,2,0.5,0,0.5,7.6,1,0,1,0.0,2,0.5,0,0.5,7.6,2021-22,Regular%20Season
1629750,Javonte Green,1610612741,CHI,64,37,27,1502.0,91,59,32,0.648,188,0.484,5,0.497,6.3,185,37,148,0.2,304,0.609,28,0.67,6.1,276,96,180,0.348,475,0.581,33,0.624,6.2,2021-22,Regular%20Season
1630606,Javonte Smart,1610612748,MIA,9,4,5,169.0,5,3,2,0.6,10,0.5,1,0.556,9.6,18,4,14,0.222,26,0.692,2,0.75,8.6,23,7,16,0.304,36,0.639,3,0.697,8.8,2021-22,Regular%20Season
1629637,Jaxson Hayes,1610612740,NOP,67,28,39,1374.0,114,65,49,0.57,210,0.543,11,0.573,6.9,199,57,143,0.286,321,0.62,33,0.691,5.5,313,122,192,0.39,520,0.602,44,0.658,6.0,2021-22,Regular%20Season
1630643,Jay Huff,1610612747,LAL,3,0,3,15.0,1,0,1,0.0,1,1.0,0,1.0,5.0,3,0,3,0.0,8,0.375,0,0.375,8.3,4,0,4,0.0,9,0.444,0,0.444,7.4,2021-22,Regular%20Season
1630206,Jay Scrubb,1610612746,LAC,9,4,5,95.0,2,1,0,0.5,4,0.5,0,0.5,2.0,14,0,14,0.0,19,0.737,1,0.778,8.5,16,1,14,0.063,23,0.696,1,0.727,8.1,2021-22,Regular%20Season
1627759,Jaylen Brown,1610612738,BOS,65,43,22,2186.0,53,25,28,0.472,193,0.275,4,0.28,10.6,344,73,271,0.212,531,0.648,54,0.721,6.3,397,98,299,0.247,700,0.567,58,0.618,6.9,2021-22,Regular%20Season
1629658,Jaylen Hoard,1610612760,OKC,7,2,5,240.0,30,16,14,0.533,55,0.545,0,0.545,5.9,54,11,43,0.204,85,0.635,9,0.711,3.7,84,27,57,0.321,137,0.613,9,0.656,4.5,2021-22,Regular%20Season
1628537,Jaylen Morris,1610612759,SAS,1,0,1,6.0,0,0,0,0.0,1,0.0,0,0.0,0.0,2,0,2,0.0,2,1.0,0,1.0,9.9,2,0,2,0.0,2,1.0,0,1.0,9.9,2021-22,Regular%20Season
1629669,Jaylen Nowell,1610612750,MIN,50,33,17,859.0,22,6,16,0.273,54,0.407,2,0.423,10.4,101,20,81,0.198,169,0.598,10,0.635,7.8,123,26,97,0.211,221,0.557,12,0.589,8.2,2021-22,Regular%20Season
1629873,Jaysean Paige,1610612765,DET,1,1,0,7.0,0,0,0,0.0,1,0.0,0,0.0,0.0,1,0,1,0.0,1,1.0,0,1.0,7.1,1,0,1,0.0,2,0.5,0,0.5,7.1,2021-22,Regular%20Season
1628369,Jayson Tatum,1610612738,BOS,75,49,26,2691.0,84,40,45,0.476,208,0.404,8,0.42,11.2,519,92,427,0.177,713,0.728,45,0.777,5.9,603,132,472,0.219,895,0.674,53,0.716,6.6,2021-22,Regular%20Season
1630288,Jeff Dowtin Jr.,1610612753,ORL,6,2,4,91.0,8,2,6,0.25,10,0.8,0,0.8,11.9,10,2,8,0.2,12,0.833,0,0.833,10.2,18,4,14,0.222,21,0.857,0,0.857,11.0,2021-22,Regular%20Season
201145,Jeff Green,1610612743,DEN,72,42,30,1795.0,41,27,15,0.659,114,0.36,4,0.373,6.6,188,41,147,0.218,295,0.637,26,0.699,7.0,229,68,162,0.297,394,0.581,30,0.629,6.9,2021-22,Regular%20Season
1629203,Jemerrio Jones,1610612747,LAL,2,0,2,15.0,2,1,1,0.5,4,0.5,0,0.5,1.2,1,0,1,0.0,5,0.2,0,0.2,4.1,3,1,2,0.333,9,0.333,0,0.333,2.2,2021-22,Regular%20Season
203924,Jerami Grant,1610612765,DET,47,11,36,1500.0,28,14,13,0.5,98,0.286,7,0.308,12.8,163,23,141,0.141,271,0.601,22,0.655,7.6,191,37,154,0.194,356,0.537,29,0.584,8.4,2021-22,Regular%20Season
1630526,Jeremiah Robinson-Earl,1610612760,OKC,48,14,34,1077.0,75,49,26,0.653,165,0.455,3,0.463,7.2,199,69,130,0.347,321,0.62,29,0.682,5.4,274,118,156,0.431,475,0.577,32,0.619,5.9,2021-22,Regular%20Season
203087,Jeremy Lamb,1610612758,SAC,48,20,28,836.0,26,8,18,0.308,54,0.481,1,0.491,9.2,128,30,97,0.234,194,0.66,17,0.723,5.5,154,38,115,0.247,238,0.647,18,0.7,6.1,2021-22,Regular%20Season
1630579,Jericho Sims,1610612752,NYK,32,16,16,531.0,61,45,16,0.738,135,0.452,5,0.469,5.6,108,42,66,0.389,179,0.603,16,0.663,4.4,169,87,82,0.515,307,0.55,21,0.591,4.8,2021-22,Regular%20Season
1628975,Jevon Carter,1610612749,MIL,51,31,20,806.0,14,1,13,0.071,29,0.483,1,0.5,16.5,96,11,84,0.115,147,0.653,10,0.701,9.6,110,12,97,0.109,175,0.629,11,0.671,10.5,2021-22,Regular%20Season
202710,Jimmy Butler,1610612748,MIA,56,38,18,1919.0,102,69,34,0.676,213,0.479,5,0.49,7.0,234,56,177,0.239,373,0.627,27,0.676,6.8,336,125,211,0.372,583,0.576,32,0.61,6.8,2021-22,Regular%20Season
1629111,Jock Landale,1610612759,SAS,41,18,23,550.0,63,47,16,0.746,131,0.481,2,0.488,4.6,75,31,44,0.413,154,0.487,19,0.556,5.0,138,78,60,0.565,280,0.493,21,0.533,4.8,2021-22,Regular%20Season
203925,Joe Harris,1610612751,BKN,14,10,4,423.0,5,2,3,0.4,14,0.357,0,0.357,13.7,51,12,39,0.235,81,0.63,4,0.662,7.7,56,14,42,0.25,95,0.589,4,0.615,8.2,2021-22,Regular%20Season
204060,Joe Ingles,1610612757,POR,43,27,16,1091.0,12,3,9,0.25,31,0.387,0,0.387,19.1,119,20,100,0.168,176,0.676,15,0.739,9.1,131,23,109,0.176,206,0.636,15,0.686,10.0,2021-22,Regular%20Season
1630580,Joe Wieskamp,1610612759,SAS,11,5,6,119.0,4,2,2,0.5,7,0.571,0,0.571,10.6,10,4,6,0.4,16,0.625,1,0.667,7.6,14,6,8,0.429,21,0.667,1,0.7,8.5,2021-22,Regular%20Season
1630555,Joel Ayayi,1610612764,WAS,3,0,3,9.0,1,0,1,0.0,3,0.333,0,0.333,11.7,2,0,2,0.0,2,1.0,0,1.0,8.2,3,0,3,0.0,5,0.6,0,0.6,9.4,2021-22,Regular%20Season
203954,Joel Embiid,1610612755,PHI,68,45,23,2296.0,146,110,33,0.753,350,0.417,9,0.428,4.7,650,215,434,0.331,1002,0.649,96,0.717,4.5,796,325,467,0.408,1320,0.603,105,0.655,4.5,2021-22,Regular%20Season
1628381,John Collins,1610612737,ATL,54,26,28,1663.0,93,65,28,0.699,245,0.38,4,0.386,5.1,329,92,236,0.28,577,0.57,52,0.627,4.2,422,157,264,0.372,784,0.538,56,0.58,4.4,2021-22,Regular%20Season
1629723,John Konchar,1610612763,MEM,68,45,23,1258.0,87,38,47,0.437,162,0.537,4,0.551,8.9,242,47,192,0.194,360,0.672,28,0.729,6.1,329,85,239,0.258,507,0.649,32,0.693,6.8,2021-22,Regular%20Season
1630257,Jon Teske,1610612763,MEM,1,1,0,4.0,0,0,0,0.0,2,0.0,0,0.0,0.0,1,0,1,0.0,1,1.0,0,1.0,6.5,1,0,1,0.0,2,0.5,0,0.5,6.5,2021-22,Regular%20Season
202685,Jonas Valanciunas,1610612740,NOP,73,33,40,2208.0,224,181,42,0.808,536,0.418,9,0.425,4.0,609,167,440,0.274,936,0.651,58,0.694,3.8,833,348,482,0.418,1421,0.586,67,0.615,3.8,2021-22,Regular%20Season
1630228,Jonathan Kuminga,1610612744,GSW,58,37,21,1103.0,51,28,23,0.549,135,0.378,2,0.383,7.0,176,34,142,0.193,282,0.624,29,0.696,5.7,227,62,165,0.273,395,0.575,31,0.624,6.0,2021-22,Regular%20Season
1628395,Jordan Bell,1610612741,CHI,1,1,0,2.0,1,0,1,0.0,2,0.5,1,1.0,13.3,0,0,0,0.0,0,0.0,0,0.0,0.0,1,0,1,0.0,2,0.5,1,1.0,13.3,2021-22,Regular%20Season
203903,Jordan Clarkson,1610612762,UTA,77,46,31,2087.0,67,34,33,0.507,132,0.508,2,0.515,9.8,206,29,177,0.141,351,0.587,30,0.642,7.4,273,63,210,0.231,478,0.571,32,0.612,8.0,2021-22,Regular%20Season
1630692,Jordan Goodwin,1610612764,WAS,1,1,0,3.0,0,0,0,0.0,0,0.0,0,0.0,0.0,1,0,1,0.0,1,1.0,0,1.0,9.8,1,0,1,0.0,1,1.0,0,1.0,9.8,2021-22,Regular%20Season
1629162,Jordan McLaughlin,1610612750,MIN,42,24,18,718.0,22,13,9,0.591,46,0.478,0,0.478,8.6,72,11,61,0.153,130,0.554,13,0.615,8.5,94,24,70,0.255,174,0.54,13,0.584,8.5,2021-22,Regular%20Season
1629670,Jordan Nwora,1610612749,MIL,55,28,27,1149.0,37,9,28,0.243,88,0.42,1,0.425,10.6,184,27,157,0.147,271,0.679,16,0.722,6.3,221,36,185,0.163,347,0.637,17,0.67,7.1,2021-22,Regular%20Season
1629673,Jordan Poole,1610612744,GSW,74,48,26,2223.0,34,6,28,0.176,101,0.337,4,0.351,15.3,226,33,193,0.146,365,0.619,33,0.681,8.6,260,39,221,0.15,458,0.568,37,0.618,9.4,2021-22,Regular%20Season
1630648,Jordan Schakel,1610612764,WAS,4,1,3,30.0,2,1,1,0.5,4,0.5,0,0.5,7.0,6,1,5,0.167,8,0.75,1,0.857,7.9,8,2,6,0.25,12,0.667,1,0.727,7.7,2021-22,Regular%20Season
1630631,Jose Alvarado,1610612740,NOP,42,20,22,726.0,25,10,15,0.4,61,0.41,0,0.41,12.2,74,7,67,0.095,122,0.607,11,0.667,8.4,99,17,82,0.172,183,0.541,11,0.576,9.4,2021-22,Regular%20Season
1630528,Josh Christopher,1610612745,HOU,63,14,49,1231.0,52,31,20,0.596,111,0.468,7,0.5,9.0,134,23,110,0.172,213,0.629,15,0.677,6.9,186,54,130,0.29,318,0.585,22,0.628,7.5,2021-22,Regular%20Season
1630581,Josh Giddey,1610612760,OKC,53,16,37,1670.0,98,51,47,0.52,216,0.454,2,0.458,8.1,323,63,259,0.195,488,0.662,32,0.708,5.2,421,114,306,0.271,681,0.618,34,0.651,5.9,2021-22,Regular%20Season
1630182,Josh Green,1610612742,DAL,54,37,17,943.0,52,20,33,0.385,115,0.452,9,0.491,10.1,109,16,93,0.147,176,0.619,19,0.694,8.3,161,36,126,0.224,285,0.565,28,0.626,8.9,2021-22,Regular%20Season
1628404,Josh Hart,1610612757,POR,53,19,34,1757.0,60,32,27,0.533,163,0.368,9,0.39,8.6,322,71,250,0.22,490,0.657,47,0.727,6.3,382,103,277,0.27,636,0.601,56,0.659,6.7,2021-22,Regular%20Season
1628367,Josh Jackson,1610612758,SAC,43,11,32,779.0,21,12,8,0.571,60,0.35,0,0.35,7.2,118,27,91,0.229,173,0.682,8,0.715,6.2,139,39,99,0.281,222,0.626,8,0.65,6.3,2021-22,Regular%20Season
1629006,Josh Okogie,1610612750,MIN,27,14,13,380.0,29,17,12,0.586,61,0.475,2,0.492,7.7,41,8,33,0.195,69,0.594,7,0.661,8.2,70,25,45,0.357,128,0.547,9,0.588,8.0,2021-22,Regular%20Season
1626196,Josh Richardson,1610612759,SAS,57,35,22,1475.0,42,14,29,0.333,96,0.438,3,0.452,11.3,141,25,116,0.177,258,0.547,29,0.616,8.3,183,39,145,0.213,346,0.529,32,0.583,9.0,2021-22,Regular%20Season
1630563,Joshua Primo,1610612759,SAS,42,16,26,913.0,32,16,16,0.5,66,0.485,4,0.516,9.2,81,19,62,0.235,150,0.54,18,0.614,7.6,113,35,78,0.31,215,0.526,22,0.585,8.1,2021-22,Regular%20Season
201950,Jrue Holiday,1610612749,MIL,64,46,18,2142.0,69,42,28,0.609,174,0.397,5,0.408,8.1,232,59,173,0.254,371,0.625,29,0.678,7.8,301,101,201,0.336,538,0.559,34,0.597,7.9,2021-22,Regular%20Season
1629308,Juan Toscano-Anderson,1610612744,GSW,58,40,18,929.0,28,14,14,0.5,79,0.354,3,0.368,6.0,148,22,127,0.149,264,0.561,25,0.619,5.7,176,36,141,0.205,330,0.533,28,0.583,5.8,2021-22,Regular%20Season
1627823,Juancho Hernangomez,1610612762,UTA,29,14,15,412.0,28,15,13,0.536,58,0.483,2,0.5,7.3,72,10,62,0.139,107,0.673,7,0.72,5.7,100,25,75,0.25,158,0.633,9,0.671,6.1,2021-22,Regular%20Season
203944,Julius Randle,1610612752,NYK,71,31,40,2505.0,123,71,50,0.577,355,0.346,4,0.35,5.6,585,121,462,0.207,888,0.659,74,0.719,4.8,708,192,512,0.271,1178,0.601,78,0.644,5.0,2021-22,Regular%20Season
1626147,Justin Anderson,1610612754,IND,12,2,10,293.0,4,2,2,0.5,16,0.25,0,0.25,11.7,42,4,38,0.095,64,0.656,2,0.677,6.5,46,6,40,0.13,75,0.613,2,0.63,6.9,2021-22,Regular%20Season
1630551,Justin Champagnie,1610612761,TOR,26,14,12,243.0,37,27,10,0.73,64,0.578,1,0.587,7.2,35,12,23,0.343,53,0.66,5,0.729,5.6,72,39,33,0.542,114,0.632,6,0.667,6.4,2021-22,Regular%20Season
203200,Justin Holiday,1610612758,SAC,68,22,46,1923.0,29,12,17,0.414,74,0.392,2,0.403,13.1,161,36,124,0.224,274,0.588,23,0.641,8.8,190,48,141,0.253,338,0.562,25,0.607,9.5,2021-22,Regular%20Season
1628382,Justin Jackson,1610612756,PHX,3,2,1,19.0,1,0,1,0.0,4,0.25,1,0.333,26.7,4,0,4,0.0,4,1.0,0,1.0,5.6,5,0,5,0.0,7,0.714,1,0.833,9.9,2021-22,Regular%20Season
1629620,Justin Robinson,1610612765,DET,12,7,5,207.0,4,0,4,0.0,10,0.4,0,0.4,15.5,17,1,16,0.059,33,0.515,3,0.567,9.0,21,1,20,0.048,43,0.488,3,0.525,10.2,2021-22,Regular%20Season
1626159,Justise Winslow,1610612757,POR,39,20,19,713.0,50,29,21,0.58,115,0.435,2,0.442,6.4,148,38,108,0.257,232,0.638,19,0.695,5.9,198,67,129,0.338,338,0.586,21,0.625,6.0,2021-22,Regular%20Season
203994,Jusuf Nurkic,1610612757,POR,56,25,31,1578.0,167,131,37,0.784,408,0.409,14,0.424,4.9,452,127,322,0.281,684,0.661,72,0.739,4.2,619,258,359,0.417,1064,0.582,86,0.633,4.4,2021-22,Regular%20Season
1629752,Juwan Morgan,1610612738,BOS,1,0,1,27.0,2,2,0,1.0,2,1.0,0,1.0,4.3,2,0,2,0.0,6,0.333,0,0.333,6.8,4,2,2,0.5,8,0.5,0,0.5,5.6,2021-22,Regular%20Season
1630231,KJ Martin,1610612745,HOU,76,18,58,1619.0,80,54,26,0.675,218,0.367,8,0.381,7.8,217,52,163,0.24,340,0.638,30,0.7,6.6,297,106,189,0.357,523,0.568,38,0.612,6.9,2021-22,Regular%20Season
1629644,KZ Okpala,1610612748,MIA,15,11,4,216.0,11,4,7,0.364,29,0.379,1,0.393,6.2,30,7,23,0.233,54,0.556,6,0.625,5.5,41,11,30,0.268,80,0.513,7,0.562,5.7,2021-22,Regular%20Season
1630539,Kai Jones,1610612766,CHA,9,5,4,39.0,3,4,0,1.333,6,0.5,0,0.5,2.4,8,3,5,0.375,14,0.571,1,0.615,4.7,11,7,5,0.636,19,0.579,1,0.611,4.0,2021-22,Regular%20Season
1626157,Karl-Anthony Towns,1610612750,MIN,74,44,30,2475.0,194,128,65,0.66,450,0.431,11,0.442,6.6,533,174,359,0.326,795,0.67,52,0.717,4.8,727,302,424,0.415,1207,0.602,63,0.635,5.3,2021-22,Regular%20Season
1626208,Keifer Sykes,1610612754,IND,20,4,16,444.0,8,1,7,0.125,17,0.471,0,0.471,14.5,37,5,32,0.135,58,0.638,3,0.673,11.0,45,6,39,0.133,74,0.608,3,0.634,11.6,2021-22,Regular%20Season
1628966,Keita Bates-Diop,1610612759,SAS,55,21,34,943.0,62,37,25,0.597,138,0.449,4,0.463,7.2,169,28,141,0.166,263,0.643,18,0.69,5.7,231,65,166,0.281,388,0.595,22,0.631,6.1,2021-22,Regular%20Season
1629103,Kelan Martin,1610612738,BOS,24,9,15,410.0,17,9,8,0.529,38,0.447,1,0.459,10.0,38,7,30,0.184,69,0.551,10,0.644,4.4,55,16,38,0.291,105,0.524,11,0.585,6.1,2021-22,Regular%20Season
1629640,Keldon Johnson,1610612759,SAS,75,33,42,2392.0,80,44,35,0.55,222,0.36,14,0.385,6.9,377,78,297,0.207,604,0.624,59,0.692,5.4,457,122,332,0.267,794,0.576,73,0.634,5.7,2021-22,Regular%20Season
1629833,Keljin Blevins,1610612757,POR,20,1,19,297.0,16,7,9,0.438,34,0.471,0,0.471,8.9,29,5,24,0.172,54,0.537,7,0.617,7.3,45,12,33,0.267,80,0.563,7,0.616,7.8,2021-22,Regular%20Season
203482,Kelly Olynyk,1610612765,DET,40,13,27,764.0,54,36,17,0.667,126,0.429,1,0.432,5.7,123,39,84,0.317,198,0.621,13,0.665,5.1,177,75,101,0.424,308,0.575,14,0.602,5.3,2021-22,Regular%20Season
1626162,Kelly Oubre Jr.,1610612766,CHA,75,39,36,1985.0,78,44,35,0.564,170,0.459,4,0.47,9.1,220,52,169,0.236,372,0.591,33,0.649,6.6,298,96,204,0.322,529,0.563,37,0.606,7.3,2021-22,Regular%20Season
202689,Kemba Walker,1610612752,NYK,32,15,17,849.0,14,4,11,0.286,39,0.359,2,0.378,18.8,97,14,84,0.144,163,0.595,16,0.66,8.6,111,18,95,0.162,201,0.552,18,0.607,10.0,2021-22,Regular%20Season
1629026,Kenrich Williams,1610612760,OKC,48,17,31,1056.0,75,46,29,0.613,176,0.426,6,0.441,7.1,145,40,105,0.276,235,0.617,16,0.662,6.1,220,86,134,0.391,398,0.553,22,0.585,6.4,2021-22,Regular%20Season
203145,Kent Bazemore,1610612747,LAL,31,12,19,498.0,13,9,3,0.692,36,0.361,2,0.382,9.3,56,4,52,0.071,110,0.509,12,0.571,6.7,69,13,55,0.188,140,0.493,14,0.548,7.2,2021-22,Regular%20Season
203484,Kentavious Caldwell-Pope,1610612764,WAS,76,34,42,2295.0,41,17,24,0.415,105,0.39,5,0.41,12.1,220,32,187,0.145,358,0.615,29,0.669,8.0,261,49,211,0.188,452,0.577,34,0.624,8.7,2021-22,Regular%20Season
1630553,Keon Johnson,1610612757,POR,28,4,24,623.0,24,16,8,0.667,56,0.429,2,0.444,8.7,57,8,48,0.14,100,0.57,7,0.613,9.5,81,24,56,0.296,155,0.523,9,0.555,9.2,2021-22,Regular%20Season
1630556,Kessler Edwards,1610612751,BKN,41,16,25,951.0,44,28,16,0.636,91,0.484,2,0.494,6.0,128,26,101,0.203,213,0.601,27,0.688,5.8,172,54,117,0.314,301,0.571,29,0.632,5.8,2021-22,Regular%20Season
201142,Kevin Durant,1610612751,BKN,55,36,19,2047.0,29,8,20,0.276,81,0.358,2,0.367,18.5,378,96,282,0.254,564,0.67,37,0.717,6.5,407,104,302,0.256,629,0.647,39,0.69,7.3,2021-22,Regular%20Season
1628989,Kevin Huerter,1610612737,ATL,73,39,34,2165.0,32,9,23,0.281,80,0.4,4,0.421,12.4,222,40,182,0.18,356,0.624,25,0.671,8.4,254,49,205,0.193,427,0.595,29,0.638,8.9,2021-22,Regular%20Season
1628995,Kevin Knox II,1610612737,ATL,19,12,7,180.0,14,5,9,0.357,24,0.583,0,0.583,14.5,30,5,25,0.167,59,0.508,3,0.536,5.0,44,10,34,0.227,80,0.55,3,0.571,8.0,2021-22,Regular%20Season
201567,Kevin Love,1610612739,CLE,74,38,36,1665.0,87,69,17,0.793,218,0.399,7,0.412,5.3,449,129,320,0.287,687,0.654,54,0.709,4.4,536,198,337,0.369,879,0.61,61,0.655,4.5,2021-22,Regular%20Season
1630698,Kevin Pangos,1610612739,CLE,8,5,3,98.0,2,0,2,0.0,2,1.0,0,1.0,23.9,9,1,8,0.111,18,0.5,3,0.6,9.5,11,1,10,0.091,20,0.55,3,0.647,12.1,2021-22,Regular%20Season
1629645,Kevin Porter Jr.,1610612745,HOU,60,16,44,1891.0,43,20,22,0.465,113,0.381,4,0.394,9.3,224,47,177,0.21,356,0.629,33,0.693,7.0,267,67,199,0.251,465,0.574,37,0.624,7.3,2021-22,Regular%20Season
1626172,Kevon Looney,1610612744,GSW,81,53,28,1713.0,205,133,71,0.649,408,0.502,14,0.52,5.3,382,128,253,0.335,649,0.589,59,0.647,4.8,587,261,324,0.445,1029,0.57,73,0.614,5.0,2021-22,Regular%20Season
203920,Khem Birch,1610612761,TOR,54,33,21,986.0,122,80,42,0.656,247,0.494,10,0.515,6.4,117,35,83,0.299,252,0.464,28,0.522,5.6,239,115,125,0.481,490,0.488,38,0.529,6.0,2021-22,Regular%20Season
203114,Khris Middleton,1610612749,MIL,66,44,22,2141.0,41,26,15,0.634,110,0.373,4,0.387,9.4,315,54,261,0.171,492,0.64,47,0.708,6.8,356,80,276,0.225,591,0.602,51,0.659,7.1,2021-22,Regular%20Season
1630165,Killian Hayes,1610612765,DET,61,19,42,1556.0,36,13,23,0.361,93,0.387,4,0.404,15.1,172,29,143,0.169,292,0.589,28,0.652,7.3,208,42,166,0.202,379,0.549,32,0.599,8.7,2021-22,Regular%20Season
1629681,Killian Tillie,1610612763,MEM,26,19,7,370.0,18,8,10,0.444,43,0.419,1,0.429,10.4,37,11,26,0.297,52,0.712,2,0.74,8.7,55,19,36,0.345,90,0.611,3,0.632,9.3,2021-22,Regular%20Season
1630184,Kira Lewis Jr.,1610612740,NOP,16,3,13,259.0,9,1,7,0.111,15,0.6,1,0.643,12.4,30,2,28,0.067,50,0.6,4,0.652,8.3,39,3,35,0.077,65,0.6,5,0.65,9.2,2021-22,Regular%20Season
202691,Klay Thompson,1610612744,GSW,32,17,15,941.0,15,3,12,0.2,49,0.306,3,0.326,15.4,110,24,86,0.218,180,0.611,18,0.679,6.6,125,27,98,0.216,219,0.571,21,0.631,7.7,2021-22,Regular%20Season
1627739,Kris Dunn,1610612757,POR,14,1,13,336.0,9,4,5,0.444,24,0.375,5,0.474,9.5,40,8,32,0.2,82,0.488,11,0.563,6.6,49,12,37,0.245,104,0.471,16,0.557,7.1,2021-22,Regular%20Season
204001,Kristaps Porzingis,1610612764,WAS,51,26,25,1481.0,102,67,34,0.657,215,0.474,9,0.495,5.7,309,93,218,0.301,515,0.6,47,0.66,4.9,411,160,252,0.389,698,0.589,56,0.64,5.1,2021-22,Regular%20Season
203937,Kyle Anderson,1610612763,MEM,69,46,23,1484.0,69,43,25,0.623,168,0.411,6,0.426,8.2,299,76,221,0.254,405,0.738,21,0.779,5.7,368,119,246,0.323,527,0.698,27,0.736,6.1,2021-22,Regular%20Season
1629657,Kyle Guy,1610612748,MIA,8,5,3,122.0,4,2,2,0.5,11,0.364,0,0.364,14.8,13,3,10,0.231,20,0.65,4,0.813,7.4,17,5,12,0.294,31,0.548,4,0.63,9.2,2021-22,Regular%20Season
1628398,Kyle Kuzma,1610612764,WAS,66,29,37,2204.0,70,45,25,0.643,187,0.374,5,0.385,6.5,491,104,385,0.212,723,0.679,49,0.728,5.0,561,149,410,0.266,884,0.635,54,0.676,5.2,2021-22,Regular%20Season
200768,Kyle Lowry,1610612748,MIA,62,40,22,2097.0,33,13,20,0.394,102,0.324,8,0.351,11.3,249,41,208,0.165,513,0.485,82,0.578,7.6,282,54,228,0.191,608,0.464,90,0.544,8.0,2021-22,Regular%20Season
202681,Kyrie Irving,1610612751,BKN,29,14,15,1092.0,16,9,6,0.563,66,0.242,3,0.254,10.7,111,15,96,0.135,189,0.587,16,0.642,8.1,127,24,102,0.189,249,0.51,19,0.552,8.4,2021-22,Regular%20Season
200746,LaMarcus Aldridge,1610612751,BKN,47,26,21,1050.0,73,44,29,0.603,161,0.453,4,0.465,5.4,185,62,123,0.335,315,0.587,36,0.663,5.6,258,106,152,0.411,463,0.557,40,0.61,5.5,2021-22,Regular%20Season
1630163,LaMelo Ball,1610612766,CHA,73,38,35,2383.0,107,52,55,0.486,248,0.431,13,0.455,8.6,391,76,315,0.194,553,0.707,37,0.758,8.0,498,128,370,0.257,783,0.636,50,0.679,8.1,2021-22,Regular%20Season
1630205,Lamar Stevens,1610612739,CLE,50,27,23,929.0,47,27,20,0.574,105,0.448,5,0.47,5.8,116,23,93,0.198,211,0.55,23,0.617,5.8,163,50,113,0.307,310,0.526,28,0.578,5.8,2021-22,Regular%20Season
202362,Lance Stephenson,1610612754,IND,44,10,34,793.0,12,3,9,0.25,44,0.273,1,0.279,15.3,115,15,101,0.13,170,0.676,13,0.732,6.5,127,18,110,0.142,206,0.617,14,0.661,7.4,2021-22,Regular%20Season
1629013,Landry Shamet,1610612756,PHX,57,43,14,1189.0,16,6,10,0.375,53,0.302,3,0.32,17.5,110,17,93,0.155,178,0.618,15,0.675,9.8,126,23,103,0.183,225,0.56,18,0.609,10.8,2021-22,Regular%20Season
204038,Langston Galloway,1610612749,MIL,7,4,3,107.0,3,3,0,1.0,10,0.3,1,0.333,5.7,15,2,13,0.133,24,0.625,1,0.652,6.6,18,5,13,0.278,33,0.545,2,0.581,6.5,2021-22,Regular%20Season
1626204,Larry Nance Jr.,1610612740,NOP,46,19,27,1040.0,72,48,24,0.667,169,0.426,6,0.442,6.7,176,33,141,0.188,270,0.652,16,0.693,5.9,248,81,165,0.327,420,0.59,22,0.623,6.1,2021-22,Regular%20Season
1628374,Lauri Markkanen,1610612739,CLE,61,32,29,1878.0,59,39,20,0.661,149,0.396,6,0.413,6.6,286,83,202,0.29,475,0.602,41,0.659,5.9,345,122,222,0.354,609,0.567,47,0.614,6.0,2021-22,Regular%20Season
2544,LeBron James,1610612747,LAL,56,25,31,2084.0,63,35,27,0.556,166,0.38,2,0.384,6.1,396,89,308,0.225,590,0.671,37,0.716,6.1,459,124,335,0.27,724,0.634,39,0.67,6.1,2021-22,Regular%20Season
1630195,Leandro Bolmaro,1610612750,MIN,22,10,12,192.0,16,12,4,0.75,25,0.64,0,0.64,8.5,27,4,23,0.148,42,0.643,4,0.711,7.8,43,16,27,0.372,67,0.642,4,0.683,8.1,2021-22,Regular%20Season
1629623,Lindell Wigginton,1610612749,MIL,10,5,5,173.0,3,3,0,1.0,10,0.3,1,0.333,3.4,22,1,21,0.045,35,0.629,4,0.71,8.0,25,4,21,0.16,45,0.556,5,0.625,7.4,2021-22,Regular%20Season
1630322,Lindy Waters III,1610612760,OKC,22,6,16,455.0,6,0,6,0.0,23,0.261,2,0.286,21.2,67,17,50,0.254,98,0.684,7,0.736,7.0,73,17,56,0.233,119,0.613,9,0.664,8.1,2021-22,Regular%20Season
1629022,Lonnie Walker IV,1610612759,SAS,65,26,39,1511.0,18,6,12,0.333,53,0.34,0,0.34,14.8,163,33,129,0.202,235,0.694,16,0.744,8.3,181,39,141,0.215,282,0.642,16,0.68,9.0,2021-22,Regular%20Season
1628366,Lonzo Ball,1610612741,CHI,35,22,13,1212.0,35,24,11,0.686,86,0.407,2,0.417,11.6,155,29,125,0.187,234,0.662,24,0.738,7.7,190,53,136,0.279,312,0.609,26,0.664,8.4,2021-22,Regular%20Season
101150,Lou Williams,1610612737,ATL,45,25,20,659.0,15,6,9,0.4,31,0.484,2,0.517,11.5,71,9,61,0.127,109,0.651,10,0.717,8.3,86,15,70,0.174,138,0.623,12,0.683,8.9,2021-22,Regular%20Season
1629663,Louis King,1610612758,SAC,7,1,6,89.0,0,0,0,0.0,3,0.0,0,0.0,0.0,12,3,9,0.25,18,0.667,0,0.667,8.4,12,3,9,0.25,20,0.6,0,0.6,8.4,2021-22,Regular%20Season
1629652,Luguentz Dort,1610612760,OKC,49,17,32,1601.0,38,18,19,0.474,116,0.328,8,0.352,9.2,174,34,141,0.195,283,0.615,27,0.68,8.3,212,52,160,0.245,398,0.533,35,0.584,8.4,2021-22,Regular%20Season
1629029,Luka Doncic,1610612742,DAL,65,44,21,2301.0,56,30,26,0.536,190,0.295,9,0.309,8.4,537,105,429,0.196,778,0.69,69,0.757,5.4,593,135,455,0.228,918,0.646,78,0.706,5.7,2021-22,Regular%20Season
1630568,Luka Garza,1610612765,DET,26,3,23,349.0,57,34,22,0.596,117,0.487,1,0.491,5.4,39,16,23,0.41,94,0.415,16,0.5,5.1,96,50,45,0.521,208,0.462,17,0.503,5.3,2021-22,Regular%20Season
1628379,Luke Kennard,1610612746,LAC,67,32,35,1839.0,20,6,14,0.3,55,0.364,4,0.392,12.7,209,23,187,0.11,355,0.589,24,0.631,7.5,229,29,201,0.127,403,0.568,28,0.611,7.9,2021-22,Regular%20Season
1628436,Luke Kornet,1610612738,BOS,10,8,2,92.0,13,10,2,0.769,27,0.481,0,0.481,4.1,16,4,12,0.25,24,0.667,1,0.696,4.5,29,14,14,0.483,50,0.58,1,0.592,4.3,2021-22,Regular%20Season
1630640,MJ Walker,1610612756,PHX,1,1,0,8.0,0,0,0,0.0,2,0.0,0,0.0,0.0,1,0,1,0.0,1,1.0,0,1.0,4.1,1,0,1,0.0,3,0.333,0,0.333,4.1,2021-22,Regular%20Season
1630644,Mac McClung,1610612747,LAL,1,1,0,22.0,0,0,0,0.0,2,0.0,0,0.0,0.0,3,0,3,0.0,4,0.75,0,0.75,7.2,3,0,3,0.0,6,0.5,0,0.5,7.2,2021-22,Regular%20Season
1630201,Malachi Flynn,1610612761,TOR,27,14,13,446.0,10,3,7,0.3,27,0.37,1,0.385,11.2,52,10,42,0.192,84,0.619,5,0.658,9.4,62,13,49,0.21,109,0.569,6,0.602,9.7,2021-22,Regular%20Season
1627763,Malcolm Brogdon,1610612754,IND,36,14,22,1206.0,33,16,17,0.485,90,0.367,5,0.388,11.5,152,32,120,0.211,243,0.626,30,0.714,7.6,185,48,137,0.259,331,0.559,35,0.625,8.3,2021-22,Regular%20Season
1630792,Malcolm Hill,1610612741,CHI,12,6,6,194.0,11,4,7,0.364,20,0.55,0,0.55,11.0,24,3,21,0.125,42,0.571,4,0.632,5.3,35,7,28,0.2,60,0.583,4,0.625,7.1,2021-22,Regular%20Season
1627736,Malik Beasley,1610612750,MIN,74,43,31,1871.0,26,7,19,0.269,81,0.321,7,0.351,16.5,201,31,170,0.154,309,0.65,28,0.715,8.4,227,38,189,0.167,381,0.596,35,0.656,9.5,2021-22,Regular%20Season
1630238,Malik Fitts,1610612738,BOS,9,7,2,51.0,2,1,1,0.5,5,0.4,0,0.4,16.9,15,3,12,0.2,22,0.682,2,0.75,6.7,17,4,13,0.235,25,0.68,2,0.739,7.9,2021-22,Regular%20Season
1628370,Malik Monk,1610612747,LAL,71,28,43,2015.0,37,13,24,0.351,86,0.43,3,0.446,11.4,219,30,189,0.137,360,0.608,26,0.656,6.3,256,43,213,0.168,437,0.586,29,0.627,7.1,2021-22,Regular%20Season
1629005,Malik Newman,1610612739,CLE,1,0,1,8.0,0,0,0,0.0,0,0.0,0,0.0,0.0,1,0,1,0.0,1,1.0,0,1.0,8.3,1,0,1,0.0,1,1.0,0,1.0,8.3,2021-22,Regular%20Season
1629603,Mamadi Diakite,1610612760,OKC,12,3,9,178.0,17,13,4,0.765,44,0.386,1,0.395,3.8,42,13,28,0.31,63,0.667,6,0.737,4.2,59,26,32,0.441,102,0.578,7,0.621,4.1,2021-22,Regular%20Season
1630585,Marcus Garrett,1610612748,MIA,8,7,1,117.0,9,7,2,0.778,15,0.6,0,0.6,8.6,14,4,10,0.286,24,0.583,2,0.636,6.3,23,11,12,0.478,39,0.59,2,0.622,7.2,2021-22,Regular%20Season
202694,Marcus Morris Sr.,1610612746,LAC,51,26,25,1467.0,23,10,13,0.435,68,0.338,4,0.359,13.1,208,34,173,0.163,313,0.665,30,0.735,7.1,231,44,186,0.19,367,0.629,34,0.694,7.7,2021-22,Regular%20Season
203935,Marcus Smart,1610612738,BOS,68,46,22,2223.0,41,18,22,0.439,111,0.369,6,0.39,11.1,227,63,164,0.278,375,0.605,36,0.67,8.4,268,81,186,0.302,483,0.555,42,0.608,8.8,2021-22,Regular%20Season
1628365,Markelle Fultz,1610612753,ORL,18,6,12,360.0,4,3,1,0.75,20,0.2,0,0.2,9.6,45,9,36,0.2,74,0.608,7,0.672,7.5,49,12,37,0.245,94,0.521,7,0.563,7.7,2021-22,Regular%20Season
202693,Markieff Morris,1610612748,MIA,17,10,7,298.0,17,9,8,0.529,37,0.459,1,0.472,6.7,28,6,22,0.214,66,0.424,9,0.491,5.1,45,15,30,0.333,97,0.464,10,0.517,5.7,2021-22,Regular%20Season
1630250,Marko Simonovic,1610612741,CHI,5,2,3,27.0,5,3,2,0.6,9,0.556,0,0.556,2.6,5,3,2,0.6,10,0.5,0,0.5,3.3,10,6,4,0.6,18,0.556,0,0.556,2.9,2021-22,Regular%20Season
1630210,Markus Howard,1610612743,DEN,8,3,5,95.0,2,0,2,0.0,5,0.4,0,0.4,12.0,10,0,10,0.0,15,0.667,3,0.833,6.9,12,0,12,0.0,20,0.6,3,0.706,7.8,2021-22,Regular%20Season
1627737,Marquese Chriss,1610612742,DAL,28,20,8,308.0,33,19,14,0.576,79,0.418,1,0.423,4.7,70,23,47,0.329,116,0.603,12,0.673,5.2,103,42,61,0.408,184,0.56,13,0.602,5.0,2021-22,Regular%20Season
1628963,Marvin Bagley III,1610612765,DET,48,17,31,1146.0,105,76,28,0.724,198,0.53,3,0.538,5.2,233,61,171,0.262,341,0.683,25,0.737,4.5,338,137,199,0.405,521,0.649,28,0.686,4.7,2021-22,Regular%20Season
1630222,Mason Jones,1610612747,LAL,4,2,2,51.0,1,0,1,0.0,5,0.2,1,0.25,1.9,9,1,8,0.111,17,0.529,2,0.6,6.1,10,1,9,0.1,21,0.476,3,0.556,5.7,2021-22,Regular%20Season
203486,Mason Plumlee,1610612766,CHA,72,40,32,1771.0,175,111,65,0.634,399,0.439,12,0.452,5.8,384,119,264,0.31,674,0.57,70,0.636,4.1,559,230,329,0.411,1049,0.533,82,0.578,4.7,2021-22,Regular%20Season
1629680,Matisse Thybulle,1610612755,PHI,60,39,21,1569.0,42,22,21,0.524,104,0.404,2,0.412,8.7,109,16,92,0.147,185,0.589,16,0.645,10.2,151,38,113,0.252,282,0.535,18,0.572,9.7,2021-22,Regular%20Season
1629744,Matt Thomas,1610612741,CHI,26,14,12,390.0,3,0,3,0.0,8,0.375,0,0.375,17.0,47,7,39,0.149,76,0.618,10,0.712,7.9,50,7,42,0.14,82,0.61,10,0.694,8.4,2021-22,Regular%20Season
203090,Maurice Harkless,1610612758,SAC,39,12,27,774.0,12,7,5,0.583,44,0.273,2,0.286,7.6,96,15,81,0.156,139,0.691,10,0.744,6.9,108,22,86,0.204,172,0.628,12,0.675,7.0,2021-22,Regular%20Season
1629622,Max Strus,1610612748,MIA,62,42,20,1515.0,24,10,14,0.417,67,0.358,6,0.393,11.9,178,38,139,0.213,303,0.587,30,0.652,7.6,202,48,153,0.238,366,0.552,36,0.612,8.1,2021-22,Regular%20Season
1628467,Maxi Kleber,1610612742,DAL,59,36,23,1450.0,70,42,28,0.6,156,0.449,2,0.455,10.0,280,99,179,0.354,470,0.596,59,0.681,4.8,350,141,207,0.403,603,0.58,61,0.646,5.8,2021-22,Regular%20Season
1628982,Melvin Frazier Jr.,1610612760,OKC,3,0,3,120.0,5,1,4,0.2,13,0.385,0,0.385,11.2,8,0,8,0.0,16,0.5,4,0.667,7.0,13,1,12,0.077,28,0.464,4,0.542,8.7,2021-22,Regular%20Season
1630695,Micah Potter,1610612765,DET,3,2,1,31.0,4,2,2,0.5,14,0.286,0,0.286,3.3,5,0,5,0.0,14,0.357,1,0.385,2.5,9,2,7,0.222,26,0.346,1,0.36,2.8,2021-22,Regular%20Season
1629008,Michael Porter Jr.,1610612743,DEN,9,5,4,265.0,9,2,7,0.222,27,0.333,0,0.333,6.3,50,6,44,0.12,79,0.633,7,0.694,5.4,59,8,51,0.136,101,0.584,7,0.628,5.6,2021-22,Regular%20Season
1628969,Mikal Bridges,1610612756,PHX,79,62,17,2744.0,72,34,38,0.472,152,0.474,7,0.497,10.6,271,76,196,0.28,423,0.641,31,0.691,7.6,343,110,234,0.321,562,0.61,38,0.655,8.2,2021-22,Regular%20Season
201144,Mike Conley,1610612762,UTA,69,42,27,1981.0,47,9,37,0.191,97,0.485,7,0.522,14.3,170,23,147,0.135,276,0.616,20,0.664,9.1,217,32,184,0.147,368,0.59,27,0.636,10.2,2021-22,Regular%20Season
203488,Mike Muscala,1610612760,OKC,38,13,25,526.0,21,11,9,0.524,54,0.389,1,0.396,6.3,108,41,67,0.38,199,0.543,20,0.603,4.9,129,52,76,0.403,243,0.531,21,0.581,5.1,2021-22,Regular%20Season
1628970,Miles Bridges,1610612766,CHA,79,41,38,2800.0,89,36,51,0.404,239,0.372,11,0.39,10.1,465,115,348,0.247,721,0.645,55,0.698,5.8,554,151,399,0.273,915,0.605,66,0.653,6.4,2021-22,Regular%20Season
1630540,Miles McBride,1610612752,NYK,20,12,8,285.0,4,0,5,0.0,17,0.235,1,0.25,13.1,38,10,27,0.263,60,0.633,4,0.679,9.1,42,10,32,0.238,76,0.553,5,0.592,9.6,2021-22,Regular%20Season
1629011,Mitchell Robinson,1610612752,NYK,69,30,39,1805.0,292,230,61,0.788,541,0.54,13,0.553,4.3,321,140,181,0.436,538,0.597,49,0.656,6.2,613,370,242,0.604,1057,0.58,62,0.616,5.3,2021-22,Regular%20Season
1629671,Miye Oni,1610612762,UTA,7,6,1,22.0,1,1,0,1.0,2,0.5,0,0.5,6.4,6,1,5,0.167,6,1.0,0,1.0,5.4,7,2,5,0.286,7,1.0,0,1.0,5.6,2021-22,Regular%20Season
1628964,Mo Bamba,1610612753,ORL,71,19,52,1824.0,148,104,43,0.703,331,0.447,7,0.457,4.7,424,97,326,0.229,730,0.581,87,0.659,4.0,572,201,369,0.351,1019,0.561,94,0.618,4.2,2021-22,Regular%20Season
1628420,Monte Morris,1610612743,DEN,70,42,28,2096.0,27,7,20,0.259,69,0.391,3,0.409,11.3,199,23,176,0.116,285,0.698,18,0.745,9.7,226,30,196,0.133,352,0.642,21,0.683,9.9,2021-22,Regular%20Season
1626149,Montrezl Harrell,1610612766,CHA,70,35,35,1623.0,149,105,43,0.705,323,0.461,7,0.472,5.3,282,83,200,0.294,478,0.59,61,0.676,5.8,431,188,243,0.436,772,0.558,68,0.612,5.6,2021-22,Regular%20Season
1629021,Moritz Wagner,1610612753,ORL,57,16,41,915.0,42,25,16,0.595,133,0.316,0,0.316,7.3,190,47,142,0.247,297,0.64,25,0.699,5.3,232,72,158,0.31,405,0.573,25,0.611,5.7,2021-22,Regular%20Season
1629650,Moses Brown,1610612739,CLE,31,15,16,324.0,39,32,7,0.821,96,0.406,3,0.419,4.4,96,28,66,0.292,148,0.649,14,0.716,4.1,135,60,73,0.444,234,0.577,17,0.622,4.2,2021-22,Regular%20Season
1630541,Moses Moody,1610612744,GSW,30,20,10,487.0,16,9,7,0.563,40,0.4,0,0.4,11.3,59,15,42,0.254,89,0.663,5,0.702,6.8,75,24,49,0.32,118,0.636,5,0.664,7.8,2021-22,Regular%20Season
1630589,Moses Wright,1610612742,DAL,2,2,0,11.0,1,0,1,0.0,1,1.0,0,1.0,21.5,2,0,2,0.0,2,1.0,0,1.0,7.0,3,0,3,0.0,3,1.0,0,1.0,11.8,2021-22,Regular%20Season
1628539,Mychal Mulder,1610612748,MIA,13,2,11,192.0,2,0,2,0.0,8,0.25,1,0.286,9.4,22,3,19,0.136,39,0.564,2,0.595,7.0,24,3,21,0.125,47,0.511,3,0.545,7.2,2021-22,Regular%20Season
1629619,Myles Powell,1610612755,PHI,3,3,0,25.0,1,0,1,0.0,1,1.0,0,1.0,5.8,5,0,5,0.0,7,0.714,0,0.714,11.0,6,0,6,0.0,8,0.75,0,0.75,10.1,2021-22,Regular%20Season
1626167,Myles Turner,1610612754,IND,42,15,27,1235.0,65,35,29,0.538,154,0.422,2,0.428,8.0,232,79,152,0.341,421,0.551,46,0.619,4.5,297,114,181,0.384,557,0.533,48,0.583,5.3,2021-22,Regular%20Season
1630230,Naji Marshall,1610612740,NOP,48,19,29,714.0,38,25,13,0.658,90,0.422,7,0.458,6.5,104,12,91,0.115,177,0.588,21,0.667,5.5,142,37,104,0.261,259,0.548,28,0.615,5.7,2021-22,Regular%20Season
1629642,Nassir Little,1610612757,POR,41,19,22,1077.0,58,40,18,0.69,111,0.523,1,0.527,10.0,178,37,141,0.208,299,0.595,27,0.654,5.6,236,77,159,0.326,398,0.593,28,0.638,6.7,2021-22,Regular%20Season
1630233,Nathan Knight,1610612750,MIN,26,15,11,239.0,32,28,4,0.875,66,0.485,2,0.5,4.2,53,12,41,0.226,91,0.582,18,0.726,5.7,85,40,45,0.471,151,0.563,20,0.649,5.1,2021-22,Regular%20Season
1629675,Naz Reid,1610612750,MIN,71,40,31,1146.0,101,69,33,0.683,219,0.461,4,0.47,5.2,199,65,134,0.327,367,0.542,37,0.603,4.6,300,134,167,0.447,564,0.532,41,0.574,4.8,2021-22,Regular%20Season
1629674,Neemias Queta,1610612758,SAC,9,2,7,112.0,14,8,5,0.571,27,0.519,1,0.538,6.2,17,11,7,0.647,38,0.447,9,0.586,4.4,31,19,12,0.613,61,0.508,10,0.608,5.1,2021-22,Regular%20Season
202357,Nemanja Bjelica,1610612744,GSW,67,45,22,1090.0,62,48,15,0.774,139,0.446,2,0.453,5.5,229,74,155,0.323,353,0.649,31,0.711,4.6,291,122,170,0.419,474,0.614,33,0.66,4.8,2021-22,Regular%20Season
203457,Nerlens Noel,1610612752,NYK,25,10,15,562.0,48,35,12,0.729,103,0.466,3,0.48,5.5,93,32,62,0.344,181,0.514,24,0.592,5.1,141,67,74,0.475,279,0.505,27,0.56,5.3,2021-22,Regular%20Season
1629651,Nic Claxton,1610612751,BKN,46,23,23,971.0,91,66,25,0.725,240,0.379,6,0.389,4.3,173,44,129,0.254,311,0.556,26,0.607,4.8,264,110,154,0.417,531,0.497,32,0.529,4.7,2021-22,Regular%20Season
1630208,Nick Richards,1610612766,CHA,36,18,18,320.0,32,26,6,0.813,83,0.386,2,0.395,3.6,52,15,37,0.288,95,0.547,14,0.642,5.2,84,41,43,0.488,173,0.486,16,0.535,4.6,2021-22,Regular%20Season
1629638,Nickeil Alexander-Walker,1610612762,UTA,56,24,32,1387.0,37,17,19,0.459,91,0.407,5,0.43,8.8,150,25,124,0.167,265,0.566,26,0.628,6.4,187,42,143,0.225,349,0.536,31,0.588,6.9,2021-22,Regular%20Season
201587,Nicolas Batum,1610612746,LAC,57,31,26,1428.0,29,12,17,0.414,56,0.518,2,0.537,11.8,218,55,160,0.252,314,0.694,18,0.736,5.6,247,67,177,0.271,363,0.68,20,0.72,6.3,2021-22,Regular%20Season
203917,Nik Stauskas,1610612738,BOS,2,1,1,24.0,1,0,1,0.0,1,1.0,0,1.0,23.1,2,1,1,0.5,5,0.4,0,0.4,6.4,3,1,2,0.333,6,0.5,0,0.5,11.9,2021-22,Regular%20Season
203999,Nikola Jokic,1610612743,DEN,74,46,28,2476.0,206,165,38,0.801,477,0.432,13,0.444,4.2,813,279,531,0.343,1155,0.704,90,0.763,4.0,1019,444,569,0.436,1571,0.649,103,0.694,4.0,2021-22,Regular%20Season
202696,Nikola Vucevic,1610612741,CHI,73,41,32,2418.0,142,100,41,0.704,327,0.434,7,0.444,5.3,662,221,438,0.334,970,0.682,72,0.737,4.0,804,321,479,0.399,1244,0.646,79,0.69,4.3,2021-22,Regular%20Season
1626181,Norman Powell,1610612746,LAC,43,15,28,1388.0,20,7,13,0.35,70,0.286,3,0.299,13.9,125,21,104,0.168,192,0.651,16,0.71,8.9,145,28,117,0.193,249,0.582,19,0.63,9.6,2021-22,Regular%20Season
203658,Norvel Pelle,1610612762,UTA,3,0,3,19.0,3,2,1,0.667,6,0.5,0,0.5,3.8,3,1,2,0.333,9,0.333,2,0.429,1.9,6,3,3,0.5,15,0.4,2,0.462,2.8,2021-22,Regular%20Season
1628384,OG Anunoby,1610612761,TOR,48,31,17,1728.0,74,38,37,0.514,168,0.44,9,0.465,9.8,190,41,149,0.216,311,0.611,31,0.679,6.5,264,79,186,0.299,457,0.578,40,0.633,7.4,2021-22,Regular%20Season
1630167,Obi Toppin,1610612752,NYK,67,28,39,1178.0,69,34,34,0.493,152,0.454,2,0.46,7.5,196,36,160,0.184,309,0.634,25,0.69,5.1,265,70,194,0.264,440,0.602,27,0.642,5.7,2021-22,Regular%20Season
1630846,Olivier Sarr,1610612760,OKC,19,6,13,407.0,34,21,13,0.618,90,0.378,2,0.386,6.2,59,16,43,0.271,129,0.457,18,0.532,5.5,93,37,56,0.398,217,0.429,20,0.472,5.8,2021-22,Regular%20Season
1630209,Omer Yurtseven,1610612748,MIA,45,30,15,679.0,85,60,22,0.706,191,0.445,4,0.455,4.0,209,54,153,0.258,285,0.733,22,0.795,3.8,294,114,175,0.388,463,0.635,26,0.673,3.9,2021-22,Regular%20Season
1630168,Onyeka Okongwu,1610612737,ATL,47,26,21,985.0,115,75,40,0.652,210,0.548,3,0.556,5.5,168,60,107,0.357,270,0.622,27,0.691,5.1,283,135,147,0.477,470,0.602,30,0.643,5.3,2021-22,Regular%20Season
1629052,Oshae Brissett,1610612754,IND,63,18,45,1541.0,108,63,45,0.583,241,0.448,13,0.474,6.8,250,61,188,0.244,400,0.625,35,0.685,5.6,358,124,233,0.346,612,0.585,48,0.635,5.9,2021-22,Regular%20Season
203490,Otto Porter Jr.,1610612744,GSW,61,40,21,1356.0,86,50,37,0.581,178,0.483,3,0.491,7.8,269,61,208,0.227,410,0.656,36,0.719,5.6,355,111,245,0.313,564,0.629,39,0.676,6.1,2021-22,Regular%20Season
200782,P.J. Tucker,1610612748,MIA,71,45,26,1981.0,100,60,40,0.6,265,0.377,7,0.388,7.6,287,69,215,0.24,491,0.585,60,0.666,6.2,387,129,255,0.333,731,0.529,67,0.583,6.6,2021-22,Regular%20Season
1629023,P.J. Washington,1610612766,CHA,64,33,31,1764.0,82,47,37,0.573,171,0.48,4,0.491,6.8,255,88,167,0.345,442,0.577,35,0.627,5.1,337,135,204,0.401,589,0.572,39,0.613,5.5,2021-22,Regular%20Season
1628408,PJ Dozier,1610612743,DEN,17,9,8,322.0,14,6,7,0.429,32,0.438,1,0.452,9.0,49,9,40,0.184,68,0.721,9,0.831,7.6,63,15,47,0.238,95,0.663,10,0.741,7.9,2021-22,Regular%20Season
1628238,Paris Bass,1610612756,PHX,1,1,0,5.0,1,1,0,1.0,3,0.333,0,0.333,8.5,1,0,1,0.0,1,1.0,0,1.0,11.4,2,1,1,0.5,3,0.667,0,0.667,9.9,2021-22,Regular%20Season
1627783,Pascal Siakam,1610612761,TOR,68,40,28,2578.0,128,81,48,0.633,294,0.435,15,0.459,7.8,452,101,352,0.223,671,0.674,49,0.727,5.5,580,182,400,0.314,933,0.622,64,0.667,6.0,2021-22,Regular%20Season
1626192,Pat Connaughton,1610612749,MIL,64,41,23,1671.0,45,19,26,0.422,104,0.433,3,0.446,11.7,228,56,171,0.246,396,0.576,51,0.661,6.3,273,75,197,0.275,491,0.556,54,0.625,7.2,2021-22,Regular%20Season
201976,Patrick Beverley,1610612750,MIN,56,32,24,1466.0,62,21,39,0.339,123,0.504,2,0.512,11.3,178,26,151,0.146,303,0.587,28,0.647,7.9,240,47,190,0.196,421,0.57,30,0.614,8.8,2021-22,Regular%20Season
1630172,Patrick Williams,1610612741,CHI,16,8,8,396.0,17,10,7,0.588,36,0.472,0,0.472,10.6,52,7,45,0.135,92,0.565,9,0.627,6.7,69,17,52,0.246,125,0.552,9,0.595,7.6,2021-22,Regular%20Season
201988,Patty Mills,1610612751,BKN,65,33,32,1942.0,18,3,15,0.167,57,0.316,0,0.316,16.9,138,16,122,0.116,234,0.59,14,0.627,10.0,156,19,137,0.122,288,0.542,14,0.569,10.8,2021-22,Regular%20Season
202331,Paul George,1610612746,LAC,30,17,13,1051.0,12,4,8,0.333,63,0.19,2,0.197,10.6,201,41,161,0.204,325,0.618,32,0.686,5.9,213,45,169,0.211,372,0.573,34,0.63,6.1,2021-22,Regular%20Season
200794,Paul Millsap,1610612755,PHI,31,21,10,360.0,41,29,11,0.707,83,0.494,1,0.5,4.8,73,21,52,0.288,130,0.562,11,0.613,4.4,114,50,63,0.439,208,0.548,12,0.582,4.5,2021-22,Regular%20Season
1630194,Paul Reed,1610612755,PHI,26,13,13,272.0,44,32,12,0.727,103,0.427,5,0.449,5.4,48,13,35,0.271,83,0.578,7,0.632,5.2,92,45,47,0.489,180,0.511,12,0.548,5.3,2021-22,Regular%20Season
1628778,Paul Watson,1610612760,OKC,8,2,6,152.0,3,1,2,0.333,9,0.333,0,0.333,11.6,24,2,22,0.083,32,0.75,1,0.774,6.7,27,3,24,0.111,38,0.711,1,0.73,7.3,2021-22,Regular%20Season
1630202,Payton Pritchard,1610612738,BOS,53,32,21,878.0,32,12,19,0.375,69,0.464,3,0.485,12.0,102,15,87,0.147,178,0.573,20,0.646,8.7,134,27,106,0.201,245,0.547,23,0.604,9.5,2021-22,Regular%20Season
1627822,Petr Cornelie,1610612743,DEN,9,2,7,30.0,7,6,1,0.857,11,0.636,0,0.636,4.5,7,1,6,0.143,9,0.778,0,0.778,3.4,14,7,7,0.5,18,0.778,0,0.778,4.0,2021-22,Regular%20Season
1630173,Precious Achiuwa,1610612761,TOR,73,46,27,1725.0,146,93,52,0.637,356,0.41,9,0.421,5.6,327,90,236,0.275,527,0.62,54,0.691,5.2,473,183,288,0.387,849,0.557,63,0.602,5.3,2021-22,Regular%20Season
1629656,Quentin Grimes,1610612752,NYK,38,16,22,771.0,23,10,13,0.435,40,0.575,1,0.59,14.4,70,14,56,0.2,136,0.515,18,0.593,6.7,93,24,69,0.258,170,0.547,19,0.616,8.6,2021-22,Regular%20Season
1629683,Quinndary Weatherspoon,1610612744,GSW,6,4,2,65.0,2,2,0,1.0,7,0.286,0,0.286,2.6,12,5,7,0.417,15,0.8,1,0.857,9.4,14,7,7,0.5,22,0.636,1,0.667,8.4,2021-22,Regular%20Season
1630181,R.J. Hampton,1610612753,ORL,58,15,43,1309.0,23,13,10,0.565,60,0.383,3,0.404,9.3,171,25,144,0.146,254,0.673,22,0.737,8.6,194,38,154,0.196,313,0.62,25,0.674,8.7,2021-22,Regular%20Season
1629628,RJ Barrett,1610612752,NYK,69,32,37,2384.0,66,24,42,0.364,188,0.351,7,0.365,12.8,339,59,279,0.174,536,0.632,44,0.689,6.2,405,83,321,0.205,693,0.584,51,0.631,7.3,2021-22,Regular%20Season
1630612,RJ Nembhard Jr.,1610612739,CLE,6,2,4,25.0,3,1,2,0.333,6,0.5,0,0.5,12.2,4,0,4,0.0,6,0.667,1,0.8,7.5,7,1,6,0.143,11,0.636,1,0.7,9.5,2021-22,Regular%20Season
200765,Rajon Rondo,1610612739,CLE,37,16,21,668.0,15,5,11,0.333,41,0.366,1,0.375,10.8,93,10,83,0.108,149,0.624,13,0.684,7.9,108,15,94,0.139,185,0.584,14,0.632,8.3,2021-22,Regular%20Season
203526,Raul Neto,1610612764,WAS,58,26,32,1217.0,13,4,9,0.308,65,0.2,6,0.22,16.5,121,11,109,0.091,200,0.605,22,0.68,9.5,134,15,118,0.112,263,0.51,28,0.57,10.2,2021-22,Regular%20Season
1629730,Rayjon Tucker,1610612749,MIL,3,1,2,65.0,3,1,2,0.333,6,0.5,0,0.5,12.1,5,2,3,0.4,7,0.714,0,0.714,6.1,8,3,5,0.375,13,0.615,0,0.615,8.3,2021-22,Regular%20Season
203493,Reggie Bullock Jr.,1610612742,DAL,67,44,23,1868.0,33,11,21,0.333,79,0.418,2,0.429,14.4,208,37,172,0.178,329,0.632,25,0.684,7.3,241,48,193,0.199,394,0.612,27,0.657,8.3,2021-22,Regular%20Season
202704,Reggie Jackson,1610612746,LAC,73,38,35,2281.0,39,15,24,0.385,109,0.358,8,0.386,12.8,224,26,196,0.116,382,0.586,37,0.649,8.8,263,41,220,0.156,486,0.541,45,0.596,9.4,2021-22,Regular%20Season
1629617,Reggie Perry,1610612757,POR,10,0,10,187.0,15,11,4,0.733,40,0.375,1,0.385,6.2,32,5,27,0.156,54,0.593,7,0.681,3.8,47,16,31,0.34,86,0.547,8,0.603,4.6,2021-22,Regular%20Season
1626158,Richaun Holmes,1610612758,SAC,41,13,28,997.0,88,74,15,0.841,214,0.411,4,0.419,4.7,209,57,151,0.273,382,0.547,46,0.622,4.4,297,131,166,0.441,579,0.513,50,0.561,4.5,2021-22,Regular%20Season
201937,Ricky Rubio,1610612754,IND,33,20,13,933.0,15,3,12,0.2,59,0.254,5,0.278,19.1,126,17,109,0.135,175,0.72,10,0.764,9.8,141,20,121,0.142,229,0.616,15,0.659,10.8,2021-22,Regular%20Season
1630306,Rob Edwards,1610612760,OKC,1,0,1,9.0,0,0,0,0.0,0,0.0,0,0.0,0.0,3,1,2,0.333,3,1.0,0,1.0,6.7,3,1,2,0.333,3,1.0,0,1.0,6.7,2021-22,Regular%20Season
203496,Robert Covington,1610612746,LAC,70,34,36,1924.0,59,31,28,0.525,185,0.319,7,0.331,8.6,332,68,264,0.205,556,0.597,58,0.667,5.6,391,99,292,0.253,707,0.553,65,0.609,6.1,2021-22,Regular%20Season
1629057,Robert Williams III,1610612738,BOS,60,40,20,1770.0,235,173,61,0.736,393,0.598,11,0.615,4.9,344,111,233,0.323,539,0.638,58,0.715,5.7,579,284,294,0.491,909,0.637,69,0.689,5.4,2021-22,Regular%20Season
1630218,Robert Woodard II,1610612759,SAS,6,0,6,29.0,5,3,2,0.6,6,0.833,0,0.833,5.8,6,0,6,0.0,15,0.4,2,0.462,6.1,11,3,8,0.273,20,0.55,2,0.611,6.0,2021-22,Regular%20Season
201577,Robin Lopez,1610612753,ORL,33,9,24,579.0,68,55,14,0.809,141,0.482,4,0.496,5.1,58,25,33,0.431,129,0.45,24,0.552,6.3,126,80,47,0.635,269,0.468,28,0.523,5.7,2021-22,Regular%20Season
203918,Rodney Hood,1610612746,LAC,36,18,18,569.0,15,7,8,0.467,33,0.455,3,0.5,7.3,62,8,54,0.129,92,0.674,7,0.729,8.0,77,15,62,0.195,123,0.626,10,0.681,7.9,2021-22,Regular%20Season
203585,Rodney McGruder,1610612765,DET,38,12,26,647.0,30,14,16,0.467,79,0.38,7,0.417,8.9,80,18,62,0.225,132,0.606,13,0.672,8.0,110,32,78,0.291,206,0.534,20,0.591,8.3,2021-22,Regular%20Season
1629641,Romeo Langford,1610612759,SAS,38,15,23,704.0,30,13,16,0.433,56,0.536,7,0.612,8.7,78,25,53,0.321,128,0.609,8,0.65,6.7,108,38,69,0.352,183,0.59,15,0.643,7.2,2021-22,Regular%20Season
1626220,Royce O'Neale,1610612762,UTA,75,44,31,2345.0,64,31,33,0.484,158,0.405,4,0.416,9.3,304,54,248,0.178,542,0.561,64,0.636,6.7,368,85,281,0.231,683,0.539,68,0.598,7.1,2021-22,Regular%20Season
200752,Rudy Gay,1610612762,UTA,55,34,21,1038.0,55,31,24,0.564,114,0.482,4,0.5,7.2,187,52,135,0.278,283,0.661,19,0.708,5.2,242,83,159,0.343,390,0.621,23,0.659,5.7,2021-22,Regular%20Season
203497,Rudy Gobert,1610612762,UTA,66,42,24,2120.0,241,176,65,0.73,559,0.431,22,0.449,4.5,727,194,530,0.267,1109,0.656,88,0.712,3.7,968,370,595,0.382,1619,0.598,110,0.641,3.9,2021-22,Regular%20Season
1629060,Rui Hachimura,1610612764,WAS,42,16,26,944.0,25,11,13,0.44,62,0.403,2,0.417,12.1,135,26,109,0.193,219,0.616,17,0.668,5.4,160,37,122,0.231,272,0.588,19,0.632,6.4,2021-22,Regular%20Season
201566,Russell Westbrook,1610612747,LAL,78,31,47,2678.0,110,59,49,0.536,342,0.322,6,0.327,7.5,470,91,376,0.194,666,0.706,43,0.754,6.6,580,150,425,0.259,927,0.626,49,0.661,6.8,2021-22,Regular%20Season
1627853,Ryan Arcidiacono,1610612752,NYK,5,4,1,63.0,0,0,0,0.0,0,0.0,0,0.0,0.0,8,0,8,0.0,12,0.667,1,0.727,8.0,8,0,8,0.0,12,0.667,1,0.727,8.0,2021-22,Regular%20Season
1630240,Saben Lee,1610612765,DET,30,7,23,544.0,18,10,8,0.556,49,0.367,1,0.375,12.4,67,17,49,0.254,100,0.67,6,0.713,7.0,85,27,57,0.318,148,0.574,7,0.603,8.1,2021-22,Regular%20Season
1630180,Saddiq Bey,1610612765,DET,80,22,58,2666.0,107,44,63,0.411,226,0.473,8,0.491,9.6,331,59,271,0.178,504,0.657,25,0.691,6.8,438,103,334,0.235,711,0.616,33,0.646,7.5,2021-22,Regular%20Season
1630573,Sam Hauser,1610612738,BOS,16,11,5,131.0,5,2,3,0.4,11,0.455,0,0.455,14.8,24,3,21,0.125,28,0.857,1,0.889,5.2,29,5,24,0.172,35,0.829,1,0.853,6.9,2021-22,Regular%20Season
1630241,Sam Merrill,1610612763,MEM,4,2,2,30.0,1,1,0,1.0,2,0.5,0,0.5,14.7,6,0,6,0.0,7,0.857,0,0.857,6.4,7,1,6,0.143,8,0.875,0,0.875,7.6,2021-22,Regular%20Season
1630572,Sandro Mamukelashvili,1610612749,MIL,24,10,14,348.0,35,20,14,0.571,75,0.467,4,0.493,5.4,47,14,33,0.298,84,0.56,10,0.635,5.0,82,34,47,0.415,157,0.522,14,0.573,5.2,2021-22,Regular%20Season
1630583,Santi Aldama,1610612763,MEM,28,17,11,322.0,32,21,11,0.656,54,0.593,4,0.64,6.0,52,13,39,0.25,87,0.598,12,0.693,5.1,84,34,50,0.405,136,0.618,16,0.7,5.4,2021-22,Regular%20Season
1630567,Scottie Barnes,1610612761,TOR,74,43,31,2617.0,195,115,78,0.59,347,0.562,9,0.577,7.2,362,89,273,0.246,592,0.611,64,0.686,6.0,557,204,351,0.366,915,0.609,73,0.662,6.4,2021-22,Regular%20Season
203816,Scotty Hopson,1610612760,OKC,1,0,1,18.0,0,0,0,0.0,1,0.0,0,0.0,0.0,1,0,1,0.0,3,0.333,0,0.333,1.9,1,0,1,0.0,4,0.25,0,0.25,1.9,2021-22,Regular%20Season
1629635,Sekou Doumbouya,1610612747,LAL,2,0,2,16.0,2,1,1,0.5,2,1.0,0,1.0,5.3,4,2,2,0.5,4,1.0,0,1.0,9.2,6,3,3,0.5,6,1.0,0,1.0,7.9,2021-22,Regular%20Season
1628400,Semi Ojeleye,1610612746,LAC,19,6,13,331.0,27,15,12,0.556,65,0.415,1,0.422,6.8,47,11,36,0.234,71,0.662,3,0.691,6.6,74,26,48,0.351,131,0.565,4,0.583,6.6,2021-22,Regular%20Season
201586,Serge Ibaka,1610612749,MIL,51,28,23,847.0,60,38,22,0.633,140,0.429,4,0.441,6.4,184,67,117,0.364,289,0.637,28,0.705,4.6,244,105,139,0.43,421,0.58,32,0.627,5.1,2021-22,Regular%20Season
203552,Seth Curry,1610612751,BKN,58,34,24,1970.0,21,7,14,0.333,51,0.412,1,0.42,18.7,179,16,163,0.089,295,0.607,26,0.665,9.2,200,23,177,0.115,340,0.588,27,0.639,10.2,2021-22,Regular%20Season
1628983,Shai Gilgeous-Alexander,1610612760,OKC,56,16,40,1942.0,37,17,20,0.459,112,0.33,5,0.346,10.2,241,47,194,0.195,364,0.662,27,0.715,7.5,278,64,214,0.23,461,0.603,32,0.648,7.8,2021-22,Regular%20Season
1629003,Shake Milton,1610612755,PHI,49,31,18,1096.0,29,9,19,0.31,65,0.446,3,0.468,11.7,112,16,96,0.143,172,0.651,14,0.709,8.2,141,25,115,0.177,234,0.603,17,0.65,8.9,2021-22,Regular%20Season
1629783,Shaq Buchanan,1610612763,MEM,1,1,0,7.0,1,1,0,1.0,2,0.5,0,0.5,1.8,1,0,1,0.0,1,1.0,0,1.0,2.7,2,1,1,0.5,3,0.667,0,0.667,2.2,2021-22,Regular%20Season
1627885,Shaquille Harrison,1610612751,BKN,1,0,1,21.0,1,0,1,0.0,1,1.0,0,1.0,7.6,3,1,2,0.333,5,0.6,0,0.6,8.8,4,1,3,0.25,6,0.667,0,0.667,8.5,2021-22,Regular%20Season
1630536,Sharife Cooper,1610612737,ATL,3,0,3,19.0,0,0,0,0.0,2,0.0,0,0.0,0.0,5,1,4,0.2,5,1.0,0,1.0,5.7,5,1,4,0.2,7,0.714,0,0.714,5.7,2021-22,Regular%20Season
1630219,Skylar Mays,1610612737,ATL,10,6,4,145.0,5,4,1,0.8,10,0.5,0,0.5,10.7,20,1,19,0.05,32,0.625,4,0.714,8.9,25,5,20,0.2,40,0.625,4,0.694,9.3,2021-22,Regular%20Season
203524,Solomon Hill,1610612737,ATL,11,5,6,135.0,6,4,3,0.667,15,0.4,1,0.429,7.2,17,1,16,0.059,30,0.567,6,0.708,5.7,23,5,19,0.217,44,0.523,7,0.622,6.1,2021-22,Regular%20Season
203915,Spencer Dinwiddie,1610612742,DAL,66,37,29,1960.0,45,24,21,0.533,106,0.425,5,0.446,11.5,234,41,194,0.175,358,0.654,31,0.716,7.9,279,65,215,0.233,462,0.604,36,0.655,8.5,2021-22,Regular%20Season
1626169,Stanley Johnson,1610612747,LAL,45,16,29,1053.0,34,22,12,0.647,92,0.37,3,0.382,9.5,121,34,87,0.281,228,0.531,23,0.59,6.3,155,56,99,0.361,307,0.505,26,0.552,7.0,2021-22,Regular%20Season
201939,Stephen Curry,1610612744,GSW,64,45,19,2211.0,34,16,18,0.471,103,0.33,5,0.347,11.9,301,43,258,0.143,482,0.624,54,0.703,7.2,335,59,276,0.176,585,0.573,59,0.637,7.7,2021-22,Regular%20Season
1628425,Sterling Brown,1610612742,DAL,42,25,17,572.0,26,14,12,0.538,60,0.433,2,0.448,7.8,123,19,103,0.154,200,0.615,19,0.68,5.6,149,33,115,0.221,250,0.596,21,0.651,6.0,2021-22,Regular%20Season
203500,Steven Adams,1610612763,MEM,75,50,25,1977.0,344,254,88,0.738,667,0.516,16,0.528,4.1,402,134,269,0.333,669,0.601,78,0.68,4.3,746,388,357,0.52,1313,0.568,94,0.612,4.2,2021-22,Regular%20Season
1629004,Svi Mykhailiuk,1610612761,TOR,34,18,16,554.0,20,9,11,0.45,45,0.444,3,0.476,11.0,72,9,63,0.125,111,0.649,8,0.699,7.8,92,18,74,0.196,151,0.609,11,0.657,8.5,2021-22,Regular%20Season
204456,T.J. McConnell,1610612754,IND,24,8,16,605.0,20,7,13,0.35,43,0.465,0,0.465,12.4,70,10,59,0.143,121,0.579,8,0.619,8.3,90,17,72,0.189,163,0.552,8,0.581,9.3,2021-22,Regular%20Season
1629605,Tacko Fall,1610612739,CLE,6,2,4,48.0,7,7,0,1.0,17,0.412,0,0.412,4.8,16,3,13,0.188,23,0.696,0,0.696,4.0,23,10,13,0.435,38,0.605,0,0.605,4.2,2021-22,Regular%20Season
201959,Taj Gibson,1610612752,NYK,47,22,25,889.0,86,63,23,0.733,160,0.538,5,0.555,4.7,139,39,100,0.281,264,0.527,21,0.572,5.6,225,102,123,0.453,413,0.545,26,0.581,5.2,2021-22,Regular%20Season
1629659,Talen Horton-Tucker,1610612747,LAL,56,22,34,1434.0,37,14,23,0.378,95,0.389,0,0.389,10.7,156,39,117,0.25,269,0.58,30,0.653,7.4,193,53,140,0.275,349,0.553,30,0.605,8.0,2021-22,Regular%20Season
1627752,Taurean Prince,1610612750,MIN,60,38,22,1044.0,26,15,12,0.577,68,0.382,1,0.388,10.2,148,23,125,0.155,230,0.643,21,0.708,8.2,174,38,137,0.218,284,0.613,22,0.664,8.5,2021-22,Regular%20Season
1629611,Terance Mann,1610612746,LAC,79,40,39,2257.0,104,53,49,0.51,228,0.456,5,0.466,7.2,317,70,245,0.221,503,0.63,44,0.691,5.7,421,123,294,0.292,714,0.59,49,0.633,6.1,2021-22,Regular%20Season
1629056,Terence Davis,1610612758,SAC,24,7,17,464.0,11,7,4,0.636,36,0.306,1,0.314,5.8,79,20,59,0.253,128,0.617,11,0.675,6.9,90,27,63,0.3,159,0.566,12,0.612,6.7,2021-22,Regular%20Season
203082,Terrence Ross,1610612753,ORL,57,13,44,1335.0,20,6,14,0.3,53,0.377,2,0.392,17.9,141,17,124,0.121,204,0.691,11,0.731,7.8,161,23,138,0.143,247,0.652,13,0.688,9.1,2021-22,Regular%20Season
1626179,Terry Rozier,1610612766,CHA,71,37,34,2395.0,56,21,34,0.375,143,0.392,12,0.427,13.2,258,47,211,0.182,424,0.608,43,0.677,7.3,314,68,245,0.217,564,0.557,55,0.617,8.3,2021-22,Regular%20Season
1630678,Terry Taylor,1610612754,IND,30,6,24,692.0,95,61,34,0.642,159,0.597,4,0.613,5.5,77,20,57,0.26,142,0.542,15,0.606,7.3,172,81,91,0.471,296,0.581,19,0.621,6.3,2021-22,Regular%20Season
201152,Thaddeus Young,1610612761,TOR,48,25,23,810.0,80,54,25,0.675,154,0.519,4,0.533,5.4,128,32,97,0.25,225,0.569,22,0.631,6.6,208,86,122,0.413,372,0.559,26,0.601,6.1,2021-22,Regular%20Season
203648,Thanasis Antetokounmpo,1610612749,MIL,30,14,16,422.0,40,27,13,0.675,97,0.412,2,0.421,6.3,61,16,45,0.262,100,0.61,9,0.67,6.4,101,43,58,0.426,188,0.537,11,0.571,6.4,2021-22,Regular%20Season
1630177,Theo Maledon,1610612760,OKC,43,12,31,818.0,20,8,12,0.4,47,0.426,1,0.435,12.1,111,13,97,0.117,179,0.62,13,0.669,8.5,131,21,109,0.16,225,0.582,14,0.621,9.1,2021-22,Regular%20Season
1629033,Theo Pinson,1610612742,DAL,9,5,4,117.0,2,0,2,0.0,7,0.286,1,0.333,29.7,19,8,11,0.421,31,0.613,4,0.704,5.9,21,8,13,0.381,37,0.568,5,0.656,8.2,2021-22,Regular%20Season
1628418,Thomas Bryant,1610612764,WAS,26,7,19,436.0,26,21,5,0.808,57,0.456,1,0.464,4.3,82,20,62,0.244,132,0.621,8,0.661,4.5,108,41,67,0.38,185,0.584,9,0.614,4.4,2021-22,Regular%20Season
204025,Tim Frazier,1610612739,CLE,8,1,7,173.0,5,0,5,0.0,14,0.357,0,0.357,12.0,14,1,13,0.071,30,0.467,4,0.538,8.0,19,1,18,0.053,44,0.432,4,0.475,9.0,2021-22,Regular%20Season
203501,Tim Hardaway Jr.,1610612742,DAL,41,24,17,1235.0,13,4,9,0.308,43,0.302,2,0.317,16.7,143,38,104,0.266,224,0.638,16,0.688,7.2,156,42,113,0.269,259,0.602,18,0.647,8.0,2021-22,Regular%20Season
1627789,Timothe Luwawu-Cabarrot,1610612737,ATL,34,17,17,618.0,17,2,15,0.118,42,0.405,1,0.415,12.2,65,16,49,0.246,126,0.516,9,0.556,7.0,82,18,64,0.22,165,0.497,10,0.529,8.1,2021-22,Regular%20Season
202699,Tobias Harris,1610612755,PHI,73,45,28,2543.0,77,48,28,0.623,236,0.326,5,0.333,6.6,419,76,344,0.181,664,0.631,59,0.693,6.0,496,124,372,0.25,876,0.566,64,0.611,6.1,2021-22,Regular%20Season
203107,Tomas Satoransky,1610612764,WAS,45,19,26,779.0,27,12,15,0.444,75,0.36,6,0.391,8.5,98,10,88,0.102,140,0.7,15,0.784,8.3,125,22,103,0.176,213,0.587,21,0.651,8.4,2021-22,Regular%20Season
1628396,Tony Bradley,1610612741,CHI,48,26,22,508.0,67,40,26,0.597,144,0.465,3,0.475,5.6,119,41,78,0.345,211,0.564,18,0.617,4.0,186,81,104,0.435,341,0.545,21,0.581,4.6,2021-22,Regular%20Season
203503,Tony Snell,1610612740,NOP,39,14,25,701.0,16,9,7,0.563,49,0.327,2,0.34,12.6,87,13,75,0.149,142,0.613,7,0.644,7.4,103,22,82,0.214,182,0.566,9,0.595,8.2,2021-22,Regular%20Season
1628470,Torrey Craig,1610612756,PHX,69,35,34,1503.0,86,48,35,0.558,202,0.426,8,0.443,6.7,224,40,185,0.179,355,0.631,32,0.693,6.0,310,88,220,0.284,524,0.592,40,0.64,6.2,2021-22,Regular%20Season
1629027,Trae Young,1610612737,ATL,73,38,35,2546.0,50,15,35,0.3,152,0.329,8,0.347,11.3,234,12,222,0.051,365,0.641,23,0.684,10.6,284,27,257,0.095,515,0.551,31,0.587,10.8,2021-22,Regular%20Season
1629309,Trayvon Palmer,1610612765,DET,1,0,1,17.0,0,0,0,0.0,0,0.0,0,0.0,0.0,2,1,1,0.5,5,0.4,0,0.4,7.1,2,1,1,0.5,5,0.4,0,0.4,7.1,2021-22,Regular%20Season
1630200,Tre Jones,1610612759,SAS,53,24,29,1012.0,29,7,22,0.241,79,0.367,1,0.372,10.0,126,15,111,0.119,200,0.63,18,0.692,8.8,155,22,133,0.142,279,0.556,19,0.596,9.1,2021-22,Regular%20Season
1630544,Tre Mann,1610612760,OKC,53,15,38,1233.0,25,7,18,0.28,76,0.329,5,0.352,13.8,146,32,114,0.219,227,0.643,9,0.67,7.1,171,39,132,0.228,297,0.576,14,0.604,8.1,2021-22,Regular%20Season
1629682,Tremont Waters,1610612764,WAS,2,0,2,42.0,0,0,0,0.0,0,0.0,0,0.0,0.0,4,1,2,0.25,6,0.667,0,0.667,10.8,4,1,2,0.25,6,0.667,0,0.667,10.8,2021-22,Regular%20Season
1630570,Trendon Watford,1610612757,POR,44,16,28,849.0,57,30,27,0.526,130,0.438,6,0.46,7.5,142,39,103,0.275,245,0.58,21,0.634,5.2,199,69,130,0.347,354,0.562,27,0.609,5.8,2021-22,Regular%20Season
1630235,Trent Forrest,1610612762,UTA,45,27,18,664.0,23,11,12,0.478,50,0.46,1,0.469,10.0,76,10,66,0.132,123,0.618,8,0.661,8.3,99,21,78,0.212,170,0.582,9,0.615,8.7,2021-22,Regular%20Season
1630243,Trevelin Queen,1610612745,HOU,7,0,7,63.0,7,6,1,0.857,9,0.778,1,0.875,7.8,9,4,5,0.444,13,0.692,1,0.75,6.6,16,10,6,0.625,21,0.762,2,0.842,7.1,2021-22,Regular%20Season
1630286,Trevon Scott,1610612739,CLE,1,1,0,9.0,1,1,0,1.0,3,0.333,0,0.333,8.1,1,0,1,0.0,3,0.333,0,0.333,6.9,2,1,1,0.5,6,0.333,0,0.333,7.5,2021-22,Regular%20Season
2772,Trevor Ariza,1610612747,LAL,23,8,15,451.0,10,5,5,0.5,19,0.526,0,0.526,8.0,72,10,62,0.139,102,0.706,8,0.766,6.8,82,15,67,0.183,119,0.689,8,0.739,7.0,2021-22,Regular%20Season
203504,Trey Burke,1610612742,DAL,22,12,10,328.0,4,0,4,0.0,9,0.444,0,0.444,25.3,29,4,25,0.138,45,0.644,2,0.674,9.2,33,4,29,0.121,54,0.611,2,0.635,11.2,2021-22,Regular%20Season
1626168,Trey Lyles,1610612758,SAC,72,19,53,1485.0,88,60,28,0.682,214,0.411,4,0.419,6.4,285,65,219,0.228,468,0.609,40,0.666,4.9,373,125,247,0.335,654,0.57,44,0.611,5.2,2021-22,Regular%20Season
1630530,Trey Murphy III,1610612740,NOP,51,25,26,810.0,47,24,23,0.511,109,0.431,4,0.448,8.5,100,21,78,0.21,157,0.637,12,0.69,7.5,147,45,101,0.306,258,0.57,16,0.607,7.8,2021-22,Regular%20Season
202684,Tristan Thompson,1610612741,CHI,52,17,35,857.0,116,96,20,0.828,299,0.388,12,0.404,4.0,166,44,121,0.265,269,0.617,30,0.695,5.2,282,140,141,0.496,558,0.505,42,0.547,4.7,2021-22,Regular%20Season
1628972,Troy Brown Jr.,1610612741,CHI,53,30,23,983.0,39,22,17,0.564,95,0.411,5,0.433,8.6,164,40,124,0.244,255,0.643,21,0.701,6.3,203,62,141,0.305,340,0.597,26,0.646,6.7,2021-22,Regular%20Season
1629660,Ty Jerome,1610612760,OKC,37,13,24,659.0,19,8,11,0.421,43,0.442,2,0.463,9.9,59,11,48,0.186,101,0.584,9,0.641,9.2,78,19,59,0.244,142,0.549,11,0.595,9.3,2021-22,Regular%20Season
1629076,Tyler Cook,1610612741,CHI,16,11,5,188.0,16,10,6,0.625,49,0.327,0,0.327,6.5,37,8,29,0.216,59,0.627,4,0.673,4.7,53,18,35,0.34,104,0.51,4,0.53,5.3,2021-22,Regular%20Season
1629639,Tyler Herro,1610612748,MIA,66,44,22,2151.0,32,8,24,0.25,127,0.252,7,0.267,14.3,297,44,255,0.148,488,0.609,46,0.672,7.4,329,52,279,0.158,598,0.55,53,0.604,8.1,2021-22,Regular%20Season
204020,Tyler Johnson,1610612759,SAS,5,1,4,80.0,3,0,3,0.0,6,0.5,0,0.5,24.6,9,2,7,0.222,17,0.529,1,0.563,10.0,12,2,10,0.167,22,0.545,1,0.571,13.6,2021-22,Regular%20Season
1630169,Tyrese Haliburton,1610612754,IND,76,25,51,2664.0,60,18,42,0.3,148,0.405,8,0.429,11.7,248,17,230,0.069,382,0.649,32,0.709,9.0,308,35,272,0.114,524,0.588,40,0.636,9.5,2021-22,Regular%20Season
1630178,Tyrese Maxey,1610612755,PHI,70,42,28,2490.0,26,8,18,0.308,92,0.283,6,0.302,15.6,214,24,189,0.112,357,0.599,33,0.66,9.5,240,32,207,0.133,443,0.542,39,0.594,10.2,2021-22,Regular%20Season
1627820,Tyrone Wallace,1610612740,NOP,5,4,1,65.0,0,0,0,0.0,0,0.0,0,0.0,0.0,8,2,6,0.25,12,0.667,1,0.727,5.5,8,2,6,0.25,12,0.667,1,0.727,5.5,2021-22,Regular%20Season
1626145,Tyus Jones,1610612763,MEM,62,47,15,1336.0,17,2,15,0.118,48,0.354,3,0.378,17.6,155,11,143,0.071,218,0.711,13,0.756,8.3,172,13,158,0.076,264,0.652,16,0.694,9.2,2021-22,Regular%20Season
1628962,Udoka Azubuike,1610612762,UTA,13,10,3,188.0,18,11,7,0.611,43,0.419,0,0.419,5.6,53,10,43,0.189,90,0.589,6,0.631,4.5,71,21,50,0.296,130,0.546,6,0.573,4.8,2021-22,Regular%20Season
2617,Udonis Haslem,1610612748,MIA,10,8,2,74.0,4,4,0,1.0,12,0.333,0,0.333,3.7,21,5,16,0.238,32,0.656,3,0.724,5.0,25,9,16,0.36,41,0.61,3,0.658,4.8,2021-22,Regular%20Season
1630586,Usman Garuba,1610612745,HOU,21,1,20,229.0,21,13,8,0.619,52,0.404,2,0.42,6.3,62,15,47,0.242,90,0.689,8,0.756,4.6,83,28,55,0.337,134,0.619,10,0.669,5.1,2021-22,Regular%20Season
1630176,Vernon Carey Jr.,1610612764,WAS,4,2,2,33.0,8,5,3,0.625,13,0.615,1,0.667,4.2,4,1,3,0.25,6,0.667,1,0.8,4.5,12,6,6,0.5,18,0.667,2,0.75,4.3,2021-22,Regular%20Season
203506,Victor Oladipo,1610612748,MIA,7,3,4,157.0,3,1,2,0.333,6,0.5,0,0.5,5.2,20,4,16,0.2,44,0.455,8,0.556,8.5,23,5,18,0.217,50,0.46,8,0.548,8.1,2021-22,Regular%20Season
1630249,Vit Krejci,1610612760,OKC,28,8,20,653.0,18,7,11,0.389,45,0.4,4,0.439,10.2,83,12,71,0.145,139,0.597,9,0.638,6.7,101,19,82,0.188,182,0.555,13,0.598,7.3,2021-22,Regular%20Season
1628427,Vlatko Cancar,1610612743,DEN,8,3,5,127.0,8,3,5,0.375,13,0.615,0,0.615,10.0,23,4,19,0.174,27,0.852,0,0.852,7.7,31,7,24,0.226,40,0.775,0,0.775,8.3,2021-22,Regular%20Season
201961,Wayne Ellington,1610612747,LAL,35,13,22,656.0,10,2,8,0.2,22,0.455,2,0.5,17.3,67,12,55,0.179,105,0.638,6,0.677,7.9,77,14,63,0.182,123,0.626,8,0.67,9.1,2021-22,Regular%20Season
1627782,Wayne Selden,1610612752,NYK,1,1,0,9.0,0,0,0,0.0,0,0.0,0,0.0,0.0,1,1,0,1.0,2,0.5,0,0.5,5.9,1,1,0,1.0,2,0.5,0,0.5,5.9,2021-22,Regular%20Season
1628976,Wendell Carter Jr.,1610612753,ORL,62,16,46,1852.0,139,101,37,0.727,340,0.409,11,0.422,5.5,509,146,361,0.287,766,0.664,60,0.721,4.7,648,247,398,0.381,1068,0.607,71,0.65,4.9,2021-22,Regular%20Season
1629117,Wenyen Gabriel,1610612747,LAL,24,8,16,351.0,37,27,11,0.73,83,0.446,4,0.468,4.4,58,20,38,0.345,93,0.624,6,0.667,6.3,95,47,49,0.495,169,0.562,10,0.597,5.5,2021-22,Regular%20Season
1628411,Wes Iwundu,1610612737,ATL,3,2,1,82.0,3,2,1,0.667,7,0.429,0,0.429,13.1,10,3,7,0.3,17,0.588,2,0.667,6.6,13,5,8,0.385,24,0.542,2,0.591,8.1,2021-22,Regular%20Season
202083,Wesley Matthews,1610612749,MIL,42,30,12,910.0,30,13,18,0.433,63,0.476,2,0.492,9.6,62,14,48,0.226,125,0.496,12,0.549,10.1,92,27,66,0.293,180,0.511,14,0.554,9.9,2021-22,Regular%20Season
203115,Will Barton,1610612743,DEN,71,41,30,2276.0,44,26,18,0.591,118,0.373,4,0.386,6.5,296,34,262,0.115,486,0.609,55,0.687,6.0,340,60,280,0.176,588,0.578,59,0.643,6.1,2021-22,Regular%20Season
1626161,Willie Cauley-Stein,1610612755,PHI,17,9,8,170.0,13,7,6,0.538,29,0.448,2,0.481,4.1,27,8,17,0.296,53,0.509,5,0.563,5.1,40,15,23,0.375,77,0.519,7,0.571,4.7,2021-22,Regular%20Season
1626195,Willy Hernangomez,1610612740,NOP,49,22,27,839.0,143,95,47,0.664,274,0.522,6,0.534,5.2,195,46,147,0.236,285,0.684,19,0.733,4.1,338,141,194,0.417,541,0.625,25,0.655,4.5,2021-22,Regular%20Season
1629875,Xavier Moon,1610612746,LAC,6,4,2,112.0,2,0,2,0.0,8,0.25,0,0.25,10.9,12,4,8,0.333,26,0.462,4,0.545,10.0,14,4,10,0.286,34,0.412,4,0.467,10.1,2021-22,Regular%20Season
1630270,Xavier Sneed,1610612762,UTA,5,4,1,23.0,2,1,1,0.5,2,1.0,0,1.0,5.2,4,3,1,0.75,6,0.667,0,0.667,4.8,6,4,2,0.667,8,0.75,0,0.75,4.9,2021-22,Regular%20Season
1630214,Xavier Tillman,1610612763,MEM,40,24,16,610.0,66,40,26,0.606,143,0.462,4,0.475,6.9,95,28,66,0.295,142,0.669,10,0.72,6.1,161,68,92,0.422,275,0.585,14,0.617,6.5,2021-22,Regular%20Season
1629139,Yuta Watanabe,1610612761,TOR,28,14,14,416.0,18,9,9,0.5,47,0.383,1,0.391,8.6,74,17,56,0.23,112,0.661,15,0.763,6.6,92,26,65,0.283,155,0.594,16,0.662,7.0,2021-22,Regular%20Season
1630582,Yves Pons,1610612763,MEM,7,4,3,62.0,5,1,4,0.2,10,0.5,0,0.5,12.7,7,1,6,0.143,13,0.538,0,0.538,7.0,12,2,10,0.167,22,0.545,0,0.545,9.4,2021-22,Regular%20Season
1628380,Zach Collins,1610612759,SAS,27,14,13,492.0,46,30,16,0.652,128,0.359,2,0.365,6.2,107,30,77,0.28,189,0.566,21,0.637,4.2,153,60,93,0.392,305,0.502,23,0.543,4.8,2021-22,Regular%20Season
203897,Zach LaVine,1610612741,CHI,67,37,30,2328.0,22,8,14,0.364,110,0.2,6,0.212,9.6,286,44,244,0.154,449,0.637,38,0.696,6.1,308,52,258,0.169,550,0.56,44,0.609,6.3,2021-22,Regular%20Season
1630285,Zavier Simpson,1610612760,OKC,4,1,3,174.0,2,0,2,0.0,13,0.154,2,0.182,30.1,19,3,16,0.158,25,0.76,0,0.76,9.6,21,3,18,0.143,36,0.583,2,0.618,11.6,2021-22,Regular%20Season
1630192,Zeke Nnaji,1610612743,DEN,35,21,14,647.0,56,39,16,0.696,126,0.444,7,0.471,5.9,91,27,63,0.297,152,0.599,14,0.659,4.8,147,66,79,0.449,268,0.549,21,0.595,5.2,2021-22,Regular%20Season
1630533,Ziaire Williams,1610612763,MEM,50,34,16,1127.0,26,8,18,0.308,62,0.419,6,0.464,10.4,103,12,91,0.117,150,0.687,12,0.746,8.9,129,20,109,0.155,208,0.62,18,0.679,9.2,2021-22,Regular%20Season
203932,Aaron Gordon,1610612743,DEN,5,1,4,160.0,18,12,5,0.667,27,0.667,1,0.692,6.5,18,6,12,0.333,30,0.6,2,0.643,5.4,36,18,17,0.5,55,0.655,3,0.692,5.9,2021-22,Playoffs
1628988,Aaron Holiday,1610612756,PHX,2,2,0,10.0,3,1,2,0.333,3,1.0,0,1.0,12.5,0,0,0,0.0,0,0.0,0,0.0,0.0,3,1,2,0.333,3,1.0,0,1.0,12.5,2021-22,Playoffs
1630174,Aaron Nesmith,1610612738,BOS,10,6,4,48.0,4,2,2,0.5,6,0.667,0,0.667,15.1,11,4,7,0.364,15,0.733,1,0.786,6.4,15,6,9,0.4,20,0.75,1,0.789,8.7,2021-22,Playoffs
201143,Al Horford,1610612738,BOS,23,14,9,815.0,35,26,9,0.743,84,0.417,2,0.427,6.6,179,56,122,0.313,277,0.646,21,0.699,6.2,214,82,131,0.383,357,0.599,23,0.641,6.2,2021-22,Playoffs
1627936,Alex Caruso,1610612741,CHI,4,1,3,113.0,2,1,1,0.5,6,0.333,1,0.4,8.6,9,2,7,0.222,19,0.474,3,0.563,8.9,11,3,8,0.273,25,0.44,4,0.524,8.9,2021-22,Playoffs
203083,Andre Drummond,1610612751,BKN,4,0,4,60.0,3,3,0,1.0,13,0.231,1,0.25,2.9,9,2,7,0.222,18,0.5,4,0.643,6.3,12,5,7,0.417,29,0.414,5,0.5,5.5,2021-22,Playoffs
2738,Andre Iguodala,1610612744,GSW,3,2,1,42.0,3,1,2,0.333,3,1.0,0,1.0,5.1,4,2,2,0.5,7,0.571,0,0.571,5.5,7,3,4,0.429,10,0.7,0,0.7,5.3,2021-22,Playoffs
203952,Andrew Wiggins,1610612744,GSW,22,16,6,767.0,54,32,22,0.593,95,0.568,4,0.593,7.5,111,29,82,0.261,185,0.6,16,0.657,6.4,165,61,104,0.37,273,0.604,20,0.652,6.7,2021-22,Playoffs
1630162,Anthony Edwards,1610612750,MIN,6,2,4,227.0,4,1,3,0.25,14,0.286,0,0.286,12.7,21,3,18,0.143,40,0.525,1,0.538,9.5,25,4,21,0.16,49,0.51,1,0.521,10.0,2021-22,Playoffs
1629717,Armoni Brooks,1610612761,TOR,1,0,1,3.0,0,0,0,0.0,0,0.0,0,0.0,0.0,2,0,2,0.0,2,1.0,0,1.0,5.6,2,0,2,0.0,2,1.0,0,1.0,5.6,2021-22,Playoffs
203085,Austin Rivers,1610612743,DEN,3,0,3,68.0,0,0,0,0.0,1,0.0,0,0.0,0.0,3,1,2,0.333,5,0.6,1,0.75,4.8,3,1,2,0.333,6,0.5,1,0.6,4.8,2021-22,Playoffs
1630245,Ayo Dosunmu,1610612741,CHI,5,1,4,86.0,4,1,3,0.25,7,0.571,0,0.571,17.6,9,1,8,0.111,17,0.529,2,0.6,10.3,13,2,11,0.154,22,0.591,2,0.65,12.6,2021-22,Playoffs
1628389,Bam Adebayo,1610612748,MIA,18,11,7,614.0,37,25,12,0.676,105,0.352,3,0.363,5.7,107,33,74,0.308,162,0.66,8,0.695,5.3,144,58,86,0.403,264,0.545,11,0.569,5.4,2021-22,Playoffs
202687,Bismack Biyombo,1610612756,PHX,7,3,4,78.0,8,5,3,0.625,21,0.381,2,0.421,5.8,11,2,9,0.182,24,0.458,4,0.55,8.8,19,7,12,0.368,42,0.452,6,0.528,7.5,2021-22,Playoffs
201933,Blake Griffin,1610612751,BKN,2,0,2,25.0,2,2,0,1.0,9,0.222,1,0.25,4.8,2,1,1,0.5,4,0.5,1,0.667,4.4,4,3,1,0.75,12,0.333,2,0.4,4.6,2021-22,Playoffs
1626246,Boban Marjanovic,1610612742,DAL,2,2,0,3.0,0,0,0,0.0,0,0.0,0,0.0,0.0,3,1,2,0.333,3,1.0,0,1.0,2.8,3,1,2,0.333,3,1.0,0,1.0,2.8,2021-22,Playoffs
1626171,Bobby Portis,1610612749,MIL,12,7,5,298.0,25,17,8,0.68,59,0.424,0,0.424,5.8,95,18,77,0.189,124,0.766,6,0.805,4.7,120,35,85,0.292,177,0.678,6,0.702,4.9,2021-22,Playoffs
203992,Bogdan Bogdanovic,1610612737,ATL,4,1,3,107.0,4,2,2,0.5,9,0.444,0,0.444,9.3,15,3,12,0.2,19,0.789,3,0.938,6.8,19,5,14,0.263,28,0.679,3,0.76,7.3,2021-22,Playoffs
202711,Bojan Bogdanovic,1610612762,UTA,6,2,4,214.0,3,1,2,0.333,10,0.3,0,0.3,14.0,22,3,19,0.136,31,0.71,1,0.733,6.7,25,4,21,0.16,41,0.61,1,0.625,7.5,2021-22,Playoffs
1630538,Bones Hyland,1610612743,DEN,4,1,3,70.0,1,0,1,0.0,3,0.333,0,0.333,8.8,9,1,8,0.111,15,0.6,0,0.6,7.0,10,1,9,0.1,18,0.556,0,0.556,7.1,2021-22,Playoffs
1629634,Brandon Clarke,1610612763,MEM,12,6,6,296.0,37,30,6,0.811,92,0.402,2,0.411,5.3,46,13,34,0.283,84,0.548,6,0.59,5.5,83,43,40,0.518,174,0.477,8,0.5,5.4,2021-22,Playoffs
1627742,Brandon Ingram,1610612740,NOP,6,2,4,236.0,4,3,1,0.75,13,0.308,2,0.364,6.8,33,7,26,0.212,49,0.673,4,0.733,5.5,37,10,27,0.27,62,0.597,6,0.661,5.6,2021-22,Playoffs
201572,Brook Lopez,1610612749,MIL,12,7,5,332.0,27,17,11,0.63,54,0.5,0,0.5,4.4,44,12,32,0.273,78,0.564,10,0.647,6.1,71,29,43,0.408,125,0.568,10,0.617,5.4,2021-22,Playoffs
1628971,Bruce Brown,1610612751,BKN,4,0,4,139.0,6,1,5,0.167,17,0.353,0,0.353,8.8,13,1,12,0.077,25,0.52,2,0.565,7.9,19,2,17,0.105,42,0.452,2,0.475,8.2,2021-22,Playoffs
1627854,Bryn Forbes,1610612743,DEN,3,1,2,46.0,1,1,0,1.0,1,1.0,0,1.0,11.5,2,0,2,0.0,5,0.4,0,0.4,6.0,3,1,2,0.333,6,0.5,0,0.5,7.8,2021-22,Playoffs
203468,CJ McCollum,1610612740,NOP,6,2,4,234.0,11,6,5,0.545,16,0.688,0,0.688,12.5,29,3,26,0.103,34,0.853,1,0.879,9.4,40,9,31,0.225,49,0.816,1,0.833,10.3,2021-22,Playoffs
1628997,Caleb Martin,1610612748,MIA,13,9,4,179.0,12,3,9,0.25,31,0.387,1,0.4,8.5,25,7,18,0.28,36,0.694,3,0.758,6.7,37,10,27,0.27,63,0.587,4,0.627,7.2,2021-22,Playoffs
1629661,Cameron Johnson,1610612756,PHX,13,7,6,320.0,9,7,2,0.778,25,0.36,2,0.391,7.8,37,11,26,0.297,68,0.544,5,0.587,7.5,46,18,28,0.391,90,0.511,7,0.554,7.6,2021-22,Playoffs
1626166,Cameron Payne,1610612756,PHX,11,7,4,140.0,2,1,1,0.5,5,0.4,0,0.4,12.4,18,1,17,0.056,29,0.621,0,0.621,9.1,20,2,18,0.1,32,0.625,0,0.625,9.4,2021-22,Playoffs
1629646,Charles Bassey,1610612755,PHI,3,0,3,12.0,1,1,0,1.0,7,0.143,0,0.143,4.6,4,0,4,0.0,5,0.8,1,1.0,4.6,5,1,4,0.2,10,0.5,1,0.556,4.6,2021-22,Playoffs
1628449,Chris Boucher,1610612761,TOR,6,2,4,130.0,12,8,4,0.667,18,0.667,0,0.667,5.3,23,4,19,0.174,37,0.622,2,0.657,6.2,35,12,23,0.343,55,0.636,2,0.66,5.9,2021-22,Playoffs
101108,Chris Paul,1610612756,PHX,13,7,6,448.0,7,3,4,0.429,15,0.467,0,0.467,15.7,47,10,37,0.213,85,0.553,7,0.603,8.0,54,13,41,0.241,98,0.551,7,0.593,9.0,2021-22,Playoffs
203991,Clint Capela,1610612737,ATL,2,0,2,40.0,4,4,0,1.0,13,0.308,1,0.333,4.9,11,5,6,0.455,16,0.688,0,0.688,3.6,15,9,6,0.6,28,0.536,1,0.556,4.0,2021-22,Playoffs
1629632,Coby White,1610612741,CHI,4,0,4,89.0,0,0,0,0.0,1,0.0,0,0.0,0.0,17,4,13,0.235,24,0.708,3,0.81,6.0,17,4,13,0.235,24,0.708,3,0.81,6.0,2021-22,Playoffs
1626156,D'Angelo Russell,1610612750,MIN,6,2,4,196.0,0,0,0,0.0,3,0.0,0,0.0,0.0,15,0,15,0.0,26,0.577,1,0.6,12.5,15,0,15,0.0,29,0.517,1,0.536,12.5,2021-22,Playoffs
1630625,Dalano Banton,1610612761,TOR,1,0,1,2.0,2,1,1,0.5,2,1.0,0,1.0,15.2,0,0,0,0.0,0,0.0,0,0.0,0.0,2,1,1,0.5,2,1.0,0,1.0,15.2,2021-22,Playoffs
1627814,Damion Lee,1610612744,GSW,9,6,3,105.0,5,4,1,0.8,8,0.625,0,0.625,10.9,21,5,16,0.238,31,0.677,4,0.778,7.9,26,9,17,0.346,38,0.684,4,0.765,8.5,2021-22,Playoffs
1628464,Daniel Theis,1610612738,BOS,15,9,6,194.0,13,10,3,0.769,30,0.433,0,0.433,4.5,39,17,22,0.436,65,0.6,7,0.672,4.7,52,27,25,0.519,95,0.547,7,0.591,4.7,2021-22,Playoffs
201568,Danilo Gallinari,1610612737,ATL,4,1,3,91.0,2,1,1,0.5,3,0.667,0,0.667,9.3,19,6,13,0.316,25,0.76,0,0.76,7.1,21,7,14,0.333,28,0.75,0,0.75,7.3,2021-22,Playoffs
201980,Danny Green,1610612755,PHI,11,6,5,316.0,9,3,6,0.333,28,0.321,1,0.333,11.4,28,8,20,0.286,42,0.667,5,0.757,7.5,37,11,26,0.297,69,0.536,6,0.587,8.5,2021-22,Playoffs
1627863,Danuel House Jr.,1610612762,UTA,6,2,4,112.0,2,0,2,0.0,2,1.0,0,1.0,6.8,15,2,13,0.133,23,0.652,2,0.714,8.0,17,2,15,0.118,25,0.68,2,0.739,7.8,2021-22,Playoffs
202722,Davis Bertans,1610612742,DAL,16,7,9,183.0,4,1,3,0.25,14,0.286,1,0.308,17.6,22,7,15,0.318,39,0.564,5,0.647,8.7,26,8,18,0.308,51,0.51,6,0.578,10.1,2021-22,Playoffs
1629631,De'Andre Hunter,1610612737,ATL,4,0,4,143.0,2,0,2,0.0,10,0.2,0,0.2,13.8,17,4,13,0.235,44,0.386,4,0.425,5.4,19,4,15,0.211,51,0.373,4,0.404,6.3,2021-22,Playoffs
1629001,De'Anthony Melton,1610612763,MEM,10,4,6,170.0,9,2,7,0.222,17,0.529,1,0.563,18.5,22,2,20,0.091,34,0.647,2,0.688,8.1,31,4,27,0.129,48,0.646,3,0.689,11.1,2021-22,Playoffs
201599,DeAndre Jordan,1610612755,PHI,2,0,2,31.0,1,1,0,1.0,3,0.333,0,0.333,2.6,6,3,3,0.5,9,0.667,0,0.667,4.4,7,4,3,0.571,12,0.583,0,0.583,4.1,2021-22,Playoffs
201942,DeMar DeRozan,1610612741,CHI,5,1,4,203.0,1,1,0,1.0,12,0.083,1,0.091,8.2,26,3,23,0.115,39,0.667,3,0.722,6.8,27,4,23,0.148,49,0.551,4,0.6,6.9,2021-22,Playoffs
202326,DeMarcus Cousins,1610612743,DEN,5,1,4,57.0,3,2,1,0.667,11,0.273,0,0.273,3.6,14,2,12,0.143,16,0.875,0,0.875,3.4,17,4,13,0.235,25,0.68,0,0.68,3.4,2021-22,Playoffs
1629028,Deandre Ayton,1610612756,PHX,13,7,6,397.0,33,22,11,0.667,69,0.478,1,0.485,5.4,83,24,59,0.289,143,0.58,14,0.643,4.1,116,46,70,0.397,199,0.583,15,0.63,4.4,2021-22,Playoffs
1626153,Delon Wright,1610612737,ATL,5,1,4,137.0,11,6,5,0.545,17,0.647,0,0.647,7.1,13,3,10,0.231,19,0.684,1,0.722,7.6,24,9,15,0.375,35,0.686,1,0.706,7.4,2021-22,Playoffs
1627884,Derrick Jones Jr.,1610612741,CHI,5,1,4,59.0,3,2,1,0.667,7,0.429,0,0.429,3.6,4,2,2,0.5,8,0.5,1,0.571,4.9,7,4,3,0.571,15,0.467,1,0.5,4.3,2021-22,Playoffs
1628401,Derrick White,1610612738,BOS,22,13,9,556.0,8,3,5,0.375,32,0.25,0,0.25,11.0,62,14,48,0.226,96,0.646,6,0.689,7.6,70,17,53,0.243,123,0.569,6,0.598,8.0,2021-22,Playoffs
1630217,Desmond Bane,1610612763,MEM,12,6,6,428.0,5,2,4,0.4,37,0.135,1,0.139,12.1,40,7,32,0.175,69,0.58,8,0.656,6.7,45,9,36,0.2,102,0.441,9,0.484,7.4,2021-22,Playoffs
1626164,Devin Booker,1610612756,PHX,10,5,5,366.0,10,4,6,0.4,25,0.4,0,0.4,9.2,38,3,35,0.079,76,0.5,9,0.567,8.4,48,7,41,0.146,100,0.48,9,0.527,8.6,2021-22,Playoffs
1628984,Devonte' Graham,1610612740,NOP,4,1,3,48.0,2,1,1,0.5,4,0.5,0,0.5,9.2,7,1,6,0.143,11,0.636,1,0.7,8.2,9,2,7,0.222,15,0.6,1,0.643,8.4,2021-22,Playoffs
203473,Dewayne Dedmon,1610612748,MIA,12,8,4,130.0,15,10,5,0.667,30,0.5,0,0.5,3.7,27,8,19,0.296,42,0.643,3,0.692,4.1,42,18,24,0.429,69,0.609,3,0.636,4.0,2021-22,Playoffs
1628415,Dillon Brooks,1610612763,MEM,10,5,5,332.0,8,3,5,0.375,25,0.32,3,0.364,11.6,22,6,16,0.273,44,0.5,6,0.579,8.0,30,9,21,0.3,69,0.435,9,0.5,8.9,2021-22,Playoffs
1628378,Donovan Mitchell,1610612762,UTA,6,2,4,229.0,6,5,1,0.833,14,0.429,1,0.462,5.7,20,4,16,0.2,35,0.571,3,0.625,8.1,26,9,17,0.346,49,0.531,4,0.578,7.6,2021-22,Playoffs
1627827,Dorian Finney-Smith,1610612742,DAL,18,9,9,688.0,32,17,15,0.531,64,0.5,3,0.525,9.0,67,19,48,0.284,125,0.536,14,0.604,5.7,99,36,63,0.364,183,0.541,17,0.596,6.7,2021-22,Playoffs
203110,Draymond Green,1610612744,GSW,22,16,6,703.0,26,10,16,0.385,64,0.406,2,0.419,9.7,133,45,89,0.338,238,0.559,21,0.613,4.7,159,55,105,0.346,291,0.546,23,0.593,5.5,2021-22,Playoffs
1629130,Duncan Robinson,1610612748,MIA,10,6,4,138.0,2,1,1,0.5,5,0.4,1,0.5,20.3,21,4,17,0.19,29,0.724,1,0.75,6.3,23,5,18,0.217,33,0.697,2,0.742,7.5,2021-22,Playoffs
203939,Dwight Powell,1610612742,DAL,17,9,8,236.0,17,9,8,0.529,74,0.23,5,0.246,6.9,30,10,20,0.333,57,0.526,7,0.6,5.8,47,19,28,0.404,129,0.364,12,0.402,6.2,2021-22,Playoffs
1629672,Eric Paschall,1610612762,UTA,4,1,3,24.0,1,0,1,0.0,5,0.2,0,0.2,7.9,4,1,3,0.25,9,0.444,2,0.571,10.8,5,1,4,0.2,13,0.385,2,0.455,10.2,2021-22,Playoffs
1630267,Facundo Campazzo,1610612743,DEN,2,0,2,9.0,0,0,0,0.0,0,0.0,0,0.0,0.0,3,1,2,0.333,3,1.0,0,1.0,8.7,3,1,2,0.333,3,1.0,0,1.0,8.7,2021-22,Playoffs
1628373,Frank Ntilikina,1610612742,DAL,6,4,2,85.0,2,1,1,0.5,3,0.667,0,0.667,23.0,10,0,10,0.0,14,0.714,1,0.769,9.7,12,1,11,0.083,16,0.75,1,0.8,11.9,2021-22,Playoffs
1627832,Fred VanVleet,1610612761,TOR,4,1,3,140.0,2,0,2,0.0,6,0.333,1,0.4,25.0,10,3,7,0.3,22,0.455,4,0.556,10.4,12,3,9,0.25,28,0.429,5,0.522,12.8,2021-22,Playoffs
1627788,Furkan Korkmaz,1610612755,PHI,5,1,4,43.0,1,0,1,0.0,6,0.167,0,0.167,12.3,11,2,9,0.182,14,0.786,0,0.786,6.6,12,2,10,0.167,18,0.667,0,0.667,7.1,2021-22,Playoffs
1629216,Gabe Vincent,1610612748,MIA,15,10,5,380.0,3,1,2,0.333,16,0.188,1,0.2,26.7,32,6,26,0.188,64,0.5,4,0.533,8.3,35,7,28,0.2,78,0.449,5,0.479,9.9,2021-22,Playoffs
202066,Garrett Temple,1610612740,NOP,1,1,0,2.0,0,0,0,0.0,0,0.0,0,0.0,0.0,1,0,1,0.0,1,1.0,0,1.0,11.1,1,0,1,0.0,1,1.0,0,1.0,11.1,2021-22,Playoffs
1627780,Gary Payton II,1610612744,GSW,10,9,1,194.0,13,6,7,0.462,26,0.5,0,0.5,6.1,24,5,18,0.208,46,0.522,9,0.649,5.4,37,11,25,0.297,72,0.514,9,0.587,5.6,2021-22,Playoffs
1629018,Gary Trent Jr.,1610612761,TOR,5,2,3,159.0,1,0,1,0.0,5,0.2,0,0.2,23.1,9,3,7,0.333,18,0.5,0,0.5,9.6,10,3,8,0.3,23,0.435,0,0.435,10.8,2021-22,Playoffs
201588,George Hill,1610612749,MIL,4,1,3,66.0,1,1,0,1.0,7,0.143,0,0.143,3.1,5,1,4,0.2,11,0.455,2,0.556,9.1,6,2,4,0.333,18,0.333,2,0.375,8.1,2021-22,Playoffs
1627777,Georges Niang,1610612755,PHI,9,4,5,151.0,4,1,3,0.25,8,0.5,1,0.571,15.0,14,3,11,0.214,27,0.519,4,0.609,6.7,18,4,14,0.222,33,0.545,5,0.643,8.5,2021-22,Playoffs
203507,Giannis Antetokounmpo,1610612749,MIL,12,7,5,448.0,26,18,8,0.692,66,0.394,0,0.394,5.8,144,23,121,0.16,204,0.706,24,0.8,4.8,170,41,129,0.241,261,0.651,24,0.717,4.9,2021-22,Playoffs
201609,Goran Dragic,1610612751,BKN,4,0,4,79.0,6,1,5,0.167,9,0.667,0,0.667,13.4,12,1,11,0.083,18,0.667,1,0.706,7.7,18,2,16,0.111,27,0.667,1,0.692,9.6,2021-22,Playoffs
203476,Gorgui Dieng,1610612737,ATL,2,0,2,10.0,1,1,0,1.0,3,0.333,0,0.333,5.0,2,0,2,0.0,2,1.0,0,1.0,4.5,3,1,2,0.333,4,0.75,0,0.75,4.7,2021-22,Playoffs
1629684,Grant Williams,1610612738,BOS,24,14,10,654.0,23,12,11,0.522,83,0.277,1,0.28,6.6,68,24,44,0.353,145,0.469,19,0.54,5.6,91,36,55,0.396,225,0.404,20,0.444,5.8,2021-22,Playoffs
1628960,Grayson Allen,1610612749,MIL,12,7,5,305.0,5,0,5,0.0,16,0.313,0,0.313,23.0,30,2,28,0.067,48,0.625,5,0.698,8.4,35,2,33,0.057,63,0.556,5,0.603,10.4,2021-22,Playoffs
202328,Greg Monroe,1610612750,MIN,1,0,1,7.0,1,1,0,1.0,6,0.167,0,0.167,2.0,1,0,1,0.0,4,0.25,0,0.25,1.5,2,1,1,0.5,10,0.2,0,0.2,1.7,2021-22,Playoffs
202355,Hassan Whiteside,1610612762,UTA,6,2,4,65.0,8,6,2,0.75,20,0.4,0,0.4,3.4,23,6,17,0.261,31,0.742,3,0.821,4.3,31,12,19,0.387,49,0.633,3,0.674,4.1,2021-22,Playoffs
1629312,Haywood Highsmith,1610612748,MIA,4,1,3,18.0,2,2,0,1.0,5,0.4,0,0.4,5.6,3,0,3,0.0,4,0.75,1,1.0,6.5,5,2,3,0.4,9,0.556,1,0.625,6.2,2021-22,Playoffs
1630529,Herbert Jones,1610612740,NOP,6,2,4,226.0,8,4,4,0.5,19,0.421,1,0.444,8.8,12,3,9,0.25,25,0.48,3,0.545,8.1,20,7,13,0.35,43,0.465,4,0.513,8.4,2021-22,Playoffs
1629067,Isaac Bonga,1610612761,TOR,1,0,1,3.0,0,0,0,0.0,1,0.0,0,0.0,0.0,1,0,1,0.0,1,1.0,0,1.0,4.0,1,0,1,0.0,1,1.0,0,1.0,4.0,2021-22,Playoffs
1630198,Isaiah Joe,1610612755,PHI,2,0,2,3.0,0,0,0,0.0,0,0.0,0,0.0,0.0,2,0,2,0.0,2,1.0,0,1.0,9.3,2,0,2,0.0,2,1.0,0,1.0,9.3,2021-22,Playoffs
1630688,Ish Wainright,1610612756,PHX,4,1,3,18.0,7,3,4,0.429,11,0.636,0,0.636,7.1,4,1,3,0.25,5,0.8,0,0.8,14.2,11,4,7,0.364,15,0.733,0,0.733,9.7,2021-22,Playoffs
1629630,Ja Morant,1610612763,MEM,9,5,4,338.0,13,5,8,0.385,44,0.295,1,0.302,14.2,59,13,46,0.22,86,0.686,6,0.738,6.6,72,18,54,0.25,126,0.571,7,0.605,8.0,2021-22,Playoffs
203210,JaMychal Green,1610612743,DEN,3,1,2,46.0,3,2,1,0.667,11,0.273,0,0.273,4.4,9,0,9,0.0,16,0.563,1,0.6,5.6,12,2,10,0.167,23,0.522,1,0.545,5.3,2021-22,Playoffs
201580,JaVale McGee,1610612756,PHX,12,7,5,133.0,16,14,2,0.875,45,0.356,2,0.372,8.1,32,6,26,0.188,56,0.571,6,0.64,3.7,48,20,28,0.417,97,0.495,8,0.539,5.2,2021-22,Playoffs
1630183,Jaden McDaniels,1610612750,MIN,6,2,4,130.0,5,3,2,0.6,14,0.357,0,0.357,6.9,12,4,8,0.333,33,0.364,5,0.429,4.8,17,7,10,0.412,44,0.386,5,0.436,5.4,2021-22,Playoffs
1630531,Jaden Springer,1610612755,PHI,3,1,2,11.0,0,0,0,0.0,0,0.0,0,0.0,0.0,4,1,3,0.25,5,0.8,0,0.8,3.7,4,1,3,0.25,5,0.8,0,0.8,3.7,2021-22,Playoffs
203109,Jae Crowder,1610612756,PHX,13,7,6,383.0,8,4,4,0.5,23,0.348,1,0.364,10.2,53,11,42,0.208,88,0.602,4,0.631,5.6,61,15,46,0.246,107,0.57,5,0.598,6.2,2021-22,Playoffs
1628973,Jalen Brunson,1610612742,DAL,18,9,9,629.0,15,6,9,0.4,37,0.405,1,0.417,11.8,68,7,61,0.103,129,0.527,16,0.602,7.3,83,13,70,0.157,166,0.5,17,0.557,8.1,2021-22,Playoffs
201935,James Harden,1610612755,PHI,12,6,6,479.0,11,2,9,0.182,34,0.324,1,0.333,10.4,57,12,45,0.211,87,0.655,6,0.704,6.3,68,14,54,0.206,115,0.591,7,0.63,7.0,2021-22,Playoffs
1630215,Jared Butler,1610612762,UTA,1,0,1,5.0,0,0,0,0.0,0,0.0,0,0.0,0.0,1,0,1,0.0,2,0.5,0,0.5,11.5,1,0,1,0.0,2,0.5,0,0.5,11.5,2021-22,Playoffs
1628991,Jaren Jackson Jr.,1610612763,MEM,12,6,6,332.0,26,15,11,0.577,61,0.426,2,0.441,6.2,55,9,45,0.164,104,0.529,7,0.567,5.8,81,24,56,0.296,157,0.516,9,0.547,5.9,2021-22,Playoffs
1629020,Jarred Vanderbilt,1610612750,MIN,6,2,4,129.0,12,8,4,0.667,31,0.387,1,0.4,4.9,31,5,26,0.161,46,0.674,4,0.738,4.2,43,13,30,0.302,75,0.573,5,0.614,4.4,2021-22,Playoffs
1629633,Jarrett Culver,1610612763,MEM,3,2,1,22.0,2,2,0,1.0,4,0.5,0,0.5,3.7,5,0,5,0.0,5,1.0,0,1.0,4.7,7,2,5,0.286,9,0.778,0,0.778,4.4,2021-22,Playoffs
1629750,Javonte Green,1610612741,CHI,5,1,4,72.0,8,5,2,0.625,19,0.421,1,0.444,3.4,7,4,3,0.571,16,0.438,4,0.583,8.8,15,9,5,0.6,35,0.429,5,0.5,6.1,2021-22,Playoffs
1629637,Jaxson Hayes,1610612740,NOP,5,2,3,71.0,4,4,0,1.0,11,0.364,1,0.4,6.0,11,2,9,0.182,18,0.611,4,0.786,6.4,15,6,9,0.4,29,0.517,5,0.625,6.3,2021-22,Playoffs
1627759,Jaylen Brown,1610612738,BOS,24,14,10,920.0,33,12,21,0.364,78,0.423,2,0.434,13.6,133,26,106,0.195,217,0.613,22,0.682,6.4,166,38,127,0.229,284,0.585,24,0.638,7.8,2021-22,Playoffs
1628369,Jayson Tatum,1610612738,BOS,24,14,10,983.0,24,13,10,0.542,69,0.348,0,0.348,9.1,137,25,112,0.182,210,0.652,12,0.692,6.8,161,38,122,0.236,271,0.594,12,0.622,7.1,2021-22,Playoffs
201145,Jeff Green,1610612743,DEN,5,1,4,113.0,7,4,3,0.571,14,0.5,1,0.538,7.6,11,1,10,0.091,23,0.478,0,0.478,8.6,18,5,13,0.278,35,0.514,1,0.529,8.2,2021-22,Playoffs
1628975,Jevon Carter,1610612749,MIL,9,6,3,123.0,3,1,2,0.333,7,0.429,0,0.429,16.6,13,4,9,0.308,19,0.684,0,0.684,7.5,16,5,11,0.313,26,0.615,0,0.615,9.2,2021-22,Playoffs
202710,Jimmy Butler,1610612748,MIA,17,10,7,629.0,41,22,18,0.537,84,0.488,4,0.513,7.8,84,18,66,0.214,132,0.636,14,0.712,6.2,125,40,84,0.32,212,0.59,18,0.644,6.7,2021-22,Playoffs
203954,Joel Embiid,1610612755,PHI,10,6,4,385.0,21,15,6,0.714,60,0.35,1,0.356,5.6,86,22,64,0.256,144,0.597,9,0.637,5.0,107,37,70,0.346,198,0.54,10,0.569,5.1,2021-22,Playoffs
1628381,John Collins,1610612737,ATL,5,1,4,122.0,2,2,0,1.0,15,0.133,1,0.143,2.7,21,5,16,0.238,42,0.5,6,0.583,5.1,23,7,16,0.304,55,0.418,7,0.479,4.9,2021-22,Playoffs
1629723,John Konchar,1610612763,MEM,6,4,2,51.0,3,1,2,0.333,6,0.5,0,0.5,11.4,16,3,13,0.188,23,0.696,1,0.727,5.4,19,4,15,0.211,27,0.704,1,0.731,6.4,2021-22,Playoffs
202685,Jonas Valanciunas,1610612740,NOP,6,2,4,175.0,33,22,11,0.667,63,0.524,3,0.55,3.7,53,7,46,0.132,72,0.736,3,0.768,3.5,86,29,57,0.337,132,0.652,6,0.683,3.6,2021-22,Playoffs
1630228,Jonathan Kuminga,1610612744,GSW,8,4,4,105.0,4,1,3,0.25,15,0.267,0,0.267,6.2,23,2,21,0.087,35,0.657,4,0.742,6.3,27,3,24,0.111,46,0.587,4,0.643,6.3,2021-22,Playoffs
203903,Jordan Clarkson,1610612762,UTA,6,2,4,170.0,5,2,3,0.4,9,0.556,0,0.556,7.0,14,3,11,0.214,25,0.56,3,0.636,9.4,19,5,14,0.263,34,0.559,3,0.613,8.8,2021-22,Playoffs
1629162,Jordan McLaughlin,1610612750,MIN,4,1,3,74.0,0,0,0,0.0,4,0.0,0,0.0,0.0,12,4,8,0.333,16,0.75,0,0.75,8.7,12,4,8,0.333,20,0.6,0,0.6,8.7,2021-22,Playoffs
1629670,Jordan Nwora,1610612749,MIL,3,2,1,12.0,0,0,0,0.0,0,0.0,0,0.0,0.0,3,0,3,0.0,4,0.75,0,0.75,7.6,3,0,3,0.0,4,0.75,0,0.75,7.6,2021-22,Playoffs
1629673,Jordan Poole,1610612744,GSW,20,15,5,563.0,10,2,8,0.2,28,0.357,1,0.37,19.5,52,4,48,0.077,88,0.591,3,0.612,8.2,62,6,56,0.097,113,0.549,4,0.569,10.0,2021-22,Playoffs
1630631,Jose Alvarado,1610612740,NOP,5,1,4,100.0,2,0,2,0.0,7,0.286,1,0.333,13.0,6,2,4,0.333,15,0.4,1,0.429,8.5,8,2,6,0.25,21,0.381,2,0.421,9.6,2021-22,Playoffs
1630182,Josh Green,1610612742,DAL,9,3,6,91.0,1,0,1,0.0,7,0.143,2,0.2,14.8,11,0,11,0.0,20,0.55,1,0.579,7.4,12,0,12,0.0,27,0.444,3,0.5,8.0,2021-22,Playoffs
201950,Jrue Holiday,1610612749,MIL,12,7,5,463.0,12,8,4,0.667,42,0.286,2,0.3,8.9,55,11,44,0.2,73,0.753,3,0.786,8.6,67,19,48,0.284,113,0.593,5,0.62,8.7,2021-22,Playoffs
1629308,Juan Toscano-Anderson,1610612744,GSW,5,4,1,32.0,0,0,0,0.0,2,0.0,0,0.0,0.0,10,3,7,0.3,12,0.833,1,0.909,5.3,10,3,7,0.3,14,0.714,1,0.769,5.3,2021-22,Playoffs
1627823,Juancho Hernangomez,1610612762,UTA,5,2,3,50.0,2,1,1,0.5,4,0.5,0,0.5,9.8,10,2,8,0.2,12,0.833,0,0.833,5.6,12,3,9,0.25,16,0.75,0,0.75,6.3,2021-22,Playoffs
1629752,Juwan Morgan,1610612738,BOS,3,1,2,7.0,2,0,2,0.0,2,1.0,0,1.0,8.3,1,1,0,1.0,2,0.5,1,1.0,1.8,3,1,2,0.333,4,0.75,1,1.0,6.1,2021-22,Playoffs
1626157,Karl-Anthony Towns,1610612750,MIN,6,2,4,222.0,11,8,3,0.727,26,0.423,0,0.423,9.5,54,17,37,0.315,87,0.621,11,0.711,4.9,65,25,40,0.385,108,0.602,11,0.67,5.7,2021-22,Playoffs
201142,Kevin Durant,1610612751,BKN,4,0,4,176.0,2,0,2,0.0,7,0.286,1,0.333,17.9,21,6,15,0.286,36,0.583,2,0.618,7.6,23,6,17,0.261,43,0.535,3,0.575,8.5,2021-22,Playoffs
1628989,Kevin Huerter,1610612737,ATL,5,1,4,154.0,1,0,1,0.0,4,0.25,1,0.333,14.5,14,3,11,0.214,25,0.56,3,0.636,8.1,15,3,12,0.2,29,0.517,4,0.6,8.5,2021-22,Playoffs
1628995,Kevin Knox II,1610612737,ATL,1,0,1,5.0,0,0,0,0.0,0,0.0,0,0.0,0.0,2,0,2,0.0,2,1.0,0,1.0,3.5,2,0,2,0.0,2,1.0,0,1.0,3.5,2021-22,Playoffs
1626172,Kevon Looney,1610612744,GSW,22,16,6,448.0,63,39,24,0.619,118,0.534,2,0.543,5.8,105,40,65,0.381,158,0.665,8,0.7,4.8,168,79,89,0.47,269,0.625,10,0.649,5.2,2021-22,Playoffs
203920,Khem Birch,1610612761,TOR,5,2,3,55.0,4,4,0,1.0,10,0.4,0,0.4,5.8,5,2,3,0.4,15,0.333,3,0.417,3.8,9,6,3,0.667,25,0.36,3,0.409,4.7,2021-22,Playoffs
203114,Khris Middleton,1610612749,MIL,2,1,1,71.0,1,0,1,0.0,2,0.5,0,0.5,10.0,9,2,7,0.222,11,0.818,0,0.818,7.9,10,2,8,0.2,13,0.769,0,0.769,8.1,2021-22,Playoffs
202691,Klay Thompson,1610612744,GSW,22,16,6,792.0,7,4,3,0.571,34,0.206,2,0.219,15.6,79,19,60,0.241,150,0.527,15,0.585,7.0,86,23,63,0.267,174,0.494,17,0.548,7.7,2021-22,Playoffs
203937,Kyle Anderson,1610612763,MEM,12,6,6,221.0,10,3,7,0.3,21,0.476,0,0.476,10.2,42,8,34,0.19,69,0.609,5,0.656,5.4,52,11,41,0.212,86,0.605,5,0.642,6.3,2021-22,Playoffs
200768,Kyle Lowry,1610612748,MIA,10,4,6,295.0,3,2,1,0.667,19,0.158,0,0.158,13.5,33,6,26,0.182,71,0.465,8,0.524,6.8,36,8,27,0.222,90,0.4,8,0.439,7.3,2021-22,Playoffs
202681,Kyrie Irving,1610612751,BKN,4,0,4,170.0,6,2,4,0.333,11,0.545,0,0.545,8.8,15,3,12,0.2,32,0.469,2,0.5,5.8,21,5,16,0.238,42,0.5,2,0.525,6.7,2021-22,Playoffs
1629013,Landry Shamet,1610612756,PHX,9,5,4,159.0,3,0,3,0.0,9,0.333,0,0.333,29.6,17,2,15,0.118,26,0.654,3,0.739,12.3,20,2,18,0.1,34,0.588,3,0.645,14.9,2021-22,Playoffs
1626204,Larry Nance Jr.,1610612740,NOP,6,2,4,130.0,19,12,6,0.632,31,0.613,0,0.613,5.4,16,6,10,0.375,39,0.41,8,0.516,6.1,35,18,16,0.514,69,0.507,8,0.574,5.7,2021-22,Playoffs
1630492,Luca Vildoza,1610612749,MIL,2,1,1,10.0,1,1,0,1.0,1,1.0,0,1.0,5.0,1,0,1,0.0,1,1.0,0,1.0,8.2,2,1,1,0.5,2,1.0,0,1.0,6.6,2021-22,Playoffs
1629029,Luka Doncic,1610612742,DAL,15,7,8,552.0,10,6,4,0.6,57,0.175,2,0.182,10.7,137,31,106,0.226,189,0.725,8,0.757,4.7,147,37,110,0.252,230,0.639,10,0.668,5.1,2021-22,Playoffs
1628436,Luke Kornet,1610612738,BOS,4,2,2,9.0,1,0,1,0.0,1,1.0,0,1.0,6.7,4,0,4,0.0,5,0.8,0,0.8,5.5,5,0,5,0.0,5,1.0,0,1.0,5.8,2021-22,Playoffs
1630201,Malachi Flynn,1610612761,TOR,3,0,3,31.0,2,0,2,0.0,3,0.667,0,0.667,15.9,1,0,1,0.0,2,0.5,0,0.5,11.0,3,0,3,0.0,5,0.6,0,0.6,14.3,2021-22,Playoffs
1627736,Malik Beasley,1610612750,MIN,6,2,4,119.0,2,2,0,1.0,7,0.286,0,0.286,4.1,18,4,14,0.222,25,0.72,0,0.72,9.1,20,6,14,0.3,32,0.625,0,0.625,8.6,2021-22,Playoffs
1630238,Malik Fitts,1610612738,BOS,2,1,1,4.0,0,0,0,0.0,0,0.0,0,0.0,0.0,2,0,2,0.0,2,1.0,0,1.0,9.2,2,0,2,0.0,2,1.0,0,1.0,9.2,2021-22,Playoffs
203935,Marcus Smart,1610612738,BOS,21,12,9,760.0,20,10,10,0.5,48,0.417,3,0.444,7.3,75,17,58,0.227,129,0.581,11,0.636,9.4,95,27,68,0.284,172,0.552,14,0.601,9.0,2021-22,Playoffs
202693,Markieff Morris,1610612748,MIA,1,0,1,3.0,0,0,0,0.0,1,0.0,1,0.0,0.0,1,0,1,0.0,1,1.0,0,1.0,13.7,1,0,1,0.0,2,0.5,1,1.0,13.7,2021-22,Playoffs
1627737,Marquese Chriss,1610612742,DAL,6,3,3,21.0,4,1,3,0.25,5,0.8,0,0.8,4.2,5,2,3,0.4,7,0.714,0,0.714,4.2,9,3,6,0.333,11,0.818,0,0.818,4.2,2021-22,Playoffs
1629680,Matisse Thybulle,1610612755,PHI,5,2,3,84.0,2,0,2,0.0,7,0.286,0,0.286,20.1,7,1,6,0.143,9,0.778,1,0.875,8.8,9,1,8,0.111,16,0.563,1,0.6,11.3,2021-22,Playoffs
1629622,Max Strus,1610612748,MIA,17,11,6,508.0,15,4,11,0.267,27,0.556,1,0.577,14.5,58,8,51,0.138,95,0.611,13,0.707,6.7,73,12,62,0.164,119,0.613,14,0.695,8.3,2021-22,Playoffs
1628467,Maxi Kleber,1610612742,DAL,18,9,9,456.0,15,9,6,0.6,36,0.417,0,0.417,7.6,67,19,48,0.284,122,0.549,12,0.609,5.1,82,28,54,0.341,151,0.543,12,0.59,5.6,2021-22,Playoffs
1628969,Mikal Bridges,1610612756,PHX,13,7,6,500.0,12,7,5,0.583,25,0.48,0,0.48,8.1,49,9,40,0.184,76,0.645,5,0.69,7.6,61,16,45,0.262,101,0.604,5,0.635,7.7,2021-22,Playoffs
201144,Mike Conley,1610612762,UTA,6,2,4,174.0,2,0,2,0.0,3,0.667,0,0.667,16.3,17,3,14,0.176,24,0.708,0,0.708,9.8,19,3,16,0.158,27,0.704,0,0.704,10.5,2021-22,Playoffs
1628420,Monte Morris,1610612743,DEN,4,1,3,124.0,1,0,1,0.0,3,0.333,0,0.333,43.1,10,1,9,0.1,18,0.556,0,0.556,9.2,11,1,10,0.091,21,0.524,0,0.524,12.3,2021-22,Playoffs
1630541,Moses Moody,1610612744,GSW,5,3,2,65.0,2,0,2,0.0,7,0.286,0,0.286,16.2,6,2,4,0.333,9,0.667,0,0.667,8.9,8,2,6,0.25,14,0.571,0,0.571,10.7,2021-22,Playoffs
1630230,Naji Marshall,1610612740,NOP,4,0,4,38.0,3,1,2,0.333,7,0.429,0,0.429,9.9,3,1,2,0.333,5,0.6,1,0.75,6.9,6,2,4,0.333,12,0.5,1,0.545,8.4,2021-22,Playoffs
1629675,Naz Reid,1610612750,MIN,4,1,3,48.0,2,2,0,1.0,8,0.25,0,0.25,3.4,12,6,6,0.5,25,0.48,3,0.545,4.5,14,8,6,0.571,31,0.452,3,0.5,4.4,2021-22,Playoffs
202357,Nemanja Bjelica,1610612744,GSW,14,10,4,147.0,6,1,5,0.167,10,0.6,0,0.6,8.2,25,7,18,0.28,41,0.61,5,0.694,5.6,31,8,23,0.258,51,0.608,5,0.674,6.1,2021-22,Playoffs
1629651,Nic Claxton,1610612751,BKN,4,0,4,98.0,7,6,1,0.857,20,0.35,1,0.368,3.0,18,4,14,0.222,28,0.643,2,0.692,4.3,25,10,15,0.4,47,0.532,3,0.568,3.9,2021-22,Playoffs
1629638,Nickeil Alexander-Walker,1610612762,UTA,1,0,1,5.0,0,0,0,0.0,0,0.0,0,0.0,0.0,1,0,1,0.0,1,1.0,0,1.0,1.2,1,0,1,0.0,1,1.0,0,1.0,1.2,2021-22,Playoffs
203917,Nik Stauskas,1610612738,BOS,2,1,1,8.0,0,0,0,0.0,0,0.0,0,0.0,0.0,4,0,4,0.0,4,1.0,0,1.0,5.7,4,0,4,0.0,4,1.0,0,1.0,5.7,2021-22,Playoffs
203999,Nikola Jokic,1610612743,DEN,5,1,4,171.0,17,17,0,1.0,39,0.436,1,0.447,3.8,49,12,37,0.245,68,0.721,3,0.754,4.0,66,29,37,0.439,100,0.66,4,0.688,4.0,2021-22,Playoffs
202696,Nikola Vucevic,1610612741,CHI,5,1,4,181.0,14,13,1,0.929,20,0.7,0,0.7,5.4,48,11,37,0.229,63,0.762,4,0.814,5.1,62,24,38,0.387,81,0.765,4,0.805,5.1,2021-22,Playoffs
1628384,OG Anunoby,1610612761,TOR,6,2,4,217.0,7,4,3,0.571,19,0.368,1,0.389,7.2,17,3,14,0.176,29,0.586,2,0.63,6.6,24,7,17,0.292,46,0.522,3,0.558,6.8,2021-22,Playoffs
1630209,Omer Yurtseven,1610612748,MIA,5,2,3,27.0,1,0,1,0.0,4,0.25,0,0.25,2.6,6,1,5,0.167,12,0.5,0,0.5,5.4,7,1,6,0.143,15,0.467,0,0.467,5.0,2021-22,Playoffs
1630168,Onyeka Okongwu,1610612737,ATL,5,1,4,108.0,11,6,5,0.545,26,0.423,2,0.458,6.0,16,5,11,0.313,31,0.516,4,0.593,5.1,27,11,16,0.407,56,0.482,6,0.54,5.5,2021-22,Playoffs
203490,Otto Porter Jr.,1610612744,GSW,18,14,4,359.0,12,9,3,0.75,41,0.293,2,0.308,6.5,53,9,44,0.17,102,0.52,16,0.616,5.7,65,18,47,0.277,139,0.468,18,0.537,5.8,2021-22,Playoffs
200782,P.J. Tucker,1610612748,MIA,18,11,7,509.0,35,14,21,0.4,105,0.333,4,0.347,9.3,67,16,50,0.239,118,0.568,14,0.644,6.4,102,30,71,0.294,214,0.477,18,0.52,7.4,2021-22,Playoffs
1627783,Pascal Siakam,1610612761,TOR,6,2,4,260.0,8,4,4,0.5,15,0.533,1,0.571,4.5,35,5,30,0.143,55,0.636,6,0.714,7.2,43,9,34,0.209,70,0.614,7,0.683,6.7,2021-22,Playoffs
1626192,Pat Connaughton,1610612749,MIL,12,7,5,318.0,3,0,3,0.0,13,0.231,0,0.231,14.9,48,12,36,0.25,79,0.608,8,0.676,6.1,51,12,39,0.235,92,0.554,8,0.607,6.7,2021-22,Playoffs
201976,Patrick Beverley,1610612750,MIN,6,2,4,194.0,4,1,3,0.25,12,0.333,0,0.333,10.0,15,3,12,0.2,36,0.417,5,0.484,7.0,19,4,15,0.211,48,0.396,5,0.442,7.6,2021-22,Playoffs
1630172,Patrick Williams,1610612741,CHI,5,1,4,153.0,6,4,2,0.667,13,0.462,0,0.462,6.9,21,3,18,0.143,36,0.583,3,0.636,5.8,27,7,20,0.259,47,0.574,3,0.614,6.1,2021-22,Playoffs
201988,Patty Mills,1610612751,BKN,3,0,3,60.0,0,0,0,0.0,0,0.0,0,0.0,0.0,4,0,4,0.0,5,0.8,0,0.8,10.8,4,0,4,0.0,5,0.8,0,0.8,10.8,2021-22,Playoffs
200794,Paul Millsap,1610612755,PHI,1,0,1,6.0,0,0,0,0.0,0,0.0,0,0.0,0.0,1,0,1,0.0,2,0.5,0,0.5,5.4,1,0,1,0.0,2,0.5,0,0.5,5.4,2021-22,Playoffs
1630194,Paul Reed,1610612755,PHI,11,6,5,136.0,22,15,7,0.682,38,0.579,0,0.579,6.3,24,12,13,0.5,36,0.667,2,0.706,4.3,46,27,20,0.587,73,0.63,2,0.648,5.2,2021-22,Playoffs
1630202,Payton Pritchard,1610612738,BOS,18,10,8,260.0,10,3,7,0.3,24,0.417,0,0.417,11.2,36,3,33,0.083,56,0.643,4,0.692,8.2,46,6,40,0.13,78,0.59,4,0.622,8.9,2021-22,Playoffs
1630173,Precious Achiuwa,1610612761,TOR,6,2,4,167.0,8,6,2,0.75,22,0.364,2,0.4,4.3,21,7,14,0.333,35,0.6,1,0.618,6.0,29,13,16,0.448,55,0.527,3,0.558,5.6,2021-22,Playoffs
1629730,Rayjon Tucker,1610612749,MIL,2,1,1,10.0,1,0,1,0.0,2,0.5,0,0.5,23.3,2,0,2,0.0,3,0.667,1,1.0,13.0,3,0,3,0.0,5,0.6,1,0.75,16.4,2021-22,Playoffs
203493,Reggie Bullock Jr.,1610612742,DAL,18,9,9,707.0,8,1,7,0.125,21,0.381,0,0.381,15.0,74,12,62,0.162,109,0.679,8,0.733,8.1,82,13,69,0.159,128,0.641,8,0.683,8.8,2021-22,Playoffs
1629057,Robert Williams III,1610612738,BOS,17,9,8,394.0,43,36,6,0.837,86,0.5,4,0.524,3.8,62,17,46,0.274,120,0.517,19,0.614,6.5,105,53,52,0.505,203,0.517,23,0.583,5.4,2021-22,Playoffs
1626220,Royce O'Neale,1610612762,UTA,6,2,4,188.0,6,3,3,0.5,15,0.4,1,0.429,10.7,28,4,24,0.143,38,0.737,3,0.8,6.7,34,7,27,0.206,52,0.654,4,0.708,7.4,2021-22,Playoffs
203497,Rudy Gobert,1610612762,UTA,6,2,4,197.0,21,12,9,0.571,54,0.389,0,0.389,4.0,58,9,49,0.155,90,0.644,8,0.707,3.7,79,21,58,0.266,137,0.577,8,0.612,3.8,2021-22,Playoffs
1630573,Sam Hauser,1610612738,BOS,1,1,0,2.0,0,0,0,0.0,1,0.0,0,0.0,0.0,1,0,1,0.0,1,1.0,0,1.0,3.6,1,0,1,0.0,2,0.5,0,0.5,3.6,2021-22,Playoffs
1630567,Scottie Barnes,1610612761,TOR,4,2,2,133.0,7,2,5,0.286,13,0.538,0,0.538,9.6,29,4,25,0.138,41,0.707,5,0.806,5.1,36,6,30,0.167,54,0.667,5,0.735,6.0,2021-22,Playoffs
201586,Serge Ibaka,1610612749,MIL,3,3,0,18.0,2,2,0,1.0,8,0.25,1,0.286,4.2,8,1,7,0.125,10,0.8,0,0.8,4.0,10,3,7,0.3,17,0.588,1,0.625,4.0,2021-22,Playoffs
203552,Seth Curry,1610612751,BKN,4,0,4,132.0,2,0,2,0.0,6,0.333,1,0.4,15.5,8,2,6,0.25,13,0.615,0,0.615,7.5,10,2,8,0.2,19,0.526,1,0.556,9.1,2021-22,Playoffs
1629003,Shake Milton,1610612755,PHI,11,6,5,157.0,4,2,2,0.5,12,0.333,1,0.364,10.7,15,2,13,0.133,25,0.6,2,0.652,6.8,19,4,15,0.211,35,0.543,3,0.594,7.6,2021-22,Playoffs
1630219,Skylar Mays,1610612737,ATL,1,0,1,5.0,0,0,0,0.0,0,0.0,0,0.0,0.0,1,0,1,0.0,1,1.0,0,1.0,16.4,1,0,1,0.0,1,1.0,0,1.0,16.4,2021-22,Playoffs
203915,Spencer Dinwiddie,1610612742,DAL,17,9,8,469.0,8,4,4,0.5,26,0.308,0,0.308,11.1,36,4,32,0.111,63,0.571,6,0.632,8.7,44,8,36,0.182,86,0.512,6,0.55,9.1,2021-22,Playoffs
201939,Stephen Curry,1610612744,GSW,22,16,6,764.0,11,3,8,0.273,45,0.244,1,0.25,17.9,104,11,92,0.106,172,0.605,11,0.646,8.4,115,14,100,0.122,216,0.532,12,0.564,9.3,2021-22,Playoffs
1628425,Sterling Brown,1610612742,DAL,5,1,4,20.0,1,0,1,0.0,4,0.25,0,0.25,18.1,7,2,5,0.286,9,0.778,1,0.875,6.7,8,2,6,0.25,13,0.615,1,0.667,8.1,2021-22,Playoffs
203500,Steven Adams,1610612763,MEM,6,1,5,111.0,15,10,5,0.667,30,0.5,0,0.5,7.4,30,7,23,0.233,40,0.75,2,0.789,3.9,45,17,28,0.378,70,0.643,2,0.662,5.1,2021-22,Playoffs
1629004,Svi Mykhailiuk,1610612761,TOR,1,1,0,1.0,0,0,0,0.0,1,0.0,0,0.0,0.0,1,0,1,0.0,1,1.0,0,1.0,8.4,1,0,1,0.0,1,1.0,0,1.0,8.4,2021-22,Playoffs
1627752,Taurean Prince,1610612750,MIN,4,1,3,54.0,1,0,1,0.0,5,0.2,0,0.2,24.0,7,2,5,0.286,10,0.7,0,0.7,5.4,8,2,6,0.25,13,0.615,0,0.615,7.8,2021-22,Playoffs
201152,Thaddeus Young,1610612761,TOR,5,2,3,81.0,7,5,2,0.714,16,0.438,0,0.438,6.0,11,2,9,0.182,16,0.688,1,0.733,6.8,18,7,11,0.389,31,0.581,1,0.6,6.5,2021-22,Playoffs
203648,Thanasis Antetokounmpo,1610612749,MIL,3,1,2,5.0,1,0,1,0.0,4,0.25,0,0.25,9.8,3,1,2,0.333,3,1.0,0,1.0,4.6,4,1,3,0.25,5,0.8,0,0.8,5.9,2021-22,Playoffs
1627789,Timothe Luwawu-Cabarrot,1610612737,ATL,1,0,1,15.0,0,0,0,0.0,1,0.0,0,0.0,0.0,3,0,3,0.0,4,0.75,0,0.75,5.7,3,0,3,0.0,4,0.75,0,0.75,5.7,2021-22,Playoffs
202699,Tobias Harris,1610612755,PHI,12,6,6,466.0,10,7,3,0.7,34,0.294,0,0.294,11.8,81,25,56,0.309,142,0.57,11,0.618,5.9,91,32,59,0.352,172,0.529,11,0.565,6.5,2021-22,Playoffs
1628396,Tony Bradley,1610612741,CHI,2,0,2,8.0,0,0,0,0.0,0,0.0,0,0.0,0.0,4,1,3,0.25,7,0.571,0,0.571,3.5,4,1,3,0.25,7,0.571,0,0.571,3.5,2021-22,Playoffs
1628470,Torrey Craig,1610612756,PHX,7,3,4,48.0,5,4,1,0.8,9,0.556,0,0.556,4.2,10,1,9,0.1,13,0.769,1,0.833,6.7,15,5,10,0.333,20,0.75,1,0.789,5.9,2021-22,Playoffs
1629027,Trae Young,1610612737,ATL,5,1,4,186.0,5,1,4,0.2,10,0.5,0,0.5,21.3,20,1,19,0.05,26,0.769,2,0.833,12.9,25,2,23,0.08,36,0.694,2,0.735,14.6,2021-22,Playoffs
203504,Trey Burke,1610612742,DAL,3,3,0,15.0,0,0,0,0.0,1,0.0,0,0.0,0.0,3,0,3,0.0,3,1.0,0,1.0,6.3,3,0,3,0.0,4,0.75,0,0.75,6.3,2021-22,Playoffs
1630530,Trey Murphy III,1610612740,NOP,6,2,4,120.0,3,1,2,0.333,8,0.375,0,0.375,5.0,12,3,9,0.25,19,0.632,3,0.75,7.9,15,4,11,0.267,25,0.6,3,0.682,7.3,2021-22,Playoffs
202684,Tristan Thompson,1610612741,CHI,4,1,3,27.0,2,2,0,1.0,11,0.182,0,0.182,4.1,6,1,5,0.167,11,0.545,3,0.75,7.0,8,3,5,0.375,22,0.364,3,0.421,6.3,2021-22,Playoffs
1628972,Troy Brown Jr.,1610612741,CHI,2,0,2,35.0,1,0,1,0.0,2,0.5,0,0.5,20.7,7,0,7,0.0,12,0.583,1,0.636,6.9,8,0,8,0.0,13,0.615,1,0.667,8.6,2021-22,Playoffs
1629639,Tyler Herro,1610612748,MIA,14,10,4,374.0,7,3,4,0.429,33,0.212,0,0.212,13.2,51,5,45,0.098,92,0.554,10,0.622,5.7,58,8,49,0.138,115,0.504,10,0.552,6.6,2021-22,Playoffs
1630178,Tyrese Maxey,1610612755,PHI,11,6,5,450.0,6,1,5,0.167,20,0.3,0,0.3,15.0,36,1,35,0.028,58,0.621,4,0.667,9.6,42,2,40,0.048,78,0.538,4,0.568,10.4,2021-22,Playoffs
1626145,Tyus Jones,1610612763,MEM,11,6,5,250.0,4,0,4,0.0,10,0.4,0,0.4,17.0,35,2,33,0.057,50,0.7,2,0.729,8.1,39,2,37,0.051,59,0.661,2,0.684,9.0,2021-22,Playoffs
203506,Victor Oladipo,1610612748,MIA,13,8,5,327.0,4,1,3,0.25,20,0.2,2,0.222,15.1,47,13,34,0.277,82,0.573,13,0.681,5.5,51,14,37,0.275,102,0.5,15,0.586,6.2,2021-22,Playoffs
1628427,Vlatko Cancar,1610612743,DEN,2,0,2,9.0,0,0,0,0.0,2,0.0,0,0.0,0.0,2,0,2,0.0,2,1.0,0,1.0,7.1,2,0,2,0.0,3,0.667,0,0.667,7.1,2021-22,Playoffs
202083,Wesley Matthews,1610612749,MIL,11,7,4,316.0,9,6,3,0.667,24,0.375,1,0.391,8.1,28,4,24,0.143,39,0.718,8,0.903,8.7,37,10,27,0.27,59,0.627,9,0.74,8.6,2021-22,Playoffs
203115,Will Barton,1610612743,DEN,5,1,4,172.0,5,3,2,0.6,11,0.455,1,0.5,13.7,23,1,22,0.043,34,0.676,2,0.719,6.2,28,4,24,0.143,45,0.622,3,0.667,7.5,2021-22,Playoffs
1626195,Willy Hernangomez,1610612740,NOP,1,1,0,2.0,2,2,0,1.0,2,1.0,0,1.0,2.8,0,0,0,0.0,0,0.0,0,0.0,0.0,2,2,0,1.0,2,1.0,0,1.0,2.8,2021-22,Playoffs
1630214,Xavier Tillman,1610612763,MEM,9,6,3,139.0,13,8,4,0.615,28,0.464,0,0.464,5.4,17,3,13,0.176,28,0.607,4,0.708,7.4,30,11,17,0.367,56,0.536,4,0.577,6.5,2021-22,Playoffs
203897,Zach LaVine,1610612741,CHI,4,1,3,153.0,0,0,0,0.0,9,0.0,0,0.0,0.0,21,3,18,0.143,36,0.583,4,0.656,6.5,21,3,18,0.143,44,0.477,4,0.525,6.5,2021-22,Playoffs
1630533,Ziaire Williams,1610612763,MEM,6,3,3,132.0,4,2,2,0.5,8,0.5,1,0.571,14.2,12,2,11,0.167,20,0.6,2,0.667,7.0,16,4,13,0.25,28,0.571,3,0.64,8.7,2021-22,Playoffs
1630639,A.J. Lawson,1610612742,DAL,8,1,7,84.0,6,5,1,0.833,14,0.429,0,0.429,4.2,15,5,10,0.333,19,0.789,3,0.938,6.8,21,10,11,0.476,30,0.7,3,0.778,6.1,2022-23,Regular%20Season
1631260,AJ Green,1610612749,MIL,23,16,7,298.0,6,2,4,0.333,23,0.261,2,0.286,16.9,39,14,25,0.359,62,0.629,6,0.696,6.7,45,16,29,0.356,83,0.542,8,0.6,8.1,2022-23,Regular%20Season
1631100,AJ Griffin,1610612737,ATL,63,27,36,1309.0,37,12,25,0.324,76,0.487,1,0.493,12.0,116,25,91,0.216,190,0.611,11,0.648,7.6,153,37,116,0.242,259,0.591,12,0.619,8.7,2022-23,Regular%20Season
203932,Aaron Gordon,1610612743,DEN,67,44,23,2031.0,164,113,51,0.689,314,0.522,9,0.538,5.7,282,71,211,0.252,436,0.647,26,0.688,6.0,446,184,262,0.413,719,0.62,35,0.652,5.9,2022-23,Regular%20Season
1628988,Aaron Holiday,1610612737,ATL,39,18,21,629.0,25,10,14,0.4,51,0.49,1,0.5,10.0,49,5,44,0.102,81,0.605,6,0.653,10.2,74,15,58,0.203,132,0.561,7,0.592,10.1,2022-23,Regular%20Season
1630174,Aaron Nesmith,1610612754,IND,71,29,42,1794.0,62,33,29,0.532,179,0.346,6,0.358,10.6,215,46,169,0.214,428,0.502,48,0.566,5.9,277,79,198,0.285,582,0.476,54,0.525,7.0,2022-23,Regular%20Season
1630598,Aaron Wiggins,1610612760,OKC,64,34,30,1244.0,68,41,27,0.603,140,0.486,6,0.507,8.5,142,42,100,0.296,256,0.555,28,0.623,6.7,210,83,127,0.395,391,0.537,34,0.588,7.3,2022-23,Regular%20Season
1629678,Admiral Schofield,1610612753,ORL,24,11,13,360.0,23,11,12,0.478,63,0.365,2,0.377,8.6,39,11,28,0.282,84,0.464,8,0.513,6.2,62,22,40,0.355,138,0.449,10,0.484,7.1,2022-23,Regular%20Season
201143,Al Horford,1610612738,BOS,63,44,19,1921.0,73,40,33,0.548,144,0.507,6,0.529,9.8,317,89,228,0.281,512,0.619,53,0.691,5.6,390,129,261,0.331,643,0.607,59,0.668,6.4,2022-23,Regular%20Season
202692,Alec Burks,1610612765,DET,44,11,33,992.0,17,6,11,0.353,48,0.354,0,0.354,13.3,138,29,109,0.21,209,0.66,11,0.697,7.0,155,35,120,0.226,249,0.622,11,0.651,7.7,2022-23,Regular%20Season
1630197,Aleksej Pokusevski,1610612760,OKC,33,16,17,691.0,45,30,15,0.667,92,0.489,3,0.506,5.8,114,39,75,0.342,224,0.509,33,0.597,4.7,159,69,90,0.434,309,0.515,36,0.582,5.0,2022-23,Regular%20Season
1627936,Alex Caruso,1610612741,CHI,59,27,32,1418.0,41,16,25,0.39,105,0.39,8,0.423,10.8,152,18,134,0.118,263,0.578,21,0.628,8.9,193,34,159,0.176,352,0.548,29,0.598,9.3,2022-23,Regular%20Season
203458,Alex Len,1610612758,SAC,17,9,8,147.0,24,13,11,0.542,48,0.5,1,0.511,6.2,36,8,28,0.222,55,0.655,5,0.72,5.0,60,21,39,0.35,98,0.612,6,0.652,5.5,2022-23,Regular%20Season
1628993,Alize Johnson,1610612759,SAS,4,1,3,30.0,2,2,0,1.0,6,0.333,1,0.4,3.7,8,1,7,0.125,12,0.667,0,0.667,3.9,10,3,7,0.3,18,0.556,1,0.588,3.8,2022-23,Regular%20Season
1631214,Alondes Williams,1610612751,BKN,1,1,0,5.0,0,0,0,0.0,0,0.0,0,0.0,0.0,1,0,1,0.0,1,1.0,0,1.0,7.0,1,0,1,0.0,1,1.0,0,1.0,7.0,2022-23,Regular%20Season
1630578,Alperen Sengun,1610612745,HOU,75,18,57,2171.0,242,169,73,0.698,536,0.451,14,0.464,5.6,436,139,298,0.319,720,0.606,79,0.68,4.8,678,308,371,0.454,1205,0.563,93,0.61,5.1,2022-23,Regular%20Season
1629599,Amir Coffey,1610612746,LAC,26,11,15,507.0,17,5,12,0.294,38,0.447,1,0.459,11.8,36,4,32,0.111,70,0.514,6,0.563,9.8,53,9,44,0.17,104,0.51,7,0.546,10.5,2022-23,Regular%20Season
203083,Andre Drummond,1610612741,CHI,67,32,35,849.0,138,108,29,0.783,248,0.556,2,0.561,4.2,306,116,189,0.379,417,0.734,24,0.779,4.0,444,224,218,0.505,642,0.692,26,0.721,4.1,2022-23,Regular%20Season
2738,Andre Iguodala,1610612744,GSW,6,2,4,80.0,3,1,2,0.333,5,0.6,0,0.6,11.2,10,2,8,0.2,21,0.476,3,0.556,6.2,13,3,10,0.231,25,0.52,3,0.591,7.3,2022-23,Regular%20Season
1629614,Andrew Nembhard,1610612754,IND,71,30,41,1979.0,35,6,29,0.171,91,0.385,8,0.422,16.5,164,27,137,0.165,272,0.603,18,0.646,8.5,199,33,166,0.166,358,0.556,26,0.599,9.9,2022-23,Regular%20Season
203952,Andrew Wiggins,1610612744,GSW,35,17,18,1134.0,58,33,25,0.569,129,0.45,3,0.46,8.5,123,19,104,0.154,229,0.537,25,0.603,6.5,181,52,129,0.287,346,0.523,28,0.569,7.1,2022-23,Regular%20Season
1629014,Anfernee Simons,1610612757,POR,57,26,31,1986.0,18,7,11,0.389,69,0.261,7,0.29,13.5,143,27,116,0.189,223,0.641,19,0.701,9.0,161,34,127,0.211,289,0.557,26,0.612,9.5,2022-23,Regular%20Season
203076,Anthony Davis,1610612747,LAL,56,31,25,1905.0,195,155,40,0.795,359,0.543,12,0.562,4.2,507,224,281,0.442,795,0.638,72,0.701,4.3,702,379,321,0.54,1132,0.62,84,0.67,4.3,2022-23,Regular%20Season
1630162,Anthony Edwards,1610612750,MIN,76,39,37,2769.0,45,17,28,0.378,148,0.304,8,0.321,12.9,408,77,331,0.189,644,0.634,51,0.688,6.4,453,94,359,0.208,775,0.585,59,0.633,7.0,2022-23,Regular%20Season
1630264,Anthony Gill,1610612764,WAS,42,13,29,553.0,37,18,19,0.486,90,0.411,7,0.446,6.4,62,17,45,0.274,97,0.639,10,0.713,5.9,99,35,64,0.354,183,0.541,17,0.596,6.0,2022-23,Regular%20Season
1630237,Anthony Lamb,1610612744,GSW,54,29,25,1083.0,54,29,25,0.537,130,0.415,5,0.432,9.6,156,47,109,0.301,302,0.517,34,0.582,5.5,210,76,134,0.362,418,0.502,39,0.554,6.5,2022-23,Regular%20Season
1630559,Austin Reaves,1610612747,LAL,57,32,25,1672.0,33,11,22,0.333,82,0.402,7,0.44,10.6,160,14,145,0.088,277,0.578,29,0.645,8.7,193,25,167,0.13,354,0.545,36,0.607,9.1,2022-23,Regular%20Season
203085,Austin Rivers,1610612750,MIN,36,16,20,807.0,5,1,4,0.2,21,0.238,1,0.25,11.7,78,7,71,0.09,119,0.655,9,0.709,9.4,83,8,75,0.096,136,0.61,10,0.659,9.6,2022-23,Regular%20Season
1630245,Ayo Dosunmu,1610612741,CHI,66,33,33,1809.0,44,16,28,0.364,106,0.415,6,0.44,13.4,173,24,147,0.139,286,0.605,31,0.678,9.5,217,40,175,0.184,387,0.561,37,0.62,10.3,2022-23,Regular%20Season
1628389,Bam Adebayo,1610612748,MIA,75,40,35,2598.0,184,122,63,0.663,416,0.442,12,0.455,6.2,504,163,341,0.323,780,0.646,66,0.706,5.6,688,285,404,0.414,1163,0.592,78,0.634,5.7,2022-23,Regular%20Season
1627732,Ben Simmons,1610612751,BKN,42,24,18,1105.0,40,20,20,0.5,95,0.421,2,0.43,7.0,223,51,173,0.229,347,0.643,27,0.697,6.1,263,71,193,0.27,417,0.631,29,0.678,6.3,2022-23,Regular%20Season
1631097,Bennedict Mathurin,1610612754,IND,76,32,44,2206.0,87,50,37,0.575,244,0.357,7,0.367,8.2,231,36,195,0.156,387,0.597,38,0.662,8.2,318,86,232,0.27,620,0.513,45,0.553,8.2,2022-23,Regular%20Season
202687,Bismack Biyombo,1610612756,PHX,56,30,26,846.0,89,60,29,0.674,197,0.452,8,0.471,5.2,171,46,125,0.269,314,0.545,34,0.611,4.9,260,106,154,0.408,497,0.523,42,0.571,5.0,2022-23,Regular%20Season
201933,Blake Griffin,1610612738,BOS,36,24,12,538.0,47,27,20,0.574,97,0.485,3,0.5,7.0,108,43,65,0.398,177,0.61,17,0.675,4.7,155,70,85,0.452,268,0.578,20,0.625,5.4,2022-23,Regular%20Season
1631104,Blake Wesley,1610612759,SAS,24,6,18,473.0,12,7,5,0.583,43,0.279,0,0.279,10.7,62,7,55,0.113,97,0.639,6,0.681,7.2,74,14,60,0.189,140,0.529,6,0.552,7.8,2022-23,Regular%20Season
1626246,Boban Marjanovic,1610612745,HOU,27,7,20,158.0,20,11,8,0.55,47,0.426,5,0.476,3.3,40,12,28,0.3,63,0.635,4,0.678,4.7,60,23,36,0.383,105,0.571,9,0.625,4.2,2022-23,Regular%20Season
1626171,Bobby Portis,1610612749,MIL,70,47,23,1818.0,154,105,49,0.682,375,0.411,12,0.424,5.5,518,116,401,0.224,769,0.674,60,0.731,4.8,672,221,450,0.329,1093,0.615,72,0.658,4.9,2022-23,Regular%20Season
203992,Bogdan Bogdanovic,1610612737,ATL,51,26,25,1436.0,23,5,18,0.217,53,0.434,3,0.46,16.6,142,33,109,0.232,235,0.604,24,0.673,6.5,165,38,127,0.23,280,0.589,27,0.652,7.9,2022-23,Regular%20Season
202711,Bojan Bogdanovic,1610612765,DET,57,15,42,1839.0,34,15,19,0.441,106,0.321,2,0.327,13.3,184,23,159,0.125,311,0.592,24,0.641,8.1,218,38,178,0.174,410,0.532,26,0.568,8.9,2022-23,Regular%20Season
1629626,Bol Bol,1610612753,ORL,70,26,44,1505.0,69,40,29,0.58,144,0.479,6,0.5,6.4,336,54,282,0.161,460,0.73,28,0.778,5.2,405,94,311,0.232,582,0.696,34,0.739,5.4,2022-23,Regular%20Season
1630538,Bones Hyland,1610612746,LAC,49,33,16,1011.0,20,10,10,0.5,59,0.339,2,0.351,10.8,115,18,97,0.157,190,0.605,12,0.646,8.2,135,28,107,0.207,243,0.556,14,0.59,8.6,2022-23,Regular%20Season
203078,Bradley Beal,1610612764,WAS,49,23,26,1643.0,41,16,25,0.39,95,0.432,1,0.436,11.2,155,34,121,0.219,247,0.628,19,0.68,7.5,196,50,146,0.255,336,0.583,20,0.62,8.3,2022-23,Regular%20Season
1630527,Brandon Boston Jr.,1610612746,LAC,15,6,9,228.0,7,3,4,0.429,16,0.438,2,0.5,7.2,23,5,18,0.217,47,0.489,1,0.5,7.6,30,8,22,0.267,61,0.492,3,0.517,7.5,2022-23,Regular%20Season
1629634,Brandon Clarke,1610612763,MEM,56,32,24,1090.0,92,67,25,0.728,258,0.357,7,0.367,4.2,218,69,149,0.317,370,0.589,33,0.647,5.6,310,136,174,0.439,609,0.509,40,0.545,5.2,2022-23,Regular%20Season
1627742,Brandon Ingram,1610612740,NOP,45,23,22,1538.0,23,10,13,0.435,70,0.329,3,0.343,8.2,223,46,177,0.206,330,0.676,21,0.722,6.9,246,56,190,0.228,396,0.621,24,0.661,7.0,2022-23,Regular%20Season
1630296,Braxton Key,1610612765,DET,1,0,1,2.0,0,0,0,0.0,2,0.0,0,0.0,0.0,1,0,1,0.0,1,1.0,0,1.0,2.8,1,0,1,0.0,2,0.5,0,0.5,2.8,2022-23,Regular%20Season
201572,Brook Lopez,1610612749,MIL,77,56,21,2342.0,157,104,53,0.662,319,0.492,11,0.51,6.8,363,140,219,0.386,654,0.555,71,0.623,6.0,520,244,272,0.469,948,0.549,82,0.6,6.2,2022-23,Regular%20Season
1628971,Bruce Brown,1610612743,DEN,76,49,27,2204.0,63,38,24,0.603,166,0.38,5,0.391,7.4,265,45,220,0.17,448,0.592,36,0.643,7.0,328,83,244,0.253,597,0.549,41,0.59,7.1,2022-23,Regular%20Season
1628981,Bruno Fernando,1610612737,ATL,34,11,23,378.0,54,33,21,0.611,135,0.4,4,0.412,5.2,83,21,61,0.253,149,0.557,16,0.624,4.7,137,54,82,0.394,275,0.498,20,0.537,4.9,2022-23,Regular%20Season
1631121,Bryce McGowens,1610612766,CHA,37,12,25,734.0,20,10,10,0.5,54,0.37,1,0.377,10.4,73,13,60,0.178,123,0.593,11,0.652,9.0,93,23,70,0.247,168,0.554,12,0.596,9.3,2022-23,Regular%20Season
1627854,Bryn Forbes,1610612750,MIN,11,4,7,132.0,4,1,3,0.25,5,0.8,0,0.8,18.5,11,4,7,0.364,18,0.611,1,0.647,9.4,15,5,10,0.333,23,0.652,1,0.682,11.8,2022-23,Regular%20Season
1631205,Buddy Boeheim,1610612765,DET,5,0,5,50.0,2,1,1,0.5,2,1.0,0,1.0,10.5,4,1,3,0.25,6,0.667,1,0.8,11.9,6,2,4,0.333,8,0.75,1,0.857,11.5,2022-23,Regular%20Season
1627741,Buddy Hield,1610612754,IND,79,35,44,2457.0,67,21,45,0.313,175,0.383,4,0.392,13.0,333,48,285,0.144,566,0.588,56,0.653,7.0,400,69,330,0.173,723,0.553,60,0.603,8.0,2022-23,Regular%20Season
203468,CJ McCollum,1610612740,NOP,72,36,36,2541.0,55,14,42,0.255,119,0.462,2,0.47,14.6,273,34,239,0.125,428,0.638,28,0.683,9.1,328,48,281,0.146,540,0.607,30,0.643,10.0,2022-23,Regular%20Season
1630595,Cade Cunningham,1610612765,DET,12,3,9,400.0,12,5,7,0.417,32,0.375,2,0.4,9.9,62,17,45,0.274,97,0.639,4,0.667,6.6,74,22,52,0.297,128,0.578,6,0.607,7.1,2022-23,Regular%20Season
1631216,Caleb Houstan,1610612753,ORL,41,14,27,727.0,34,13,21,0.382,82,0.415,3,0.43,9.9,65,13,52,0.2,114,0.57,14,0.65,8.5,99,26,73,0.263,191,0.518,17,0.569,9.0,2022-23,Regular%20Season
1628997,Caleb Martin,1610612748,MIA,68,37,31,2008.0,88,29,61,0.33,190,0.463,5,0.476,11.6,256,49,205,0.191,457,0.56,57,0.64,6.8,344,78,266,0.227,618,0.557,62,0.619,8.0,2022-23,Regular%20Season
1629629,Cam Reddish,1610612757,POR,31,12,19,830.0,18,7,11,0.389,42,0.429,2,0.45,13.4,70,16,54,0.229,110,0.636,9,0.693,9.3,88,23,65,0.261,151,0.583,11,0.629,10.2,2022-23,Regular%20Season
1630560,Cam Thomas,1610612751,BKN,42,23,19,841.0,8,3,5,0.375,31,0.258,2,0.276,10.7,87,17,68,0.195,161,0.54,14,0.592,7.5,95,20,73,0.211,186,0.511,16,0.559,7.7,2022-23,Regular%20Season
1629661,Cameron Johnson,1610612751,BKN,41,25,16,1195.0,34,13,21,0.382,80,0.425,1,0.43,8.6,151,27,124,0.179,252,0.599,24,0.662,7.0,185,40,145,0.216,327,0.566,25,0.613,7.3,2022-23,Regular%20Season
1626166,Cameron Payne,1610612756,PHX,42,24,18,847.0,12,4,8,0.333,55,0.218,2,0.226,12.5,94,6,88,0.064,154,0.61,15,0.676,8.5,106,10,96,0.094,200,0.53,17,0.579,9.0,2022-23,Regular%20Season
1627747,Caris LeVert,1610612739,CLE,72,44,28,2204.0,53,27,26,0.509,130,0.408,6,0.427,9.6,229,38,190,0.166,359,0.638,30,0.696,8.1,282,65,216,0.23,469,0.601,36,0.651,8.4,2022-23,Regular%20Season
1630637,Carlik Jones,1610612741,CHI,3,2,1,49.0,1,1,0,1.0,4,0.25,0,0.25,8.9,4,1,3,0.25,6,0.667,0,0.667,8.1,5,2,3,0.4,10,0.5,0,0.5,8.2,2022-23,Regular%20Season
1626224,Cedi Osman,1610612739,CLE,62,40,22,1327.0,25,6,19,0.24,64,0.391,3,0.41,14.4,151,30,121,0.199,239,0.632,20,0.689,7.3,176,36,140,0.205,297,0.593,23,0.642,8.3,2022-23,Regular%20Season
1628435,Chance Comanche,1610612757,POR,1,0,1,21.0,2,1,1,0.5,4,0.5,0,0.5,7.3,1,0,1,0.0,3,0.333,0,0.333,2.2,3,1,2,0.333,7,0.429,0,0.429,5.6,2022-23,Regular%20Season
1629646,Charles Bassey,1610612759,SAS,33,7,26,497.0,75,40,35,0.533,142,0.528,4,0.543,5.6,118,28,90,0.237,198,0.596,22,0.67,4.5,193,68,125,0.352,322,0.599,26,0.652,4.9,2022-23,Regular%20Season
1631320,Chima Moneke,1610612758,SAC,1,0,1,6.0,2,0,2,0.0,4,0.5,0,0.5,11.2,0,0,0,0.0,0,0.0,0,0.0,0.0,2,0,2,0.0,4,0.5,0,0.5,11.2,2022-23,Regular%20Season
1629002,Chimezie Metu,1610612758,SAC,55,36,19,622.0,47,32,15,0.681,111,0.423,4,0.439,5.2,151,36,115,0.238,219,0.689,10,0.722,4.3,198,68,130,0.343,317,0.625,14,0.653,4.5,2022-23,Regular%20Season
1628449,Chris Boucher,1610612761,TOR,76,39,37,1523.0,157,121,36,0.771,363,0.433,16,0.452,3.8,264,68,196,0.258,403,0.655,38,0.723,5.1,421,189,232,0.449,742,0.567,54,0.612,4.7,2022-23,Regular%20Season
1630537,Chris Duarte,1610612754,IND,41,17,24,850.0,19,6,13,0.316,71,0.268,0,0.268,13.8,96,16,80,0.167,170,0.565,20,0.64,6.9,115,22,93,0.191,230,0.5,20,0.548,8.1,2022-23,Regular%20Season
101108,Chris Paul,1610612756,PHX,58,33,25,1877.0,27,6,21,0.222,59,0.458,3,0.482,14.5,224,37,187,0.165,355,0.631,23,0.675,8.6,251,43,208,0.171,411,0.611,26,0.652,9.2,2022-23,Regular%20Season
1631128,Christian Braun,1610612743,DEN,57,37,20,1045.0,48,26,22,0.542,117,0.41,4,0.425,8.6,133,23,110,0.173,199,0.668,16,0.727,7.0,181,49,132,0.271,305,0.593,20,0.635,7.4,2022-23,Regular%20Season
1631132,Christian Koloko,1610612761,TOR,54,27,27,777.0,84,60,24,0.714,205,0.41,6,0.422,5.1,87,31,56,0.356,188,0.463,25,0.534,5.5,171,91,80,0.532,382,0.448,31,0.487,5.3,2022-23,Regular%20Season
1626174,Christian Wood,1610612742,DAL,67,33,34,1738.0,87,59,28,0.678,231,0.377,5,0.385,6.9,404,117,287,0.29,609,0.663,53,0.727,4.6,491,176,315,0.358,795,0.618,58,0.666,5.0,2022-23,Regular%20Season
1629643,Chuma Okeke,1610612753,ORL,22,7,15,492.0,26,9,17,0.346,60,0.433,2,0.448,12.6,70,15,55,0.214,107,0.654,8,0.707,7.0,96,24,72,0.25,159,0.604,10,0.644,8.6,2022-23,Regular%20Season
203991,Clint Capela,1610612737,ATL,65,35,30,1730.0,258,198,58,0.767,461,0.56,8,0.57,4.9,459,159,301,0.346,672,0.683,37,0.723,4.7,717,357,359,0.498,1108,0.647,45,0.675,4.7,2022-23,Regular%20Season
1629632,Coby White,1610612741,CHI,64,30,34,1573.0,15,3,12,0.2,50,0.3,3,0.319,13.9,196,40,156,0.204,323,0.607,24,0.656,8.0,211,43,168,0.204,364,0.58,27,0.626,8.4,2022-23,Regular%20Season
1628998,Cody Martin,1610612766,CHA,6,1,5,133.0,8,2,6,0.25,16,0.5,0,0.5,12.9,16,5,11,0.313,23,0.696,2,0.762,8.5,24,7,17,0.292,36,0.667,2,0.706,10.0,2022-23,Regular%20Season
203469,Cody Zeller,1610612748,MIA,15,6,9,217.0,25,18,7,0.72,61,0.41,2,0.424,4.6,39,12,27,0.308,76,0.513,14,0.629,4.8,64,30,34,0.469,133,0.481,16,0.547,4.7,2022-23,Regular%20Season
1630175,Cole Anthony,1610612753,ORL,59,28,31,1523.0,47,23,23,0.489,109,0.431,6,0.456,10.5,241,31,210,0.129,396,0.609,42,0.681,7.1,288,54,233,0.188,494,0.583,48,0.646,7.7,2022-23,Regular%20Season
1631306,Cole Swider,1610612747,LAL,3,0,3,33.0,1,0,1,0.0,1,1.0,0,1.0,8.4,6,4,2,0.667,11,0.545,0,0.545,3.3,7,4,3,0.571,11,0.636,0,0.636,4.0,2022-23,Regular%20Season
1629012,Collin Sexton,1610612762,UTA,38,20,18,929.0,37,17,21,0.459,82,0.451,2,0.463,9.6,68,8,60,0.118,104,0.654,6,0.694,10.4,105,25,81,0.238,186,0.565,8,0.59,10.1,2022-23,Regular%20Season
1630557,Corey Kispert,1610612764,WAS,71,29,42,2033.0,33,14,19,0.424,75,0.44,3,0.458,9.9,174,38,136,0.218,300,0.58,22,0.626,7.7,207,52,155,0.251,371,0.558,25,0.598,8.1,2022-23,Regular%20Season
202709,Cory Joseph,1610612765,DET,50,10,40,1027.0,21,5,16,0.238,53,0.396,4,0.429,13.5,85,17,68,0.2,180,0.472,22,0.538,9.0,106,22,84,0.208,230,0.461,26,0.52,9.9,2022-23,Regular%20Season
1626156,D'Angelo Russell,1610612747,LAL,66,37,29,2164.0,35,13,23,0.371,75,0.467,3,0.486,15.8,180,29,150,0.161,345,0.522,41,0.592,8.8,215,42,173,0.195,415,0.518,44,0.58,10.0,2022-23,Regular%20Season
1630227,Daishen Nix,1610612745,HOU,44,11,33,773.0,18,6,12,0.333,41,0.439,1,0.45,12.4,80,20,60,0.25,132,0.606,8,0.645,7.3,98,26,72,0.265,172,0.57,9,0.601,8.2,2022-23,Regular%20Season
1630625,Dalano Banton,1610612761,TOR,23,13,10,219.0,11,8,3,0.727,24,0.458,1,0.478,3.6,34,5,28,0.147,46,0.739,4,0.81,7.6,45,13,31,0.289,70,0.643,5,0.692,6.6,2022-23,Regular%20Season
1631207,Dalen Terry,1610612741,CHI,18,9,9,165.0,11,8,3,0.727,22,0.5,0,0.5,8.1,24,3,21,0.125,48,0.5,2,0.522,7.4,35,11,24,0.314,69,0.507,2,0.522,7.6,2022-23,Regular%20Season
1627745,Damian Jones,1610612762,UTA,35,9,26,470.0,42,25,17,0.595,89,0.472,0,0.472,7.9,80,18,62,0.225,139,0.576,15,0.645,6.4,122,43,79,0.352,219,0.557,15,0.598,6.9,2022-23,Regular%20Season
203081,Damian Lillard,1610612757,POR,58,27,31,2107.0,44,16,28,0.364,140,0.314,6,0.328,16.7,233,45,189,0.193,386,0.604,31,0.656,7.7,277,61,217,0.22,515,0.538,37,0.579,9.1,2022-23,Regular%20Season
1627814,Damion Lee,1610612756,PHX,66,35,31,1398.0,39,13,26,0.333,93,0.419,2,0.429,10.0,186,31,155,0.167,291,0.639,26,0.702,7.2,225,44,181,0.196,373,0.603,28,0.652,7.7,2022-23,Regular%20Season
1629655,Daniel Gafford,1610612764,WAS,77,31,46,1600.0,163,127,36,0.779,367,0.444,7,0.453,4.4,270,87,184,0.322,560,0.482,59,0.539,4.1,433,214,220,0.494,902,0.48,66,0.518,4.2,2022-23,Regular%20Season
1628464,Daniel Theis,1610612754,IND,6,1,5,102.0,7,5,2,0.714,21,0.333,0,0.333,2.7,15,6,9,0.4,34,0.441,4,0.5,4.7,22,11,11,0.5,53,0.415,4,0.449,4.0,2022-23,Regular%20Season
201980,Danny Green,1610612739,CLE,5,2,3,76.0,3,1,2,0.333,8,0.375,0,0.375,12.3,11,2,9,0.182,17,0.647,2,0.733,6.8,14,3,11,0.214,25,0.56,2,0.609,8.0,2022-23,Regular%20Season
1627863,Danuel House Jr.,1610612755,PHI,44,30,14,725.0,9,2,7,0.222,32,0.281,0,0.281,9.8,85,9,76,0.106,141,0.603,8,0.639,7.1,94,11,83,0.117,167,0.563,8,0.591,7.4,2022-23,Regular%20Season
203967,Dario Saric,1610612760,OKC,48,24,24,769.0,53,32,22,0.604,125,0.424,3,0.434,6.1,154,42,112,0.273,279,0.552,25,0.606,4.6,207,74,134,0.357,390,0.531,28,0.572,5.0,2022-23,Regular%20Season
1629647,Darius Bazley,1610612756,PHX,35,17,18,560.0,34,17,16,0.5,88,0.386,0,0.386,9.2,104,22,82,0.212,172,0.605,18,0.675,5.0,138,39,98,0.283,246,0.561,18,0.605,6.0,2022-23,Regular%20Season
1630620,Darius Days,1610612745,HOU,3,0,3,23.0,1,1,0,1.0,4,0.25,0,0.25,8.4,5,0,5,0.0,8,0.625,0,0.625,4.0,6,1,5,0.167,12,0.5,0,0.5,4.7,2022-23,Regular%20Season
1629636,Darius Garland,1610612739,CLE,64,37,27,2270.0,28,9,19,0.321,110,0.255,3,0.262,14.3,157,19,137,0.121,266,0.59,22,0.643,10.7,185,28,156,0.151,374,0.495,25,0.53,11.2,2022-23,Regular%20Season
1630561,David Duke Jr.,1610612751,BKN,9,5,4,147.0,11,2,9,0.182,21,0.524,2,0.579,11.7,18,4,14,0.222,28,0.643,4,0.75,7.1,29,6,23,0.207,48,0.604,6,0.69,8.8,2022-23,Regular%20Season
1631223,David Roddy,1610612763,MEM,67,43,24,1252.0,50,17,33,0.34,105,0.476,4,0.495,8.9,143,35,107,0.245,259,0.552,24,0.609,5.7,193,52,140,0.269,353,0.547,28,0.594,6.5,2022-23,Regular%20Season
1630558,Davion Mitchell,1610612758,SAC,56,36,20,1073.0,16,3,13,0.188,44,0.364,2,0.381,16.2,89,14,75,0.157,140,0.636,13,0.701,8.8,105,17,88,0.162,182,0.577,15,0.629,9.9,2022-23,Regular%20Season
202722,Davis Bertans,1610612742,DAL,28,11,17,355.0,10,3,7,0.3,22,0.455,1,0.476,9.7,43,8,35,0.186,74,0.581,7,0.642,6.9,53,11,42,0.208,92,0.576,8,0.631,7.4,2022-23,Regular%20Season
1628432,Davon Reed,1610612747,LAL,28,20,8,294.0,10,3,7,0.3,25,0.4,2,0.435,16.6,49,9,40,0.184,82,0.598,10,0.681,5.7,59,12,47,0.203,102,0.578,12,0.656,7.6,2022-23,Regular%20Season
1630549,Day'Ron Sharpe,1610612751,BKN,45,21,24,538.0,99,77,22,0.778,196,0.505,3,0.513,4.5,101,34,67,0.337,196,0.515,18,0.567,3.8,200,111,89,0.555,380,0.526,21,0.557,4.1,2022-23,Regular%20Season
1628368,De'Aaron Fox,1610612758,SAC,72,43,29,2426.0,40,11,29,0.275,116,0.345,4,0.357,15.4,266,43,223,0.162,409,0.65,30,0.702,7.9,306,54,252,0.176,518,0.591,34,0.632,8.8,2022-23,Regular%20Season
1629631,De'Andre Hunter,1610612737,ATL,66,34,32,2118.0,46,17,28,0.37,137,0.336,2,0.341,12.6,238,63,175,0.265,414,0.575,48,0.65,6.4,284,80,203,0.282,532,0.534,50,0.589,7.3,2022-23,Regular%20Season
1629001,De'Anthony Melton,1610612755,PHI,75,49,26,2110.0,69,35,34,0.507,157,0.439,3,0.448,10.2,243,56,187,0.23,401,0.606,44,0.681,7.3,312,91,221,0.292,551,0.566,47,0.619,8.0,2022-23,Regular%20Season
201599,DeAndre Jordan,1610612743,DEN,38,23,15,577.0,52,33,19,0.635,113,0.46,1,0.464,4.4,150,47,102,0.313,221,0.679,19,0.743,4.5,202,80,121,0.396,317,0.637,20,0.68,4.4,2022-23,Regular%20Season
201942,DeMar DeRozan,1610612741,CHI,71,36,35,2573.0,34,12,22,0.353,131,0.26,10,0.281,11.7,300,53,247,0.177,482,0.622,43,0.683,8.2,334,65,269,0.195,592,0.564,53,0.62,8.6,2022-23,Regular%20Season
1629731,Dean Wade,1610612739,CLE,40,27,13,854.0,20,6,14,0.3,57,0.351,3,0.37,12.1,130,32,98,0.246,221,0.588,20,0.647,5.8,150,38,112,0.253,268,0.56,23,0.612,6.7,2022-23,Regular%20Season
1629028,Deandre Ayton,1610612756,PHX,67,36,31,2035.0,172,119,53,0.692,339,0.507,4,0.513,5.7,495,142,352,0.287,750,0.66,73,0.731,4.2,667,261,405,0.391,1042,0.64,77,0.691,4.6,2022-23,Regular%20Season
1627749,Dejounte Murray,1610612737,ATL,73,38,35,2690.0,53,20,33,0.377,148,0.358,3,0.366,9.7,336,73,263,0.217,569,0.591,70,0.673,6.9,389,93,296,0.239,708,0.549,73,0.613,7.3,2022-23,Regular%20Season
1626153,Delon Wright,1610612764,WAS,46,24,22,1148.0,58,31,27,0.534,100,0.58,1,0.586,8.6,122,14,109,0.115,199,0.613,17,0.67,9.4,180,45,136,0.25,296,0.608,18,0.647,9.1,2022-23,Regular%20Season
1630166,Deni Avdija,1610612764,WAS,75,32,43,2013.0,74,47,26,0.635,197,0.376,8,0.392,7.6,413,85,328,0.206,656,0.63,72,0.707,4.3,487,132,354,0.271,826,0.59,80,0.653,4.8,2022-23,Regular%20Season
203471,Dennis Schroder,1610612747,LAL,60,34,26,1844.0,21,3,18,0.143,72,0.292,2,0.3,17.4,144,12,132,0.083,242,0.595,26,0.667,10.5,165,15,150,0.091,309,0.534,28,0.587,11.4,2022-23,Regular%20Season
1628372,Dennis Smith Jr.,1610612766,CHA,51,17,34,1331.0,27,12,15,0.444,86,0.314,2,0.321,12.9,140,23,117,0.164,258,0.543,39,0.639,7.8,167,35,132,0.21,336,0.497,41,0.566,8.6,2022-23,Regular%20Season
1631220,Dereon Seabron,1610612740,NOP,1,1,0,3.0,1,1,0,1.0,1,1.0,0,1.0,1.8,0,0,0,0.0,1,0.0,0,0.0,0.0,1,1,0,1.0,2,0.5,0,0.5,1.8,2022-23,Regular%20Season
1627884,Derrick Jones Jr.,1610612741,CHI,55,24,31,819.0,59,45,14,0.763,139,0.424,4,0.437,4.7,92,32,61,0.348,166,0.554,16,0.613,6.4,151,77,75,0.51,291,0.519,20,0.557,5.7,2022-23,Regular%20Season
201565,Derrick Rose,1610612752,NYK,18,6,12,250.0,8,3,5,0.375,17,0.471,0,0.471,9.5,32,5,27,0.156,51,0.627,1,0.64,10.7,40,8,32,0.2,68,0.588,1,0.597,10.4,2022-23,Regular%20Season
1628401,Derrick White,1610612738,BOS,77,53,24,2256.0,52,23,28,0.442,118,0.441,8,0.473,8.9,241,53,188,0.22,421,0.572,43,0.638,7.8,293,76,216,0.259,533,0.55,51,0.608,8.0,2022-23,Regular%20Season
1630217,Desmond Bane,1610612763,MEM,57,38,19,1816.0,43,13,30,0.302,134,0.321,4,0.331,14.5,248,59,188,0.238,393,0.631,32,0.687,6.6,291,72,218,0.247,512,0.568,36,0.611,7.8,2022-23,Regular%20Season
1626164,Devin Booker,1610612756,PHX,51,33,18,1803.0,46,22,24,0.478,121,0.38,6,0.4,11.7,194,25,168,0.129,315,0.616,24,0.667,7.9,240,47,192,0.196,434,0.553,30,0.594,8.7,2022-23,Regular%20Season
1630170,Devin Vassell,1610612759,SAS,37,12,25,1151.0,8,5,2,0.625,44,0.182,3,0.195,9.4,140,31,109,0.221,218,0.642,17,0.697,6.3,148,36,111,0.243,254,0.583,20,0.632,6.5,2022-23,Regular%20Season
1629653,Devon Dotson,1610612764,WAS,3,0,3,45.0,6,2,4,0.333,9,0.667,0,0.667,14.2,4,0,4,0.0,8,0.5,0,0.5,11.6,10,2,8,0.2,16,0.625,0,0.625,13.2,2022-23,Regular%20Season
1628984,Devonte' Graham,1610612759,SAS,57,26,31,1142.0,19,2,17,0.105,40,0.475,3,0.514,17.9,103,17,86,0.165,167,0.617,17,0.687,9.1,122,19,103,0.156,205,0.595,20,0.659,10.5,2022-23,Regular%20Season
203473,Dewayne Dedmon,1610612755,PHI,36,23,13,402.0,34,24,10,0.706,101,0.337,5,0.354,6.6,100,32,67,0.32,169,0.592,20,0.671,4.3,134,56,77,0.418,259,0.517,25,0.573,4.9,2022-23,Regular%20Season
1628415,Dillon Brooks,1610612763,MEM,70,43,27,2138.0,45,15,29,0.333,124,0.363,5,0.378,11.1,199,28,171,0.141,346,0.575,32,0.634,7.9,244,43,200,0.176,452,0.54,37,0.588,8.5,2022-23,Regular%20Season
1627734,Domantas Sabonis,1610612758,SAC,79,47,32,2736.0,251,176,76,0.701,628,0.4,16,0.41,4.7,722,216,506,0.299,1145,0.631,109,0.697,3.7,973,392,582,0.403,1703,0.571,125,0.617,4.0,2022-23,Regular%20Season
1631230,Dominick Barlow,1610612759,SAS,24,4,20,354.0,43,29,14,0.674,83,0.518,3,0.538,5.3,52,12,40,0.231,96,0.542,16,0.65,6.0,95,41,54,0.432,172,0.552,19,0.621,5.7,2022-23,Regular%20Season
1628378,Donovan Mitchell,1610612739,CLE,67,43,24,2412.0,63,29,35,0.46,139,0.453,4,0.467,10.9,226,39,187,0.173,362,0.624,18,0.657,8.6,289,68,222,0.235,495,0.584,22,0.611,9.1,2022-23,Regular%20Season
1631495,Donovan Williams,1610612737,ATL,2,1,1,4.0,0,0,0,0.0,0,0.0,0,0.0,0.0,2,0,2,0.0,2,1.0,0,1.0,3.6,2,0,2,0.0,2,1.0,0,1.0,3.6,2022-23,Regular%20Season
1628978,Donte DiVincenzo,1610612744,GSW,66,38,28,1783.0,77,41,36,0.532,152,0.507,4,0.52,9.9,241,24,216,0.1,406,0.594,39,0.657,6.9,318,65,252,0.204,550,0.578,43,0.627,7.6,2022-23,Regular%20Season
1627827,Dorian Finney-Smith,1610612751,BKN,64,30,34,1950.0,114,63,51,0.553,214,0.533,5,0.545,8.1,202,60,142,0.297,373,0.542,43,0.612,6.1,316,123,193,0.389,567,0.557,48,0.609,6.8,2022-23,Regular%20Season
203926,Doug McDermott,1610612759,SAS,57,18,39,1190.0,23,14,8,0.609,62,0.371,2,0.383,10.3,113,18,95,0.159,190,0.595,13,0.638,7.8,136,32,103,0.235,244,0.557,15,0.594,8.2,2022-23,Regular%20Season
203110,Draymond Green,1610612744,GSW,71,39,32,2245.0,66,36,30,0.545,172,0.384,5,0.395,7.5,447,151,294,0.338,726,0.616,71,0.682,5.2,513,187,324,0.365,850,0.604,76,0.663,5.5,2022-23,Regular%20Season
1629234,Drew Eubanks,1610612757,POR,75,30,45,1525.0,132,67,64,0.508,296,0.446,6,0.455,6.5,277,63,214,0.227,482,0.575,46,0.635,4.3,409,130,278,0.318,735,0.556,52,0.599,5.0,2022-23,Regular%20Season
1630696,Dru Smith,1610612751,BKN,11,6,5,144.0,2,0,2,0.0,7,0.286,0,0.286,15.2,22,5,17,0.227,34,0.647,4,0.733,9.0,24,5,19,0.208,39,0.615,4,0.686,9.5,2022-23,Regular%20Season
1630613,Duane Washington Jr.,1610612752,NYK,20,10,10,332.0,2,1,1,0.5,20,0.1,0,0.1,17.3,34,1,33,0.029,43,0.791,0,0.791,9.9,36,2,34,0.056,61,0.59,0,0.59,10.3,2022-23,Regular%20Season
1629130,Duncan Robinson,1610612748,MIA,30,14,16,538.0,8,3,5,0.375,15,0.533,0,0.533,17.4,61,17,44,0.279,96,0.635,7,0.685,7.4,69,20,49,0.29,111,0.622,7,0.663,8.5,2022-23,Regular%20Season
203939,Dwight Powell,1610612742,DAL,72,35,37,1409.0,149,80,68,0.537,357,0.417,12,0.432,5.8,165,49,115,0.297,330,0.5,34,0.557,6.1,314,129,183,0.411,671,0.468,46,0.502,6.0,2022-23,Regular%20Season
1630700,Dyson Daniels,1610612740,NOP,52,30,22,1002.0,36,18,19,0.5,86,0.419,2,0.429,10.5,152,39,113,0.257,258,0.589,18,0.633,6.6,188,57,132,0.303,332,0.566,20,0.603,7.4,2022-23,Regular%20Season
1628410,Edmond Sumner,1610612751,BKN,39,26,13,639.0,13,5,8,0.385,42,0.31,3,0.333,10.1,66,9,57,0.136,115,0.574,8,0.617,8.7,79,14,65,0.177,157,0.503,11,0.541,8.9,2022-23,Regular%20Season
201569,Eric Gordon,1610612746,LAC,56,19,37,1607.0,16,2,14,0.125,56,0.286,0,0.286,17.0,118,12,106,0.102,179,0.659,14,0.715,11.2,134,14,120,0.104,228,0.588,14,0.626,11.9,2022-23,Regular%20Season
1630647,Eugene Omoruyi,1610612765,DET,33,10,23,602.0,43,28,15,0.651,119,0.361,8,0.387,5.4,68,11,57,0.162,117,0.581,8,0.624,7.2,111,39,72,0.351,228,0.487,16,0.524,6.5,2022-23,Regular%20Season
203095,Evan Fournier,1610612752,NYK,23,12,11,415.0,4,1,3,0.25,9,0.444,0,0.444,7.2,45,6,39,0.133,72,0.625,7,0.692,9.4,49,7,42,0.143,80,0.613,7,0.671,9.2,2022-23,Regular%20Season
1630596,Evan Mobley,1610612739,CLE,79,48,31,2715.0,187,117,70,0.626,396,0.472,11,0.486,6.5,524,166,357,0.317,872,0.601,89,0.669,4.8,711,283,427,0.398,1227,0.579,100,0.631,5.3,2022-23,Regular%20Season
1630267,Facundo Campazzo,1610612742,DAL,1,0,1,23.0,0,0,0,0.0,3,0.0,0,0.0,0.0,2,0,2,0.0,2,1.0,0,1.0,13.1,2,0,2,0.0,4,0.5,0,0.5,13.1,2022-23,Regular%20Season
1628402,Frank Jackson,1610612762,UTA,1,0,1,5.0,1,1,0,1.0,3,0.333,0,0.333,2.4,1,0,1,0.0,2,0.5,0,0.5,40.0,2,1,1,0.5,5,0.4,0,0.4,21.2,2022-23,Regular%20Season
1626163,Frank Kaminsky,1610612745,HOU,24,7,17,198.0,7,3,4,0.429,21,0.333,0,0.333,8.1,45,17,28,0.378,66,0.682,3,0.714,3.9,52,20,32,0.385,82,0.634,3,0.658,4.4,2022-23,Regular%20Season
1628373,Frank Ntilikina,1610612742,DAL,32,13,19,503.0,7,3,4,0.429,21,0.333,1,0.35,11.0,55,8,47,0.145,95,0.579,9,0.64,8.6,62,11,51,0.177,109,0.569,10,0.626,8.9,2022-23,Regular%20Season
1630532,Franz Wagner,1610612753,ORL,78,32,46,2545.0,70,31,39,0.443,190,0.368,4,0.376,9.3,259,34,225,0.131,411,0.63,36,0.691,9.0,329,65,264,0.198,594,0.554,40,0.594,9.0,2022-23,Regular%20Season
1627832,Fred VanVleet,1610612761,TOR,67,33,34,2468.0,30,6,24,0.2,114,0.263,7,0.28,15.1,250,46,204,0.184,416,0.601,45,0.674,9.4,280,52,228,0.186,527,0.531,52,0.589,10.0,2022-23,Regular%20Season
1627788,Furkan Korkmaz,1610612755,PHI,21,14,7,263.0,6,2,4,0.333,15,0.4,0,0.4,16.7,36,6,30,0.167,54,0.667,5,0.735,8.6,42,8,34,0.19,69,0.609,5,0.656,9.8,2022-23,Regular%20Season
1629216,Gabe Vincent,1610612748,MIA,60,34,26,1576.0,27,8,19,0.296,58,0.466,0,0.466,16.3,118,20,98,0.169,200,0.59,16,0.641,10.6,145,28,117,0.193,254,0.571,16,0.609,11.7,2022-23,Regular%20Season
1628221,Gabe York,1610612754,IND,2,0,2,43.0,0,0,0,0.0,2,0.0,0,0.0,0.0,6,1,5,0.167,7,0.857,0,0.857,8.2,6,1,5,0.167,8,0.75,0,0.75,8.2,2022-23,Regular%20Season
202066,Garrett Temple,1610612740,NOP,12,6,6,107.0,5,2,3,0.4,10,0.5,0,0.5,11.0,12,4,8,0.333,20,0.6,2,0.667,7.8,17,6,11,0.353,30,0.567,2,0.607,8.7,2022-23,Regular%20Season
1629726,Garrison Mathews,1610612737,ATL,40,11,29,568.0,11,5,6,0.455,34,0.324,3,0.355,13.7,62,7,55,0.113,109,0.569,13,0.646,8.1,73,12,61,0.164,138,0.529,16,0.598,8.9,2022-23,Regular%20Season
203914,Gary Harris,1610612753,ORL,41,18,23,1012.0,21,7,14,0.333,52,0.404,3,0.429,13.0,77,15,62,0.195,117,0.658,8,0.706,12.0,98,22,76,0.224,166,0.59,11,0.632,12.2,2022-23,Regular%20Season
1627780,Gary Payton II,1610612744,GSW,21,13,8,351.0,24,15,9,0.625,49,0.49,2,0.511,6.2,45,12,33,0.267,77,0.584,6,0.634,5.7,69,27,42,0.391,125,0.552,8,0.59,5.8,2022-23,Regular%20Season
1629018,Gary Trent Jr.,1610612761,TOR,62,29,33,1983.0,30,8,22,0.267,68,0.441,4,0.469,15.4,143,23,120,0.161,213,0.671,15,0.722,8.9,173,31,142,0.179,281,0.616,19,0.66,10.1,2022-23,Regular%20Season
201588,George Hill,1610612754,IND,37,22,15,707.0,15,5,10,0.333,49,0.306,3,0.326,12.4,70,14,56,0.2,122,0.574,7,0.609,9.6,85,19,66,0.224,168,0.506,10,0.538,10.1,2022-23,Regular%20Season
1627777,Georges Niang,1610612755,PHI,72,48,24,1423.0,19,8,11,0.421,61,0.311,3,0.328,14.1,166,27,139,0.163,319,0.52,33,0.58,6.3,185,35,150,0.189,360,0.514,36,0.571,7.1,2022-23,Regular%20Season
203507,Giannis Antetokounmpo,1610612749,MIL,63,47,16,2024.0,137,83,56,0.606,313,0.438,7,0.448,7.0,605,135,469,0.223,880,0.688,72,0.749,4.7,742,218,525,0.294,1146,0.647,79,0.695,5.2,2022-23,Regular%20Season
1629048,Goga Bitadze,1610612753,ORL,33,9,24,440.0,61,47,14,0.77,138,0.442,4,0.455,4.7,76,22,54,0.289,145,0.524,25,0.633,3.9,137,69,68,0.504,276,0.496,29,0.555,4.3,2022-23,Regular%20Season
201609,Goran Dragic,1610612749,MIL,36,15,21,617.0,16,4,12,0.25,34,0.471,2,0.5,14.5,63,9,54,0.143,111,0.568,9,0.618,8.8,79,13,66,0.165,144,0.549,11,0.594,10.0,2022-23,Regular%20Season
202330,Gordon Hayward,1610612766,CHA,49,20,29,1551.0,33,16,17,0.485,83,0.398,4,0.418,10.2,182,24,158,0.132,270,0.674,18,0.722,8.6,215,40,175,0.186,339,0.634,22,0.678,8.9,2022-23,Regular%20Season
203476,Gorgui Dieng,1610612759,SAS,28,3,25,336.0,25,10,15,0.4,53,0.472,2,0.49,8.3,74,19,55,0.257,107,0.692,7,0.74,4.9,99,29,70,0.293,147,0.673,9,0.717,5.8,2022-23,Regular%20Season
1629684,Grant Williams,1610612738,BOS,78,54,24,2039.0,87,49,37,0.563,218,0.399,5,0.408,10.1,276,73,203,0.264,477,0.579,50,0.646,5.8,363,122,240,0.336,676,0.537,55,0.585,6.8,2022-23,Regular%20Season
1628960,Grayson Allen,1610612749,MIL,69,51,18,1886.0,61,19,42,0.311,138,0.442,9,0.473,13.0,176,24,152,0.136,318,0.553,32,0.615,8.3,237,43,194,0.181,444,0.534,41,0.588,9.5,2022-23,Regular%20Season
1630535,Greg Brown III,1610612757,POR,9,5,4,68.0,2,2,0,1.0,7,0.286,0,0.286,3.2,17,3,14,0.176,20,0.85,1,0.895,7.6,19,5,14,0.263,26,0.731,1,0.76,7.1,2022-23,Regular%20Season
1628977,Hamidou Diallo,1610612765,DET,52,12,40,954.0,56,32,24,0.571,102,0.549,2,0.56,8.2,134,31,101,0.231,209,0.641,11,0.677,6.1,190,63,125,0.332,302,0.629,13,0.657,6.7,2022-23,Regular%20Season
203084,Harrison Barnes,1610612758,SAC,79,46,33,2586.0,87,37,51,0.425,196,0.444,13,0.475,9.3,279,68,211,0.244,449,0.621,39,0.68,7.7,366,105,262,0.287,624,0.587,52,0.64,8.1,2022-23,Regular%20Season
1629312,Haywood Highsmith,1610612748,MIA,46,25,21,947.0,57,26,31,0.456,129,0.442,7,0.467,8.8,131,27,104,0.206,206,0.636,17,0.693,7.5,188,53,135,0.282,323,0.582,24,0.629,7.9,2022-23,Regular%20Season
1630529,Herbert Jones,1610612740,NOP,64,30,34,1918.0,97,53,44,0.546,203,0.478,9,0.5,9.3,172,46,125,0.267,324,0.531,28,0.581,7.6,269,99,169,0.368,505,0.533,37,0.575,8.3,2022-23,Regular%20Season
1630193,Immanuel Quickley,1610612752,NYK,81,47,34,2344.0,58,9,48,0.155,122,0.475,3,0.487,15.7,279,31,246,0.111,443,0.63,38,0.689,8.2,337,40,294,0.119,559,0.603,41,0.651,9.5,2022-23,Regular%20Season
1630171,Isaac Okoro,1610612739,CLE,63,40,23,1472.0,52,24,28,0.462,120,0.433,3,0.444,9.4,135,29,106,0.215,254,0.531,23,0.584,9.5,187,53,134,0.283,367,0.51,26,0.548,9.5,2022-23,Regular%20Season
1628392,Isaiah Hartenstein,1610612752,NYK,82,47,35,1628.0,209,149,60,0.713,453,0.461,11,0.473,4.9,327,113,213,0.346,579,0.565,56,0.625,4.7,536,262,273,0.489,1002,0.535,67,0.573,4.8,2022-23,Regular%20Season
1630543,Isaiah Jackson,1610612754,IND,60,24,36,1012.0,113,84,29,0.743,251,0.45,9,0.467,3.8,169,74,95,0.438,321,0.526,44,0.61,4.6,282,158,124,0.56,563,0.501,53,0.553,4.3,2022-23,Regular%20Season
1630198,Isaiah Joe,1610612760,OKC,60,30,30,1234.0,27,11,16,0.407,67,0.403,3,0.422,11.3,148,18,130,0.122,263,0.563,36,0.652,7.1,175,29,146,0.166,322,0.543,39,0.618,7.8,2022-23,Regular%20Season
1630587,Isaiah Livers,1610612765,DET,47,9,38,1135.0,27,9,18,0.333,67,0.403,2,0.415,14.4,114,24,90,0.211,205,0.556,22,0.623,7.2,141,33,108,0.234,257,0.549,24,0.605,8.6,2022-23,Regular%20Season
1630600,Isaiah Mobley,1610612739,CLE,8,5,3,78.0,4,4,0,1.0,8,0.5,0,0.5,3.0,16,7,9,0.438,27,0.593,5,0.727,5.5,20,11,9,0.55,33,0.606,5,0.714,5.0,2022-23,Regular%20Season
1629676,Isaiah Roby,1610612752,NYK,36,6,30,446.0,21,13,8,0.619,57,0.368,2,0.382,8.3,83,16,67,0.193,126,0.659,8,0.703,5.3,104,29,75,0.279,172,0.605,10,0.642,5.9,2022-23,Regular%20Season
1630191,Isaiah Stewart,1610612765,DET,49,12,37,1384.0,109,72,37,0.661,257,0.424,5,0.433,5.1,283,73,209,0.258,465,0.609,43,0.671,4.3,392,145,246,0.37,693,0.566,48,0.608,4.6,2022-23,Regular%20Season
1630225,Isaiah Todd,1610612764,WAS,1,0,1,45.0,2,0,2,0.0,6,0.333,0,0.333,14.0,10,1,9,0.1,14,0.714,0,0.714,5.0,12,1,11,0.083,17,0.706,0,0.706,6.5,2022-23,Regular%20Season
202397,Ish Smith,1610612743,DEN,25,12,13,350.0,5,1,4,0.2,16,0.313,2,0.357,12.8,49,12,37,0.245,80,0.613,9,0.69,6.5,54,13,41,0.241,96,0.563,11,0.635,7.0,2022-23,Regular%20Season
1630688,Ish Wainright,1610612756,PHX,47,24,23,814.0,45,24,21,0.533,92,0.489,2,0.5,7.5,94,28,67,0.298,163,0.577,19,0.653,6.6,139,52,88,0.374,246,0.565,21,0.618,6.9,2022-23,Regular%20Season
1627826,Ivica Zubac,1610612746,LAC,76,43,33,2169.0,236,183,53,0.775,539,0.438,9,0.445,3.9,520,169,351,0.325,821,0.633,78,0.7,4.2,756,352,404,0.466,1315,0.575,87,0.616,4.1,2022-23,Regular%20Season
1631120,JD Davison,1610612738,BOS,5,5,0,49.0,2,0,2,0.0,2,1.0,0,1.0,15.7,7,0,7,0.0,10,0.7,1,0.778,6.9,9,0,9,0.0,12,0.75,1,0.818,8.9,2022-23,Regular%20Season
1630550,JT Thor,1610612766,CHA,59,20,39,883.0,36,21,13,0.583,74,0.486,3,0.507,9.0,115,34,80,0.296,183,0.628,12,0.673,7.2,151,55,93,0.364,244,0.619,15,0.659,7.6,2022-23,Regular%20Season
1629630,Ja Morant,1610612763,MEM,61,40,21,1948.0,61,36,26,0.59,193,0.316,6,0.326,8.5,296,44,252,0.149,483,0.613,42,0.671,7.6,357,80,278,0.224,665,0.537,48,0.579,7.8,2022-23,Regular%20Season
203210,JaMychal Green,1610612744,GSW,53,29,24,766.0,72,49,23,0.681,140,0.514,4,0.529,5.0,133,38,95,0.286,215,0.619,18,0.675,4.6,205,87,118,0.424,333,0.616,22,0.659,4.7,2022-23,Regular%20Season
201580,JaVale McGee,1610612742,DAL,37,16,21,331.0,30,22,8,0.733,78,0.385,0,0.385,5.6,77,28,49,0.364,128,0.602,16,0.688,3.7,107,50,57,0.467,195,0.549,16,0.598,4.3,2022-23,Regular%20Season
1631095,Jabari Smith Jr.,1610612745,HOU,79,21,58,2451.0,122,79,42,0.648,292,0.418,11,0.434,7.2,447,120,326,0.268,695,0.643,58,0.702,4.9,569,199,368,0.35,941,0.605,69,0.653,5.4,2022-23,Regular%20Season
1631133,Jabari Walker,1610612757,POR,41,14,27,537.0,46,36,10,0.783,105,0.438,4,0.455,4.5,82,23,59,0.28,134,0.612,8,0.651,5.1,128,59,69,0.461,229,0.559,12,0.59,4.9,2022-23,Regular%20Season
1631298,Jack White,1610612743,DEN,8,4,4,45.0,6,3,3,0.5,13,0.462,1,0.5,3.7,11,6,5,0.545,13,0.846,0,0.846,6.4,17,9,8,0.529,25,0.68,1,0.708,5.4,2022-23,Regular%20Season
1631367,Jacob Gilyard,1610612763,MEM,1,0,1,41.0,0,0,0,0.0,1,0.0,1,0.0,0.0,4,0,4,0.0,7,0.571,0,0.571,12.2,4,0,4,0.0,8,0.5,1,0.571,12.2,2022-23,Regular%20Season
1630702,Jaden Hardy,1610612742,DAL,35,13,22,616.0,11,0,11,0.0,44,0.25,4,0.275,13.9,78,18,60,0.231,127,0.614,9,0.661,7.9,89,18,71,0.202,168,0.53,13,0.574,8.6,2022-23,Regular%20Season
1631093,Jaden Ivey,1610612765,DET,72,16,56,2238.0,73,26,47,0.356,196,0.372,12,0.397,11.4,212,27,184,0.127,392,0.541,52,0.624,7.8,285,53,231,0.186,584,0.488,64,0.548,8.7,2022-23,Regular%20Season
1630183,Jaden McDaniels,1610612750,MIN,75,38,37,2300.0,91,48,43,0.527,191,0.476,2,0.481,9.0,212,47,165,0.222,402,0.527,49,0.601,7.3,303,95,208,0.314,573,0.529,51,0.58,7.8,2022-23,Regular%20Season
1630531,Jaden Springer,1610612755,PHI,9,8,1,70.0,6,3,3,0.5,12,0.5,0,0.5,4.9,8,2,6,0.25,17,0.471,0,0.471,6.6,14,5,9,0.357,28,0.5,0,0.5,5.9,2022-23,Regular%20Season
203109,Jae Crowder,1610612749,MIL,17,12,5,323.0,17,10,7,0.588,34,0.5,0,0.5,10.8,52,10,42,0.192,90,0.578,9,0.642,5.6,69,20,49,0.29,121,0.57,9,0.616,6.8,2022-23,Regular%20Season
1630256,Jae'Sean Tate,1610612745,HOU,31,7,24,677.0,41,22,19,0.537,97,0.423,3,0.436,6.8,77,17,60,0.221,128,0.602,13,0.67,7.2,118,39,79,0.331,222,0.532,16,0.573,7.0,2022-23,Regular%20Season
1631222,Jake LaRavia,1610612763,MEM,23,14,9,353.0,19,9,10,0.474,33,0.576,1,0.594,10.6,44,10,33,0.227,68,0.647,5,0.698,7.3,63,19,43,0.302,96,0.656,6,0.7,8.3,2022-23,Regular%20Season
1627751,Jakob Poeltl,1610612761,TOR,71,26,45,1880.0,233,172,62,0.738,468,0.498,14,0.513,5.2,410,181,228,0.441,635,0.646,55,0.707,4.2,643,353,290,0.549,1076,0.598,69,0.639,4.6,2022-23,Regular%20Season
1628973,Jalen Brunson,1610612752,NYK,66,39,27,2308.0,40,9,31,0.225,99,0.404,4,0.421,12.2,201,33,168,0.164,346,0.581,28,0.632,9.3,241,42,199,0.174,443,0.544,32,0.586,9.8,2022-23,Regular%20Season
1631105,Jalen Duren,1610612765,DET,65,15,50,1638.0,226,167,59,0.739,535,0.422,11,0.431,4.9,357,104,252,0.291,599,0.596,60,0.662,4.0,583,271,311,0.465,1080,0.54,71,0.578,4.4,2022-23,Regular%20Season
1630224,Jalen Green,1610612745,HOU,73,19,54,2513.0,43,16,27,0.372,148,0.291,6,0.303,11.3,241,44,197,0.183,393,0.613,27,0.658,7.0,284,60,224,0.211,539,0.527,33,0.561,7.6,2022-23,Regular%20Season
1630552,Jalen Johnson,1610612737,ATL,67,34,33,1017.0,51,33,18,0.647,115,0.443,1,0.447,6.3,231,58,172,0.251,346,0.668,32,0.736,4.8,282,91,190,0.323,438,0.644,33,0.696,5.1,2022-23,Regular%20Season
1629667,Jalen McDaniels,1610612755,PHI,78,31,47,1859.0,63,30,32,0.476,192,0.328,3,0.333,7.0,283,52,230,0.184,485,0.584,57,0.661,5.3,346,82,262,0.237,646,0.536,60,0.59,5.6,2022-23,Regular%20Season
1630188,Jalen Smith,1610612754,IND,67,31,36,1272.0,129,85,44,0.659,292,0.442,7,0.453,5.2,265,89,176,0.336,428,0.619,39,0.681,4.5,394,174,220,0.442,703,0.56,46,0.6,4.7,2022-23,Regular%20Season
1630591,Jalen Suggs,1610612753,ORL,48,19,29,1171.0,55,32,23,0.582,121,0.455,5,0.474,8.4,106,15,91,0.142,194,0.546,19,0.606,8.5,161,47,114,0.292,311,0.518,24,0.561,8.5,2022-23,Regular%20Season
1631114,Jalen Williams,1610612760,OKC,69,35,34,2144.0,84,39,44,0.464,213,0.394,8,0.41,8.6,253,46,206,0.182,413,0.613,34,0.668,7.5,337,85,250,0.252,599,0.563,42,0.605,7.7,2022-23,Regular%20Season
1631288,Jamal Cain,1610612748,MIA,15,8,7,237.0,15,12,3,0.8,30,0.5,1,0.517,6.0,37,5,32,0.135,56,0.661,6,0.74,6.5,52,17,35,0.327,84,0.619,7,0.675,6.3,2022-23,Regular%20Season
1627750,Jamal Murray,1610612743,DEN,64,43,21,2124.0,48,15,33,0.313,104,0.462,3,0.475,11.3,209,31,178,0.148,333,0.628,29,0.688,8.2,257,46,211,0.179,429,0.599,32,0.647,8.8,2022-23,Regular%20Season
1631123,Jamaree Bouyea,1610612764,WAS,3,0,3,47.0,1,0,1,0.0,1,1.0,0,1.0,20.8,5,1,4,0.2,10,0.5,1,0.556,7.7,6,1,5,0.167,11,0.545,1,0.6,9.9,2022-23,Regular%20Season
1630547,James Bouknight,1610612766,CHA,28,7,21,471.0,8,5,3,0.625,24,0.333,2,0.364,10.8,64,14,46,0.219,98,0.653,5,0.688,7.2,72,19,49,0.264,122,0.59,7,0.626,8.0,2022-23,Regular%20Season
201935,James Harden,1610612755,PHI,58,39,19,2135.0,40,20,20,0.5,149,0.268,5,0.278,9.4,314,45,268,0.143,466,0.674,31,0.722,6.4,354,65,288,0.184,573,0.618,36,0.659,6.7,2022-23,Regular%20Season
201949,James Johnson,1610612754,IND,11,4,7,135.0,4,1,3,0.25,13,0.308,0,0.308,3.7,26,4,21,0.154,34,0.765,2,0.813,5.4,30,5,24,0.167,45,0.667,2,0.698,5.2,2022-23,Regular%20Season
1630164,James Wiseman,1610612765,DET,43,11,32,853.0,73,45,28,0.616,198,0.369,8,0.384,5.0,194,51,142,0.263,310,0.626,19,0.667,3.5,267,96,170,0.36,485,0.551,27,0.583,3.9,2022-23,Regular%20Season
1630215,Jared Butler,1610612760,OKC,2,2,0,49.0,1,0,1,0.0,3,0.333,0,0.333,6.9,3,1,2,0.333,7,0.429,0,0.429,10.9,4,1,3,0.25,10,0.4,0,0.4,9.9,2022-23,Regular%20Season
1631197,Jared Rhoden,1610612765,DET,11,1,10,189.0,11,7,4,0.636,21,0.524,1,0.55,7.4,26,5,21,0.192,37,0.703,2,0.743,6.1,37,12,25,0.324,57,0.649,3,0.685,6.5,2022-23,Regular%20Season
1628991,Jaren Jackson Jr.,1610612763,MEM,63,41,22,1787.0,108,67,41,0.62,240,0.45,8,0.466,6.9,318,100,217,0.314,596,0.534,59,0.592,6.0,426,167,258,0.392,816,0.522,67,0.569,6.3,2022-23,Regular%20Season
1629020,Jarred Vanderbilt,1610612747,LAL,78,43,35,1880.0,170,91,79,0.535,389,0.437,10,0.449,6.0,412,72,338,0.175,602,0.684,47,0.742,5.3,582,163,417,0.28,950,0.613,57,0.652,5.5,2022-23,Regular%20Season
1629714,Jarrell Brantley,1610612762,UTA,3,0,3,37.0,1,0,1,0.0,5,0.2,0,0.2,26.8,5,2,3,0.4,13,0.385,2,0.455,9.6,6,2,4,0.333,18,0.333,2,0.375,12.5,2022-23,Regular%20Season
1628386,Jarrett Allen,1610612739,CLE,67,44,23,2213.0,221,170,51,0.769,436,0.507,10,0.519,4.9,445,147,298,0.33,719,0.619,80,0.696,4.9,666,317,349,0.476,1127,0.591,90,0.642,4.9,2022-23,Regular%20Season
1629633,Jarrett Culver,1610612737,ATL,8,3,5,133.0,10,8,2,0.8,25,0.4,0,0.4,4.3,28,6,22,0.214,35,0.8,1,0.824,6.4,38,14,24,0.368,54,0.704,1,0.717,5.8,2022-23,Regular%20Season
1630554,Jason Preston,1610612746,LAC,9,1,8,106.0,2,0,2,0.0,6,0.333,0,0.333,13.1,20,4,16,0.2,30,0.667,1,0.69,7.3,22,4,18,0.182,35,0.629,1,0.647,7.8,2022-23,Regular%20Season
1629750,Javonte Green,1610612741,CHI,30,12,18,461.0,27,19,8,0.704,66,0.409,1,0.415,7.2,61,21,40,0.344,107,0.57,15,0.663,5.7,88,40,48,0.455,168,0.524,16,0.579,6.2,2022-23,Regular%20Season
1629637,Jaxson Hayes,1610612740,NOP,42,19,23,591.0,39,23,16,0.59,91,0.429,2,0.438,6.9,93,17,76,0.183,141,0.66,11,0.715,5.8,132,40,92,0.303,224,0.589,13,0.626,6.1,2022-23,Regular%20Season
1630643,Jay Huff,1610612764,WAS,5,1,4,89.0,6,5,1,0.833,14,0.429,0,0.429,12.1,15,4,11,0.267,29,0.517,2,0.556,3.8,21,9,12,0.429,40,0.525,2,0.553,6.2,2022-23,Regular%20Season
1630206,Jay Scrubb,1610612753,ORL,2,1,1,30.0,0,0,0,0.0,1,0.0,0,0.0,0.0,6,1,5,0.167,6,1.0,0,1.0,5.4,6,1,5,0.167,7,0.857,0,0.857,5.4,2022-23,Regular%20Season
1627759,Jaylen Brown,1610612738,BOS,67,46,21,2405.0,78,36,41,0.462,218,0.358,6,0.368,9.3,381,58,324,0.152,598,0.637,62,0.711,6.6,459,94,365,0.205,776,0.591,68,0.648,7.1,2022-23,Regular%20Season
1629669,Jaylen Nowell,1610612750,MIN,59,32,27,1166.0,36,15,21,0.417,83,0.434,2,0.444,11.1,134,19,115,0.142,211,0.635,16,0.687,8.9,170,34,136,0.2,290,0.586,18,0.625,9.3,2022-23,Regular%20Season
1631119,Jaylin Williams,1610612760,OKC,47,22,25,900.0,44,23,21,0.523,115,0.383,4,0.396,8.5,197,61,136,0.31,311,0.633,27,0.694,4.8,241,84,157,0.349,405,0.595,31,0.644,5.5,2022-23,Regular%20Season
1628369,Jayson Tatum,1610612738,BOS,74,52,22,2732.0,78,37,41,0.474,201,0.388,7,0.402,9.4,571,80,491,0.14,780,0.732,49,0.781,5.8,649,117,532,0.18,939,0.691,56,0.735,6.2,2022-23,Regular%20Season
1630288,Jeff Dowtin Jr.,1610612761,TOR,13,9,4,196.0,6,1,5,0.167,12,0.5,1,0.545,15.4,17,4,13,0.235,20,0.85,1,0.895,11.9,23,5,18,0.217,31,0.742,2,0.793,12.8,2022-23,Regular%20Season
201145,Jeff Green,1610612743,DEN,49,28,21,968.0,38,12,26,0.316,79,0.481,1,0.487,10.2,106,29,78,0.274,171,0.62,11,0.663,7.8,144,41,104,0.285,240,0.6,12,0.632,8.4,2022-23,Regular%20Season
203924,Jerami Grant,1610612757,POR,61,27,34,2187.0,53,18,35,0.34,157,0.338,9,0.358,12.4,230,40,190,0.174,357,0.644,32,0.708,7.9,283,58,225,0.205,490,0.578,41,0.63,8.8,2022-23,Regular%20Season
1630526,Jeremiah Robinson-Earl,1610612760,OKC,39,13,26,793.0,71,48,23,0.676,149,0.477,8,0.504,5.3,109,38,71,0.349,229,0.476,38,0.571,4.5,180,86,94,0.478,364,0.495,46,0.566,4.8,2022-23,Regular%20Season
1631110,Jeremy Sochan,1610612759,SAS,54,15,39,1419.0,92,54,37,0.587,192,0.479,6,0.495,6.8,195,43,153,0.221,348,0.56,48,0.65,5.5,287,97,190,0.338,530,0.542,54,0.603,5.9,2022-23,Regular%20Season
1630579,Jericho Sims,1610612752,NYK,48,29,19,797.0,99,60,39,0.606,194,0.51,7,0.529,6.2,143,53,90,0.371,251,0.57,26,0.636,4.4,242,113,129,0.467,435,0.556,33,0.602,5.1,2022-23,Regular%20Season
1628975,Jevon Carter,1610612749,MIL,74,52,22,1701.0,35,10,25,0.286,98,0.357,4,0.372,13.4,167,14,152,0.084,256,0.652,15,0.693,10.8,202,24,177,0.119,343,0.589,19,0.623,11.2,2022-23,Regular%20Season
202710,Jimmy Butler,1610612748,MIA,64,35,29,2138.0,141,94,46,0.667,275,0.513,5,0.522,5.6,234,57,177,0.244,375,0.624,23,0.665,6.6,375,151,223,0.403,637,0.589,28,0.616,6.3,2022-23,Regular%20Season
1629111,Jock Landale,1610612756,PHX,64,33,31,938.0,119,88,31,0.739,289,0.412,7,0.422,5.5,161,50,112,0.311,295,0.546,34,0.617,5.3,280,138,143,0.493,568,0.493,41,0.531,5.4,2022-23,Regular%20Season
203925,Joe Harris,1610612751,BKN,62,33,29,1335.0,23,8,13,0.348,55,0.418,3,0.442,15.1,141,32,108,0.227,257,0.549,24,0.605,7.8,164,40,121,0.244,303,0.541,27,0.594,8.8,2022-23,Regular%20Season
204060,Joe Ingles,1610612749,MIL,43,32,11,993.0,13,3,10,0.231,28,0.464,2,0.5,16.1,115,14,101,0.122,165,0.697,12,0.752,7.1,128,17,111,0.133,191,0.67,14,0.723,8.0,2022-23,Regular%20Season
1630580,Joe Wieskamp,1610612761,TOR,3,2,1,24.0,0,0,0,0.0,3,0.0,1,0.0,0.0,4,0,4,0.0,4,1.0,0,1.0,3.4,4,0,4,0.0,6,0.667,1,0.8,3.4,2022-23,Regular%20Season
203954,Joel Embiid,1610612755,PHI,66,43,23,2284.0,113,81,32,0.717,278,0.406,4,0.412,6.1,557,170,387,0.305,900,0.619,88,0.686,4.7,670,251,419,0.375,1145,0.585,92,0.636,5.0,2022-23,Regular%20Season
1631219,John Butler Jr.,1610612757,POR,9,1,8,148.0,3,3,0,1.0,6,0.5,0,0.5,5.6,12,5,7,0.417,24,0.5,2,0.545,7.0,15,8,7,0.533,29,0.517,2,0.556,6.7,2022-23,Regular%20Season
1628381,John Collins,1610612737,ATL,71,37,34,2130.0,77,42,34,0.545,233,0.33,3,0.335,8.8,385,119,266,0.309,652,0.59,68,0.659,4.6,462,161,300,0.348,841,0.549,71,0.6,5.3,2022-23,Regular%20Season
1629723,John Konchar,1610612763,MEM,70,44,26,1473.0,64,32,31,0.5,162,0.395,7,0.413,9.1,246,58,188,0.236,369,0.667,25,0.715,6.1,310,90,219,0.29,498,0.622,32,0.665,6.7,2022-23,Regular%20Season
202322,John Wall,1610612746,LAC,30,15,15,676.0,14,7,7,0.5,38,0.368,1,0.378,16.9,78,9,69,0.115,128,0.609,12,0.672,8.2,92,16,76,0.174,165,0.558,13,0.605,9.6,2022-23,Regular%20Season
1631098,Johnny Davis,1610612764,WAS,17,6,11,351.0,10,2,7,0.2,31,0.323,0,0.323,10.0,55,9,45,0.164,81,0.679,7,0.743,7.6,65,11,52,0.169,108,0.602,7,0.644,7.9,2022-23,Regular%20Season
1630548,Johnny Juzang,1610612762,UTA,15,6,9,200.0,8,3,5,0.375,22,0.364,0,0.364,7.8,31,6,25,0.194,41,0.756,1,0.775,7.7,39,9,30,0.231,60,0.65,1,0.661,7.8,2022-23,Regular%20Season
202685,Jonas Valanciunas,1610612740,NOP,79,40,39,1968.0,225,175,49,0.778,499,0.451,11,0.461,4.0,579,176,402,0.304,875,0.662,66,0.716,3.8,804,351,451,0.437,1330,0.605,77,0.642,3.9,2022-23,Regular%20Season
1628371,Jonathan Isaac,1610612753,ORL,11,8,3,124.0,15,12,3,0.8,29,0.517,1,0.536,2.4,29,8,21,0.276,42,0.69,3,0.744,4.3,44,20,24,0.455,67,0.657,4,0.698,3.6,2022-23,Regular%20Season
1630228,Jonathan Kuminga,1610612744,GSW,59,33,26,1275.0,70,38,32,0.543,161,0.435,9,0.461,7.5,161,43,118,0.267,296,0.544,30,0.605,6.2,231,81,150,0.351,438,0.527,39,0.579,6.6,2022-23,Regular%20Season
203903,Jordan Clarkson,1610612762,UTA,59,29,30,1934.0,72,34,38,0.472,158,0.456,3,0.465,8.4,174,25,147,0.144,301,0.578,23,0.626,8.1,246,59,185,0.24,449,0.548,26,0.582,8.2,2022-23,Regular%20Season
1630692,Jordan Goodwin,1610612764,WAS,55,20,35,1052.0,57,38,19,0.667,124,0.46,5,0.479,6.4,148,27,121,0.182,230,0.643,21,0.708,6.9,205,65,140,0.317,345,0.594,26,0.643,6.8,2022-23,Regular%20Season
1631160,Jordan Hall,1610612759,SAS,5,0,5,68.0,3,1,2,0.333,5,0.6,0,0.6,11.7,9,2,7,0.222,13,0.692,0,0.692,12.4,12,3,9,0.25,18,0.667,0,0.667,12.2,2022-23,Regular%20Season
1629162,Jordan McLaughlin,1610612750,MIN,30,14,16,512.0,15,5,10,0.333,31,0.484,0,0.484,14.2,45,7,38,0.156,82,0.549,7,0.6,9.7,60,12,48,0.2,109,0.55,7,0.588,10.8,2022-23,Regular%20Season
1629670,Jordan Nwora,1610612754,IND,57,34,23,1149.0,51,24,27,0.471,121,0.421,4,0.436,10.0,178,28,150,0.157,259,0.687,21,0.748,6.3,229,52,177,0.227,365,0.627,25,0.674,7.1,2022-23,Regular%20Season
1629673,Jordan Poole,1610612744,GSW,77,41,36,2304.0,31,14,18,0.452,118,0.263,4,0.272,13.1,191,28,163,0.147,299,0.639,26,0.7,9.6,222,42,181,0.189,413,0.538,30,0.58,10.2,2022-23,Regular%20Season
1630631,Jose Alvarado,1610612740,NOP,57,29,28,1230.0,28,9,19,0.321,80,0.35,5,0.373,10.3,113,25,88,0.221,198,0.571,23,0.646,9.2,141,34,107,0.241,274,0.515,28,0.573,9.4,2022-23,Regular%20Season
1630528,Josh Christopher,1610612745,HOU,43,11,32,577.0,20,8,12,0.4,51,0.392,2,0.408,11.1,51,8,43,0.157,79,0.646,6,0.699,8.7,71,16,55,0.225,127,0.559,8,0.597,9.4,2022-23,Regular%20Season
1630581,Josh Giddey,1610612760,OKC,76,34,42,2367.0,148,83,64,0.561,346,0.428,16,0.448,6.8,451,84,367,0.186,682,0.661,40,0.702,6.0,599,167,431,0.279,981,0.611,56,0.648,6.2,2022-23,Regular%20Season
1630182,Josh Green,1610612742,DAL,57,26,31,1485.0,55,14,41,0.255,118,0.466,2,0.474,10.5,127,24,103,0.189,229,0.555,23,0.617,7.6,182,38,144,0.209,344,0.529,25,0.571,8.5,2022-23,Regular%20Season
1628404,Josh Hart,1610612752,NYK,76,42,34,2454.0,142,80,62,0.563,306,0.464,13,0.485,10.0,451,102,349,0.226,712,0.633,66,0.698,6.1,593,182,411,0.307,985,0.602,79,0.655,7.1,2022-23,Regular%20Season
1631169,Josh Minott,1610612750,MIN,6,3,3,72.0,5,4,1,0.8,10,0.5,0,0.5,3.3,20,4,16,0.2,23,0.87,1,0.909,6.5,25,8,17,0.32,32,0.781,1,0.806,5.9,2022-23,Regular%20Season
1629006,Josh Okogie,1610612756,PHX,67,34,33,1332.0,109,67,42,0.615,208,0.524,3,0.532,7.2,142,45,97,0.317,246,0.577,26,0.645,7.1,251,112,139,0.446,443,0.567,29,0.606,7.1,2022-23,Regular%20Season
1626196,Josh Richardson,1610612740,NOP,61,23,38,1442.0,40,18,22,0.45,82,0.488,3,0.506,11.1,132,19,113,0.144,244,0.541,26,0.606,7.3,172,37,135,0.215,318,0.541,29,0.595,8.2,2022-23,Regular%20Season
1630563,Joshua Primo,1610612759,SAS,4,3,1,93.0,2,1,1,0.5,10,0.2,1,0.222,14.1,11,0,11,0.0,22,0.5,3,0.579,11.4,13,1,12,0.077,32,0.406,4,0.464,11.8,2022-23,Regular%20Season
201950,Jrue Holiday,1610612749,MIL,65,48,17,2133.0,78,43,35,0.551,203,0.384,8,0.4,8.4,261,42,218,0.161,403,0.648,30,0.7,8.4,339,85,253,0.251,592,0.573,38,0.612,8.4,2022-23,Regular%20Season
1629308,Juan Toscano-Anderson,1610612762,UTA,45,15,30,670.0,28,14,14,0.5,72,0.389,5,0.418,7.6,96,16,80,0.167,155,0.619,6,0.644,5.8,124,30,94,0.242,215,0.577,11,0.608,6.2,2022-23,Regular%20Season
1627823,Juancho Hernangomez,1610612761,TOR,35,16,19,561.0,27,12,15,0.444,72,0.375,4,0.397,10.7,96,16,80,0.167,151,0.636,15,0.706,5.5,123,28,95,0.228,212,0.58,19,0.637,6.7,2022-23,Regular%20Season
1630577,Julian Champagnie,1610612759,SAS,13,4,9,256.0,8,4,4,0.5,23,0.348,1,0.364,9.7,43,7,36,0.163,68,0.632,3,0.662,6.6,51,11,40,0.216,85,0.6,4,0.63,7.1,2022-23,Regular%20Season
203944,Julius Randle,1610612752,NYK,77,44,33,2737.0,141,90,51,0.638,367,0.384,13,0.398,6.1,626,125,499,0.2,923,0.678,56,0.722,4.6,767,215,550,0.28,1213,0.632,69,0.67,4.9,2022-23,Regular%20Season
1630551,Justin Champagnie,1610612738,BOS,4,3,1,31.0,3,2,1,0.667,7,0.429,0,0.429,7.8,5,2,3,0.4,7,0.714,1,0.833,5.8,8,4,4,0.5,14,0.571,1,0.615,6.5,2022-23,Regular%20Season
203200,Justin Holiday,1610612742,DAL,29,13,16,481.0,5,2,3,0.4,19,0.263,1,0.278,10.6,50,14,36,0.28,85,0.588,6,0.633,7.9,55,16,39,0.291,99,0.556,7,0.598,8.1,2022-23,Regular%20Season
1628382,Justin Jackson,1610612738,BOS,10,7,3,73.0,2,1,1,0.5,3,0.667,0,0.667,8.1,15,3,12,0.2,21,0.714,2,0.789,11.0,17,4,13,0.235,24,0.708,2,0.773,10.6,2022-23,Regular%20Season
1631303,Justin Minaya,1610612757,POR,3,0,3,61.0,2,2,0,1.0,2,1.0,0,1.0,7.7,10,1,9,0.1,15,0.667,0,0.667,9.1,12,3,9,0.25,17,0.706,0,0.706,8.8,2022-23,Regular%20Season
1626159,Justise Winslow,1610612757,POR,28,15,13,758.0,49,33,16,0.673,104,0.471,6,0.5,5.3,96,24,72,0.25,182,0.527,19,0.589,5.8,145,57,88,0.393,280,0.518,25,0.569,5.7,2022-23,Regular%20Season
203994,Jusuf Nurkic,1610612757,POR,52,24,28,1391.0,114,82,31,0.719,272,0.419,4,0.425,4.4,357,123,233,0.345,571,0.625,56,0.693,4.3,471,205,264,0.435,826,0.57,60,0.615,4.3,2022-23,Regular%20Season
1630231,KJ Martin,1610612745,HOU,82,22,60,2292.0,126,79,46,0.627,252,0.5,3,0.506,8.0,326,77,248,0.236,468,0.697,30,0.744,6.5,452,156,294,0.345,703,0.643,33,0.675,6.9,2022-23,Regular%20Season
1629644,KZ Okpala,1610612758,SAC,17,7,10,186.0,7,2,5,0.286,15,0.467,1,0.5,8.0,27,9,18,0.333,48,0.563,5,0.628,6.9,34,11,23,0.324,63,0.54,6,0.596,7.2,2022-23,Regular%20Season
1630539,Kai Jones,1610612766,CHA,31,8,23,461.0,37,27,10,0.73,77,0.481,5,0.514,5.8,86,18,68,0.209,144,0.597,11,0.647,5.8,123,45,78,0.366,219,0.562,16,0.606,5.8,2022-23,Regular%20Season
1626157,Karl-Anthony Towns,1610612750,MIN,28,14,14,929.0,48,26,22,0.542,101,0.475,2,0.485,9.1,180,42,138,0.233,277,0.65,19,0.698,5.8,228,68,160,0.298,367,0.621,21,0.659,6.5,2022-23,Regular%20Season
202695,Kawhi Leonard,1610612746,LAC,52,33,19,1748.0,57,30,27,0.526,132,0.432,4,0.445,10.1,281,75,206,0.267,415,0.677,29,0.728,6.3,338,105,233,0.311,520,0.65,33,0.694,7.0,2022-23,Regular%20Season
1631099,Keegan Murray,1610612758,SAC,78,46,32,2337.0,89,42,47,0.472,167,0.533,6,0.553,9.8,282,62,220,0.22,445,0.634,36,0.689,6.6,371,104,267,0.28,593,0.626,42,0.673,7.4,2022-23,Regular%20Season
1628966,Keita Bates-Diop,1610612759,SAS,57,13,44,1344.0,62,42,20,0.677,142,0.437,3,0.446,6.1,177,45,132,0.254,258,0.686,21,0.747,6.7,239,87,152,0.364,381,0.627,24,0.669,6.6,2022-23,Regular%20Season
1629640,Keldon Johnson,1610612759,SAS,60,15,45,1987.0,55,28,27,0.509,175,0.314,9,0.331,8.6,256,41,216,0.16,405,0.632,36,0.694,5.7,311,69,243,0.222,547,0.569,45,0.62,6.2,2022-23,Regular%20Season
203482,Kelly Olynyk,1610612762,UTA,67,27,40,1927.0,82,41,40,0.5,211,0.389,12,0.412,8.0,338,78,261,0.231,549,0.616,46,0.672,5.8,420,119,301,0.283,737,0.57,58,0.619,6.3,2022-23,Regular%20Season
1626162,Kelly Oubre Jr.,1610612766,CHA,48,16,32,1547.0,65,32,34,0.492,135,0.481,4,0.496,9.1,184,42,142,0.228,296,0.622,22,0.672,7.1,249,74,176,0.297,428,0.582,26,0.619,7.6,2022-23,Regular%20Season
202689,Kemba Walker,1610612742,DAL,5,2,3,119.0,3,1,2,0.333,7,0.429,0,0.429,18.5,13,3,10,0.231,24,0.542,2,0.591,5.8,16,4,12,0.25,31,0.516,2,0.552,8.2,2022-23,Regular%20Season
1631112,Kendall Brown,1610612754,IND,2,1,1,25.0,2,0,2,0.0,3,0.667,0,0.667,11.3,4,3,1,0.75,8,0.5,3,0.8,9.6,6,3,3,0.5,11,0.545,3,0.75,10.1,2022-23,Regular%20Season
1629134,Kendrick Nunn,1610612764,WAS,51,24,27,831.0,15,5,10,0.333,46,0.326,1,0.333,11.8,94,12,81,0.128,140,0.671,7,0.707,9.0,109,17,91,0.156,184,0.592,8,0.619,9.4,2022-23,Regular%20Season
1631113,Kennedy Chandler,1610612763,MEM,22,14,8,218.0,9,5,4,0.556,16,0.563,1,0.6,7.4,29,5,24,0.172,50,0.58,4,0.63,7.4,38,10,28,0.263,66,0.576,5,0.623,7.4,2022-23,Regular%20Season
1631254,Kenneth Lofton Jr.,1610612763,MEM,17,10,7,160.0,19,9,10,0.474,32,0.594,0,0.594,4.8,32,8,24,0.25,55,0.582,3,0.615,5.6,51,17,34,0.333,83,0.614,3,0.638,5.3,2022-23,Regular%20Season
1629026,Kenrich Williams,1610612760,OKC,53,26,27,1206.0,97,59,38,0.608,210,0.462,5,0.473,6.5,164,51,111,0.311,283,0.58,31,0.651,5.7,261,110,149,0.421,474,0.551,36,0.596,6.0,2022-23,Regular%20Season
203484,Kentavious Caldwell-Pope,1610612743,DEN,70,47,23,2222.0,35,12,23,0.343,77,0.455,3,0.473,12.3,173,29,144,0.168,292,0.592,19,0.634,9.1,208,41,167,0.197,368,0.565,22,0.601,9.6,2022-23,Regular%20Season
1631165,Keon Ellis,1610612758,SAC,5,2,3,31.0,4,1,3,0.25,6,0.667,0,0.667,12.9,4,0,4,0.0,7,0.571,0,0.571,6.9,8,1,7,0.125,12,0.667,0,0.667,9.9,2022-23,Regular%20Season
1630553,Keon Johnson,1610612757,POR,21,7,14,339.0,11,6,5,0.545,31,0.355,2,0.379,10.9,33,8,25,0.242,48,0.688,3,0.733,10.7,44,14,30,0.318,77,0.571,5,0.611,10.7,2022-23,Regular%20Season
1630556,Kessler Edwards,1610612758,SAC,20,9,11,322.0,23,14,9,0.609,43,0.535,4,0.59,7.4,38,7,31,0.184,66,0.576,4,0.613,7.0,61,21,40,0.344,105,0.581,8,0.629,7.2,2022-23,Regular%20Season
201142,Kevin Durant,1610612756,PHX,47,34,13,1672.0,17,6,11,0.353,60,0.283,1,0.288,16.9,296,79,213,0.267,441,0.671,34,0.727,6.1,313,85,224,0.272,486,0.644,35,0.694,6.7,2022-23,Regular%20Season
1628989,Kevin Huerter,1610612758,SAC,68,40,28,2021.0,42,19,23,0.452,103,0.408,2,0.416,12.1,209,28,181,0.134,324,0.645,30,0.711,7.6,251,47,204,0.187,418,0.6,32,0.65,8.4,2022-23,Regular%20Season
1628995,Kevin Knox II,1610612757,POR,53,11,42,870.0,33,20,13,0.606,77,0.429,2,0.44,8.2,141,28,113,0.199,214,0.659,15,0.709,6.1,174,48,126,0.276,271,0.642,17,0.685,6.5,2022-23,Regular%20Season
201567,Kevin Love,1610612748,MIA,61,35,26,1227.0,59,40,19,0.678,151,0.391,5,0.404,5.8,340,106,233,0.312,510,0.667,41,0.725,4.1,399,146,252,0.366,631,0.632,46,0.682,4.4,2022-23,Regular%20Season
1629645,Kevin Porter Jr.,1610612745,HOU,58,18,40,1989.0,76,29,47,0.382,168,0.452,6,0.469,10.7,238,47,192,0.197,358,0.665,21,0.706,7.5,314,76,239,0.242,518,0.606,27,0.64,8.3,2022-23,Regular%20Season
1630284,Kevon Harris,1610612753,ORL,29,10,19,408.0,28,18,10,0.643,65,0.431,0,0.431,7.4,42,9,33,0.214,84,0.5,6,0.538,8.4,70,27,43,0.386,147,0.476,6,0.496,8.0,2022-23,Regular%20Season
1626172,Kevon Looney,1610612744,GSW,81,43,38,1937.0,272,179,93,0.658,499,0.545,8,0.554,5.1,478,136,342,0.285,738,0.648,54,0.699,4.6,750,315,435,0.42,1197,0.627,62,0.661,4.8,2022-23,Regular%20Season
203920,Khem Birch,1610612759,SAS,14,6,8,123.0,8,4,4,0.5,15,0.533,0,0.533,5.9,17,2,15,0.118,28,0.607,3,0.68,5.4,25,6,19,0.24,43,0.581,3,0.625,5.6,2022-23,Regular%20Season
203114,Khris Middleton,1610612749,MIL,32,25,7,794.0,28,12,16,0.429,70,0.4,4,0.424,9.8,112,14,97,0.125,186,0.602,24,0.691,6.8,140,26,113,0.186,253,0.553,28,0.622,7.4,2022-23,Regular%20Season
1630165,Killian Hayes,1610612765,DET,71,15,56,2044.0,28,9,19,0.321,71,0.394,1,0.4,15.5,192,30,161,0.156,347,0.553,33,0.611,8.2,220,39,180,0.177,412,0.534,34,0.582,9.1,2022-23,Regular%20Season
1630184,Kira Lewis Jr.,1610612740,NOP,17,7,10,193.0,5,1,4,0.2,10,0.5,0,0.5,9.4,28,1,27,0.036,42,0.667,2,0.7,9.5,33,2,31,0.061,52,0.635,2,0.66,9.5,2022-23,Regular%20Season
202691,Klay Thompson,1610612744,GSW,66,36,30,2210.0,39,14,25,0.359,99,0.394,2,0.402,12.3,244,41,203,0.168,404,0.604,33,0.658,7.8,283,55,228,0.194,483,0.586,35,0.632,8.5,2022-23,Regular%20Season
1628424,Kobi Simmons,1610612766,CHA,3,1,2,22.0,1,1,0,1.0,2,0.5,0,0.5,9.2,3,1,2,0.333,4,0.75,0,0.75,10.7,4,2,2,0.5,5,0.8,0,0.8,10.3,2022-23,Regular%20Season
1627739,Kris Dunn,1610612762,UTA,22,8,14,568.0,9,4,5,0.444,24,0.375,1,0.391,16.4,91,20,71,0.22,140,0.65,12,0.711,6.6,100,24,76,0.24,162,0.617,13,0.671,7.5,2022-23,Regular%20Season
204001,Kristaps Porzingis,1610612764,WAS,65,27,38,2119.0,114,78,36,0.684,261,0.437,9,0.452,6.2,432,142,290,0.329,673,0.642,56,0.7,4.9,546,220,326,0.403,900,0.607,65,0.654,5.2,2022-23,Regular%20Season
203937,Kyle Anderson,1610612750,MIN,64,35,29,1892.0,65,32,33,0.492,163,0.399,2,0.404,8.5,301,67,234,0.223,459,0.656,23,0.69,6.7,366,99,267,0.27,585,0.626,25,0.654,7.0,2022-23,Regular%20Season
1628398,Kyle Kuzma,1610612764,WAS,64,29,35,2239.0,55,27,28,0.491,159,0.346,1,0.348,8.1,408,85,323,0.208,568,0.718,43,0.777,5.5,463,112,351,0.242,701,0.66,44,0.705,5.8,2022-23,Regular%20Season
200768,Kyle Lowry,1610612748,MIA,55,30,25,1718.0,43,16,27,0.372,128,0.336,6,0.352,10.1,182,30,152,0.165,384,0.474,50,0.545,7.8,225,46,179,0.204,508,0.443,56,0.498,8.3,2022-23,Regular%20Season
202681,Kyrie Irving,1610612742,DAL,60,32,28,2241.0,59,27,32,0.458,144,0.41,5,0.424,10.1,245,43,202,0.176,391,0.627,27,0.673,8.2,304,70,234,0.23,521,0.583,32,0.622,8.5,2022-23,Regular%20Season
1630163,LaMelo Ball,1610612766,CHA,36,13,23,1268.0,42,25,17,0.595,95,0.442,3,0.457,8.1,189,29,160,0.153,285,0.663,16,0.703,7.3,231,54,177,0.234,379,0.609,19,0.642,7.5,2022-23,Regular%20Season
1630205,Lamar Stevens,1610612739,CLE,55,32,23,1061.0,48,31,17,0.646,110,0.436,2,0.444,6.6,159,36,122,0.226,266,0.598,24,0.657,4.9,207,67,139,0.324,365,0.567,26,0.611,5.3,2022-23,Regular%20Season
1629013,Landry Shamet,1610612756,PHX,30,12,18,670.0,11,4,7,0.364,29,0.379,0,0.379,13.1,56,13,43,0.232,96,0.583,7,0.629,9.1,67,17,50,0.254,121,0.554,7,0.588,9.7,2022-23,Regular%20Season
1626204,Larry Nance Jr.,1610612740,NOP,64,34,30,1367.0,106,69,37,0.651,241,0.44,2,0.444,5.6,248,86,162,0.347,422,0.588,45,0.658,5.2,354,155,199,0.438,646,0.548,47,0.591,5.3,2022-23,Regular%20Season
1628374,Lauri Markkanen,1610612762,UTA,66,32,34,2272.0,130,81,48,0.623,285,0.456,5,0.464,7.2,440,116,324,0.264,627,0.702,33,0.741,5.3,570,197,372,0.346,866,0.658,38,0.688,5.7,2022-23,Regular%20Season
2544,LeBron James,1610612747,LAL,55,30,25,1954.0,65,38,26,0.585,161,0.404,3,0.411,6.5,392,87,304,0.222,555,0.706,53,0.781,5.9,457,125,330,0.274,688,0.664,56,0.723,6.0,2022-23,Regular%20Season
1630195,Leandro Bolmaro,1610612762,UTA,6,1,5,49.0,4,4,0,1.0,8,0.5,0,0.5,6.1,3,1,2,0.333,8,0.375,1,0.429,12.3,7,5,2,0.714,16,0.438,1,0.467,8.8,2022-23,Regular%20Season
1631311,Lester Quinones,1610612744,GSW,3,3,0,17.0,1,0,1,0.0,2,0.5,0,0.5,5.7,2,1,1,0.5,5,0.4,1,0.5,11.1,3,1,2,0.333,7,0.429,1,0.5,9.3,2022-23,Regular%20Season
1629623,Lindell Wigginton,1610612749,MIL,3,1,2,76.0,0,0,0,0.0,2,0.0,0,0.0,0.0,7,2,5,0.286,14,0.5,2,0.583,8.5,7,2,5,0.286,16,0.438,2,0.5,8.5,2022-23,Regular%20Season
1630322,Lindy Waters III,1610612760,OKC,29,15,14,440.0,16,6,10,0.375,31,0.516,2,0.552,9.2,59,16,43,0.271,101,0.584,8,0.634,7.1,75,22,53,0.293,128,0.586,10,0.636,7.6,2022-23,Regular%20Season
1629022,Lonnie Walker IV,1610612747,LAL,46,21,25,1161.0,14,5,9,0.357,33,0.424,0,0.424,11.9,95,15,80,0.158,143,0.664,7,0.699,10.0,109,20,89,0.183,175,0.623,7,0.649,10.2,2022-23,Regular%20Season
1629663,Louis King,1610612755,PHI,1,1,0,29.0,2,1,1,0.5,2,1.0,0,1.0,13.7,2,0,2,0.0,5,0.4,0,0.4,10.2,4,1,3,0.25,7,0.571,0,0.571,12.0,2022-23,Regular%20Season
1629652,Luguentz Dort,1610612760,OKC,72,35,37,2220.0,128,74,55,0.578,291,0.44,13,0.46,7.5,216,55,161,0.255,377,0.573,31,0.624,7.4,344,129,216,0.375,660,0.521,44,0.558,7.4,2022-23,Regular%20Season
1629029,Luka Doncic,1610612742,DAL,66,33,33,2390.0,54,29,25,0.537,190,0.284,4,0.29,11.6,515,118,396,0.229,751,0.686,48,0.733,5.1,569,147,421,0.258,886,0.642,52,0.682,5.8,2022-23,Regular%20Season
1630568,Luka Garza,1610612750,MIN,20,10,10,219.0,31,27,4,0.871,63,0.492,1,0.5,4.0,29,7,22,0.241,61,0.475,14,0.617,4.5,60,34,26,0.567,119,0.504,15,0.577,4.2,2022-23,Regular%20Season
1629677,Luka Samanic,1610612762,UTA,7,2,5,161.0,0,0,0,0.0,1,0.0,0,0.0,0.0,30,8,22,0.267,48,0.625,7,0.732,5.4,30,8,22,0.267,49,0.612,7,0.714,5.4,2022-23,Regular%20Season
1628379,Luke Kennard,1610612763,MEM,52,32,20,1192.0,15,4,11,0.267,31,0.484,1,0.5,16.0,143,19,124,0.133,235,0.609,13,0.644,7.8,158,23,135,0.146,265,0.596,14,0.629,8.6,2022-23,Regular%20Season
1628436,Luke Kornet,1610612738,BOS,56,39,17,738.0,86,65,21,0.756,163,0.528,2,0.534,4.6,111,49,62,0.441,215,0.516,27,0.59,5.9,197,114,83,0.579,369,0.534,29,0.579,5.3,2022-23,Regular%20Season
1630644,Mac McClung,1610612755,PHI,2,2,0,41.0,3,2,1,0.667,4,0.75,0,0.75,11.5,7,0,7,0.0,8,0.875,0,0.875,5.7,10,2,8,0.2,12,0.833,0,0.833,7.4,2022-23,Regular%20Season
1630201,Malachi Flynn,1610612761,TOR,35,18,17,565.0,15,5,10,0.333,31,0.484,2,0.517,16.0,61,5,56,0.082,92,0.663,10,0.744,9.3,76,10,66,0.132,121,0.628,12,0.697,10.7,2022-23,Regular%20Season
1631103,Malaki Branham,1610612759,SAS,56,14,42,1363.0,28,7,21,0.25,64,0.438,0,0.438,14.0,144,12,132,0.083,243,0.593,26,0.664,7.8,172,19,153,0.11,305,0.564,26,0.616,8.8,2022-23,Regular%20Season
1627763,Malcolm Brogdon,1610612738,BOS,67,46,21,1744.0,42,20,21,0.476,121,0.347,7,0.368,10.4,238,56,182,0.235,395,0.603,40,0.67,7.4,280,76,203,0.271,509,0.55,47,0.606,7.9,2022-23,Regular%20Season
1630792,Malcolm Hill,1610612741,CHI,2,1,1,7.0,0,0,0,0.0,0,0.0,0,0.0,0.0,3,0,3,0.0,5,0.6,1,0.75,14.3,3,0,3,0.0,5,0.6,1,0.75,14.3,2022-23,Regular%20Season
1627736,Malik Beasley,1610612747,LAL,77,44,33,2015.0,35,9,27,0.257,76,0.461,0,0.461,16.7,248,38,210,0.153,391,0.634,36,0.699,7.2,283,47,237,0.166,455,0.622,36,0.675,8.4,2022-23,Regular%20Season
1628370,Malik Monk,1610612758,SAC,73,46,27,1637.0,32,9,23,0.281,83,0.386,6,0.416,15.5,171,24,147,0.14,253,0.676,13,0.713,8.0,203,33,170,0.163,333,0.61,19,0.646,9.2,2022-23,Regular%20Season
1629603,Mamadi Diakite,1610612739,CLE,12,7,5,139.0,8,5,3,0.625,16,0.5,0,0.5,7.3,22,8,14,0.364,44,0.5,4,0.55,4.1,30,13,17,0.433,59,0.508,4,0.545,5.0,2022-23,Regular%20Season
1630699,MarJon Beauchamp,1610612749,MIL,38,23,15,627.0,38,16,22,0.421,74,0.514,3,0.535,9.9,77,11,66,0.143,138,0.558,11,0.606,7.5,115,27,88,0.235,205,0.561,14,0.602,8.3,2022-23,Regular%20Season
202694,Marcus Morris Sr.,1610612746,LAC,61,32,29,1731.0,29,11,18,0.379,86,0.337,2,0.345,11.9,229,50,179,0.218,365,0.627,23,0.67,6.4,258,61,197,0.236,430,0.6,25,0.637,7.1,2022-23,Regular%20Season
203935,Marcus Smart,1610612738,BOS,57,40,17,1845.0,46,16,30,0.348,108,0.426,6,0.451,10.7,145,37,108,0.255,287,0.505,39,0.585,9.8,191,53,138,0.277,386,0.495,45,0.56,10.0,2022-23,Regular%20Season
1631109,Mark Williams,1610612766,CHA,42,18,24,827.0,93,73,20,0.785,187,0.497,4,0.508,5.0,211,72,139,0.341,325,0.649,28,0.71,4.4,304,145,159,0.477,497,0.612,32,0.654,4.6,2022-23,Regular%20Season
1628365,Markelle Fultz,1610612753,ORL,60,29,31,1778.0,69,39,30,0.565,168,0.411,5,0.423,7.1,165,26,139,0.158,302,0.546,31,0.609,7.8,234,65,169,0.278,466,0.502,36,0.544,7.6,2022-23,Regular%20Season
202693,Markieff Morris,1610612742,DAL,25,12,13,290.0,13,5,8,0.385,22,0.591,0,0.591,10.2,58,22,36,0.379,90,0.644,9,0.716,6.4,71,27,44,0.38,106,0.67,9,0.732,7.1,2022-23,Regular%20Season
1630250,Marko Simonovic,1610612741,CHI,2,2,0,12.0,1,0,1,0.0,2,0.5,0,0.5,28.9,1,0,1,0.0,2,0.5,0,0.5,2.3,2,0,2,0.0,4,0.5,0,0.5,15.6,2022-23,Regular%20Season
1628963,Marvin Bagley III,1610612765,DET,42,7,35,990.0,94,65,29,0.691,168,0.56,3,0.57,4.9,175,62,112,0.354,260,0.673,14,0.711,4.3,269,127,141,0.472,414,0.65,17,0.678,4.5,2022-23,Regular%20Season
203486,Mason Plumlee,1610612746,LAC,79,28,51,2053.0,229,163,65,0.712,530,0.432,17,0.446,5.0,471,154,314,0.327,780,0.604,102,0.695,4.2,700,317,379,0.453,1269,0.552,119,0.609,4.4,2022-23,Regular%20Season
1629680,Matisse Thybulle,1610612757,POR,52,28,24,1041.0,40,15,25,0.375,70,0.571,0,0.571,9.6,100,19,81,0.19,159,0.629,9,0.667,8.4,140,34,106,0.243,216,0.648,9,0.676,8.8,2022-23,Regular%20Season
1630346,Matt Ryan,1610612750,MIN,15,4,11,183.0,4,0,4,0.0,6,0.667,0,0.667,16.7,22,5,17,0.227,32,0.688,1,0.71,7.4,26,5,21,0.192,37,0.703,1,0.722,8.8,2022-23,Regular%20Season
203521,Matthew Dellavedova,1610612758,SAC,10,8,2,107.0,1,1,0,1.0,5,0.2,0,0.2,1.5,12,2,10,0.167,17,0.706,3,0.857,10.2,13,3,10,0.231,22,0.591,3,0.684,9.5,2022-23,Regular%20Season
1631108,Max Christie,1610612747,LAL,28,12,16,461.0,7,5,2,0.714,25,0.28,1,0.292,11.2,68,9,59,0.132,101,0.673,4,0.701,6.0,75,14,61,0.187,121,0.62,5,0.647,6.5,2022-23,Regular%20Season
1629622,Max Strus,1610612748,MIA,72,38,34,2096.0,49,24,25,0.49,121,0.405,1,0.408,10.0,209,48,161,0.23,359,0.582,40,0.655,8.0,258,72,186,0.279,462,0.558,41,0.613,8.4,2022-23,Regular%20Season
1628467,Maxi Kleber,1610612742,DAL,36,18,18,906.0,30,19,11,0.633,81,0.37,1,0.375,7.8,105,28,77,0.267,190,0.553,19,0.614,5.6,135,47,88,0.348,260,0.519,20,0.563,6.1,2022-23,Regular%20Season
1630593,McKinley Wright IV,1610612742,DAL,18,9,9,267.0,9,4,5,0.444,19,0.474,0,0.474,11.6,38,5,33,0.132,66,0.576,4,0.613,6.6,47,9,38,0.191,85,0.553,4,0.58,7.6,2022-23,Regular%20Season
203086,Meyers Leonard,1610612749,MIL,8,5,3,108.0,12,8,4,0.667,22,0.545,0,0.545,6.3,22,6,16,0.273,35,0.629,4,0.71,6.5,34,14,20,0.412,55,0.618,4,0.667,6.4,2022-23,Regular%20Season
1629662,Mfiondu Kabengele,1610612738,BOS,4,3,1,36.0,5,2,3,0.4,10,0.5,0,0.5,4.3,5,2,3,0.4,13,0.385,0,0.385,3.8,10,4,6,0.4,22,0.455,0,0.455,4.1,2022-23,Regular%20Season
1630695,Micah Potter,1610612762,UTA,3,1,2,34.0,3,2,1,0.667,6,0.5,0,0.5,4.3,13,2,11,0.154,18,0.722,2,0.813,5.3,16,4,12,0.25,22,0.727,2,0.8,5.1,2022-23,Regular%20Season
203487,Michael Carter-Williams,1610612753,ORL,1,0,1,14.0,1,1,0,1.0,1,1.0,0,1.0,7.1,4,1,3,0.25,5,0.8,1,1.0,8.2,5,2,3,0.4,6,0.833,1,1.0,8.0,2022-23,Regular%20Season
1629008,Michael Porter Jr.,1610612743,DEN,62,41,21,1798.0,64,43,20,0.672,165,0.388,5,0.4,8.6,277,61,215,0.22,430,0.644,41,0.712,5.0,341,104,235,0.305,561,0.608,46,0.662,5.7,2022-23,Regular%20Season
1628969,Mikal Bridges,1610612751,BKN,81,41,40,2927.0,79,35,43,0.443,204,0.387,13,0.414,10.5,285,53,232,0.186,476,0.599,46,0.663,7.9,364,88,275,0.242,655,0.556,59,0.611,8.4,2022-23,Regular%20Season
201144,Mike Conley,1610612750,MIN,61,30,31,1863.0,33,6,27,0.182,81,0.407,4,0.429,16.8,148,26,122,0.176,265,0.558,22,0.609,8.8,181,32,149,0.177,343,0.528,26,0.571,10.2,2022-23,Regular%20Season
203488,Mike Muscala,1610612738,BOS,59,31,28,914.0,37,18,19,0.486,100,0.37,5,0.389,8.7,166,54,112,0.325,291,0.57,27,0.629,5.3,203,72,131,0.355,365,0.556,32,0.61,5.9,2022-23,Regular%20Season
1630540,Miles McBride,1610612752,NYK,31,17,14,511.0,13,3,10,0.231,32,0.406,0,0.406,13.6,37,6,31,0.162,73,0.507,12,0.607,9.9,50,9,41,0.18,105,0.476,12,0.538,10.9,2022-23,Regular%20Season
1629011,Mitchell Robinson,1610612752,NYK,59,35,24,1589.0,267,218,49,0.816,503,0.531,19,0.552,4.2,288,117,170,0.406,436,0.661,29,0.708,5.6,555,335,219,0.604,925,0.6,48,0.633,4.9,2022-23,Regular%20Season
1628964,Mo Bamba,1610612747,LAL,44,24,20,738.0,58,37,21,0.638,143,0.406,5,0.42,5.3,167,55,111,0.329,288,0.58,29,0.645,4.1,225,92,132,0.409,412,0.546,34,0.595,4.4,2022-23,Regular%20Season
1628420,Monte Morris,1610612764,WAS,60,28,32,1635.0,26,10,16,0.385,54,0.481,1,0.491,14.0,184,18,166,0.098,293,0.628,28,0.694,9.0,210,28,182,0.133,342,0.614,29,0.671,9.6,2022-23,Regular%20Season
1626149,Montrezl Harrell,1610612755,PHI,46,30,16,605.0,67,50,17,0.746,141,0.475,2,0.482,5.4,92,31,61,0.337,173,0.532,9,0.561,5.1,159,81,78,0.509,300,0.53,11,0.55,5.2,2022-23,Regular%20Season
1629021,Moritz Wagner,1610612753,ORL,54,25,29,1064.0,69,42,26,0.609,172,0.401,2,0.406,7.1,190,40,150,0.211,325,0.585,40,0.667,5.4,259,82,176,0.317,471,0.55,42,0.604,5.9,2022-23,Regular%20Season
1629650,Moses Brown,1610612751,BKN,28,14,14,270.0,57,42,15,0.737,110,0.518,3,0.533,3.5,82,32,50,0.39,129,0.636,12,0.701,3.7,139,74,65,0.532,229,0.607,15,0.65,3.6,2022-23,Regular%20Season
1630541,Moses Moody,1610612744,GSW,47,24,23,679.0,27,12,15,0.444,61,0.443,1,0.45,9.8,76,19,57,0.25,144,0.528,13,0.58,6.6,103,31,72,0.301,196,0.526,14,0.566,7.5,2022-23,Regular%20Season
1631217,Moussa Diabate,1610612746,LAC,13,5,8,160.0,31,23,8,0.742,73,0.425,3,0.443,5.0,19,5,14,0.263,45,0.422,15,0.633,3.7,50,28,22,0.56,116,0.431,18,0.51,4.5,2022-23,Regular%20Season
1626167,Myles Turner,1610612754,IND,61,29,32,1808.0,88,59,28,0.67,238,0.37,2,0.373,6.3,378,135,243,0.357,703,0.538,85,0.612,4.5,466,194,271,0.416,916,0.509,87,0.562,4.8,2022-23,Regular%20Season
1630230,Naji Marshall,1610612740,NOP,73,38,35,1723.0,48,21,27,0.438,132,0.364,7,0.384,9.2,231,41,190,0.177,375,0.616,41,0.692,6.0,279,62,217,0.222,488,0.572,48,0.634,6.5,2022-23,Regular%20Season
1629642,Nassir Little,1610612757,POR,51,21,30,937.0,27,10,17,0.37,82,0.329,5,0.351,8.9,114,21,93,0.184,224,0.509,29,0.585,5.4,141,31,110,0.22,295,0.478,34,0.54,6.1,2022-23,Regular%20Season
1631466,Nate Williams,1610612757,POR,4,1,3,95.0,8,6,2,0.75,16,0.5,2,0.571,3.8,3,1,2,0.333,8,0.375,0,0.375,4.3,11,7,4,0.636,24,0.458,2,0.5,3.9,2022-23,Regular%20Season
1630233,Nathan Knight,1610612750,MIN,23,11,12,247.0,21,13,8,0.619,53,0.396,0,0.396,5.5,33,5,28,0.152,56,0.589,7,0.673,4.8,54,18,36,0.333,103,0.524,7,0.563,5.1,2022-23,Regular%20Season
1629675,Naz Reid,1610612750,MIN,66,31,35,1228.0,73,48,25,0.658,172,0.424,1,0.427,6.6,260,83,177,0.319,408,0.637,22,0.674,4.9,333,131,202,0.393,548,0.608,23,0.634,5.3,2022-23,Regular%20Season
1629674,Neemias Queta,1610612758,SAC,5,1,4,29.0,5,3,2,0.6,12,0.417,0,0.417,8.0,6,3,3,0.5,9,0.667,1,0.75,5.3,11,6,5,0.545,20,0.55,1,0.579,6.5,2022-23,Regular%20Season
203457,Nerlens Noel,1610612751,BKN,14,2,12,181.0,10,5,5,0.5,24,0.417,0,0.417,5.5,36,11,25,0.306,62,0.581,4,0.621,5.2,46,16,30,0.348,82,0.561,4,0.59,5.3,2022-23,Regular%20Season
1629651,Nic Claxton,1610612751,BKN,76,41,35,2271.0,184,122,62,0.663,440,0.418,6,0.424,5.2,518,132,384,0.255,842,0.615,75,0.675,4.4,702,254,446,0.362,1229,0.571,81,0.611,4.6,2022-23,Regular%20Season
1630208,Nick Richards,1610612766,CHA,62,20,42,1201.0,147,102,41,0.694,359,0.409,10,0.421,3.9,269,84,182,0.312,476,0.565,50,0.631,3.8,416,186,223,0.447,818,0.509,60,0.549,3.8,2022-23,Regular%20Season
1629638,Nickeil Alexander-Walker,1610612750,MIN,43,21,22,746.0,14,4,10,0.286,41,0.341,0,0.341,12.0,86,17,69,0.198,151,0.57,13,0.623,7.5,100,21,79,0.21,188,0.532,13,0.571,8.1,2022-23,Regular%20Season
201587,Nicolas Batum,1610612746,LAC,75,43,32,1646.0,62,29,33,0.468,133,0.466,10,0.504,11.5,237,68,168,0.287,371,0.639,33,0.701,5.8,299,97,201,0.324,474,0.631,43,0.694,7.0,2022-23,Regular%20Season
203999,Nikola Jokic,1610612743,DEN,69,48,21,2323.0,167,132,35,0.79,330,0.506,8,0.519,4.5,650,247,403,0.38,983,0.661,81,0.721,4.1,817,379,438,0.464,1275,0.641,89,0.689,4.2,2022-23,Regular%20Season
1631107,Nikola Jovic,1610612748,MIA,10,5,5,193.0,9,7,2,0.778,20,0.45,0,0.45,5.1,22,7,15,0.318,46,0.478,10,0.611,5.6,31,14,17,0.452,64,0.484,10,0.574,5.5,2022-23,Regular%20Season
202696,Nikola Vucevic,1610612741,CHI,81,39,42,2711.0,155,114,38,0.735,361,0.429,8,0.439,5.7,733,209,523,0.285,1082,0.677,74,0.727,4.3,888,323,561,0.364,1373,0.647,82,0.688,4.5,2022-23,Regular%20Season
203943,Noah Vonleh,1610612738,BOS,17,12,5,158.0,18,14,4,0.778,38,0.474,1,0.486,6.9,30,8,22,0.267,57,0.526,5,0.577,4.8,48,22,26,0.458,95,0.505,6,0.539,5.6,2022-23,Regular%20Season
1626181,Norman Powell,1610612746,LAC,56,30,26,1465.0,24,5,19,0.208,78,0.308,2,0.316,14.2,151,28,123,0.185,253,0.597,25,0.662,7.9,175,33,142,0.189,320,0.547,27,0.597,8.7,2022-23,Regular%20Season
1628384,OG Anunoby,1610612761,TOR,66,33,33,2376.0,95,58,37,0.611,240,0.396,11,0.415,7.5,237,58,179,0.245,425,0.558,45,0.624,7.1,332,116,216,0.349,636,0.522,56,0.572,7.2,2022-23,Regular%20Season
1630167,Obi Toppin,1610612752,NYK,61,34,27,987.0,29,14,15,0.483,80,0.363,2,0.372,6.9,158,29,128,0.184,232,0.681,14,0.725,5.1,187,43,143,0.23,288,0.649,16,0.688,5.4,2022-23,Regular%20Season
1630534,Ochai Agbaji,1610612762,UTA,49,22,27,1168.0,43,19,24,0.442,96,0.448,3,0.462,11.5,78,20,59,0.256,154,0.506,8,0.534,9.0,121,39,83,0.322,246,0.492,11,0.515,9.9,2022-23,Regular%20Season
1630846,Olivier Sarr,1610612760,OKC,7,3,4,104.0,12,11,1,0.917,32,0.375,1,0.387,3.2,19,7,12,0.368,35,0.543,4,0.613,4.2,31,18,13,0.581,66,0.47,5,0.508,3.9,2022-23,Regular%20Season
1630209,Omer Yurtseven,1610612748,MIA,8,4,4,76.0,8,4,4,0.5,31,0.258,1,0.267,5.5,15,1,14,0.067,36,0.417,5,0.484,4.0,23,5,18,0.217,64,0.359,6,0.397,4.5,2022-23,Regular%20Season
1630168,Onyeka Okongwu,1610612737,ATL,80,41,39,1849.0,217,157,59,0.724,433,0.501,13,0.517,5.2,359,116,243,0.323,579,0.62,43,0.67,5.3,576,273,302,0.474,1000,0.576,56,0.61,5.3,2022-23,Regular%20Season
1631115,Orlando Robinson,1610612748,MIA,30,18,12,422.0,48,34,14,0.708,133,0.361,5,0.375,4.5,78,21,57,0.269,150,0.52,21,0.605,4.2,126,55,71,0.437,276,0.457,26,0.504,4.3,2022-23,Regular%20Season
1629052,Oshae Brissett,1610612754,IND,58,25,33,1005.0,62,31,31,0.5,163,0.38,4,0.39,6.7,156,42,114,0.269,267,0.584,32,0.664,5.4,218,73,145,0.335,402,0.542,36,0.596,5.8,2022-23,Regular%20Season
203490,Otto Porter Jr.,1610612761,TOR,6,4,2,109.0,6,4,2,0.667,13,0.462,0,0.462,10.3,13,2,11,0.154,18,0.722,2,0.813,4.7,19,6,13,0.316,31,0.613,2,0.655,6.4,2022-23,Regular%20Season
1631172,Ousmane Dieng,1610612760,OKC,34,18,16,529.0,19,8,11,0.421,56,0.339,5,0.373,14.8,86,18,68,0.209,145,0.593,12,0.647,6.0,105,26,79,0.248,191,0.55,17,0.603,7.6,2022-23,Regular%20Season
200782,P.J. Tucker,1610612755,PHI,71,46,25,1843.0,95,55,40,0.579,240,0.396,11,0.415,7.6,200,39,160,0.195,361,0.554,43,0.629,7.0,295,94,200,0.319,582,0.507,54,0.559,7.2,2022-23,Regular%20Season
1629023,P.J. Washington,1610612766,CHA,73,24,49,2380.0,73,34,39,0.466,199,0.367,8,0.382,9.9,285,63,218,0.221,478,0.596,37,0.646,6.3,358,97,257,0.271,647,0.553,45,0.595,7.0,2022-23,Regular%20Season
1628408,PJ Dozier,1610612758,SAC,9,5,4,74.0,1,0,1,0.0,5,0.2,0,0.2,16.3,13,4,9,0.308,22,0.591,3,0.684,5.2,14,4,10,0.286,25,0.56,3,0.636,6.0,2022-23,Regular%20Season
1631094,Paolo Banchero,1610612753,ORL,72,31,41,2430.0,84,43,42,0.512,239,0.351,4,0.357,10.8,413,101,312,0.245,612,0.675,50,0.735,5.5,497,144,354,0.29,820,0.606,54,0.649,6.4,2022-23,Regular%20Season
1627783,Pascal Siakam,1610612761,TOR,71,35,36,2652.0,131,77,54,0.588,296,0.443,8,0.455,7.1,425,85,338,0.2,628,0.677,48,0.733,5.9,556,162,392,0.291,884,0.629,56,0.671,6.2,2022-23,Regular%20Season
1626192,Pat Connaughton,1610612749,MIL,59,41,18,1421.0,50,17,33,0.34,115,0.435,6,0.459,10.7,233,42,191,0.18,368,0.633,45,0.721,5.5,283,59,224,0.208,469,0.603,51,0.677,6.4,2022-23,Regular%20Season
1631116,Patrick Baldwin Jr.,1610612744,GSW,19,11,8,187.0,1,0,1,0.0,9,0.111,0,0.111,1.8,39,11,28,0.282,50,0.78,3,0.83,5.7,40,11,29,0.275,57,0.702,3,0.741,5.6,2022-23,Regular%20Season
201976,Patrick Beverley,1610612741,CHI,66,34,32,1787.0,44,16,28,0.364,94,0.468,2,0.478,12.1,203,31,171,0.153,347,0.585,32,0.644,7.4,247,47,199,0.19,431,0.573,34,0.622,8.2,2022-23,Regular%20Season
1630172,Patrick Williams,1610612741,CHI,78,36,42,2230.0,77,46,31,0.597,193,0.399,6,0.412,7.0,244,59,183,0.242,422,0.578,45,0.647,5.6,321,105,214,0.327,600,0.535,51,0.585,5.9,2022-23,Regular%20Season
201988,Patty Mills,1610612751,BKN,26,11,15,419.0,8,0,8,0.0,18,0.444,2,0.5,20.4,36,0,36,0.0,59,0.61,2,0.632,12.6,44,0,44,0.0,76,0.579,4,0.611,14.0,2022-23,Regular%20Season
202331,Paul George,1610612746,LAC,56,32,24,1939.0,45,16,29,0.356,114,0.395,2,0.402,10.3,297,48,249,0.162,484,0.614,41,0.67,6.6,342,64,278,0.187,576,0.594,43,0.642,7.1,2022-23,Regular%20Season
1630194,Paul Reed,1610612755,PHI,59,39,20,720.0,112,81,31,0.723,217,0.516,10,0.541,4.8,150,51,99,0.34,238,0.63,19,0.685,5.3,262,132,130,0.504,451,0.581,29,0.621,5.1,2022-23,Regular%20Season
1630202,Payton Pritchard,1610612738,BOS,31,20,11,516.0,25,10,15,0.4,50,0.5,3,0.532,7.2,63,12,51,0.19,103,0.612,11,0.685,7.2,88,22,66,0.25,153,0.575,14,0.633,7.2,2022-23,Regular%20Season
1631212,Peyton Watson,1610612743,DEN,11,4,7,157.0,8,1,7,0.125,24,0.333,0,0.333,13.0,29,7,22,0.241,54,0.537,6,0.604,4.6,37,8,29,0.216,73,0.507,6,0.552,6.4,2022-23,Regular%20Season
1630173,Precious Achiuwa,1610612761,TOR,54,30,24,1128.0,100,65,35,0.65,217,0.461,7,0.476,6.1,228,67,161,0.294,345,0.661,24,0.71,5.0,328,132,196,0.402,540,0.607,31,0.644,5.4,2022-23,Regular%20Season
1629656,Quentin Grimes,1610612752,NYK,64,38,26,2019.0,49,19,30,0.388,96,0.51,4,0.533,12.4,180,44,135,0.244,292,0.616,24,0.672,7.1,229,63,165,0.275,385,0.595,28,0.641,8.2,2022-23,Regular%20Season
1631245,Quenton Jackson,1610612764,WAS,6,2,4,126.0,2,0,2,0.0,5,0.4,0,0.4,18.2,6,2,4,0.333,16,0.375,4,0.5,10.7,8,2,6,0.25,21,0.381,4,0.471,12.5,2022-23,Regular%20Season
1630181,R.J. Hampton,1610612765,DET,31,5,26,609.0,18,9,9,0.5,37,0.486,2,0.514,12.0,69,13,56,0.188,104,0.663,6,0.704,8.2,87,22,65,0.253,138,0.63,8,0.669,8.9,2022-23,Regular%20Season
1629628,RJ Barrett,1610612752,NYK,72,40,32,2474.0,60,27,33,0.45,203,0.296,9,0.309,12.2,308,37,271,0.12,515,0.598,48,0.66,6.4,368,64,304,0.174,676,0.544,57,0.595,7.4,2022-23,Regular%20Season
1630564,RaiQuan Gray,1610612751,BKN,1,0,1,35.0,3,2,1,0.667,4,0.75,0,0.75,4.5,6,0,6,0.0,8,0.75,0,0.75,6.7,9,2,7,0.222,11,0.818,0,0.818,6.0,2022-23,Regular%20Season
203526,Raul Neto,1610612739,CLE,27,16,11,332.0,10,1,9,0.1,16,0.625,0,0.625,17.3,36,7,29,0.194,55,0.655,2,0.679,11.0,46,8,38,0.174,71,0.648,2,0.667,12.4,2022-23,Regular%20Season
203493,Reggie Bullock Jr.,1610612742,DAL,76,35,41,2322.0,32,8,24,0.25,74,0.432,3,0.451,17.5,251,51,200,0.203,406,0.618,37,0.68,7.6,283,59,224,0.208,471,0.601,40,0.657,8.8,2022-23,Regular%20Season
202704,Reggie Jackson,1610612743,DEN,58,29,29,1454.0,25,12,12,0.48,54,0.463,3,0.49,12.5,119,13,106,0.109,214,0.556,23,0.623,9.3,144,25,118,0.174,267,0.539,26,0.598,9.8,2022-23,Regular%20Season
1626158,Richaun Holmes,1610612758,SAC,27,11,16,284.0,29,20,9,0.69,65,0.446,2,0.46,5.6,50,17,33,0.34,91,0.549,11,0.625,5.4,79,37,42,0.468,153,0.516,13,0.564,5.5,2022-23,Regular%20Season
201937,Ricky Rubio,1610612739,CLE,27,19,8,474.0,9,0,9,0.0,25,0.36,1,0.375,21.4,61,11,50,0.18,93,0.656,2,0.67,7.5,70,11,59,0.157,116,0.603,3,0.619,9.3,2022-23,Regular%20Season
203496,Robert Covington,1610612746,LAC,45,18,27,760.0,31,17,15,0.548,82,0.378,4,0.397,9.3,135,38,96,0.281,222,0.608,18,0.662,5.3,166,55,111,0.331,287,0.578,22,0.626,6.1,2022-23,Regular%20Season
1629057,Robert Williams III,1610612738,BOS,35,24,11,824.0,104,67,36,0.644,189,0.55,4,0.562,5.3,188,79,109,0.42,278,0.676,19,0.726,5.6,292,146,145,0.5,452,0.646,23,0.681,5.5,2022-23,Regular%20Season
201577,Robin Lopez,1610612739,CLE,23,15,8,249.0,23,19,4,0.826,58,0.397,5,0.434,3.9,28,13,15,0.464,49,0.571,5,0.636,6.2,51,32,19,0.627,105,0.486,10,0.537,5.2,2022-23,Regular%20Season
203585,Rodney McGruder,1610612765,DET,26,3,23,479.0,20,9,11,0.45,61,0.328,1,0.333,9.7,54,8,46,0.148,86,0.628,8,0.692,7.4,74,17,57,0.23,136,0.544,9,0.583,8.0,2022-23,Regular%20Season
1629641,Romeo Langford,1610612759,SAS,33,11,22,724.0,55,42,13,0.764,92,0.598,4,0.625,7.2,55,22,33,0.4,106,0.519,12,0.585,6.4,110,64,46,0.582,193,0.57,16,0.621,6.8,2022-23,Regular%20Season
1631199,Ron Harper Jr.,1610612761,TOR,4,3,1,30.0,3,0,3,0.0,4,0.75,0,0.75,16.6,4,0,4,0.0,6,0.667,0,0.667,10.6,7,0,7,0.0,10,0.7,0,0.7,13.2,2022-23,Regular%20Season
1626220,Royce O'Neale,1610612751,BKN,74,41,33,2345.0,55,28,26,0.509,135,0.407,11,0.444,8.3,329,69,258,0.21,615,0.535,54,0.586,6.1,384,97,284,0.253,719,0.534,65,0.587,6.5,2022-23,Regular%20Season
200752,Rudy Gay,1610612762,UTA,51,26,25,744.0,33,20,13,0.606,84,0.393,5,0.418,8.2,130,30,99,0.231,193,0.674,11,0.714,6.3,163,50,112,0.307,266,0.613,16,0.652,6.7,2022-23,Regular%20Season
203497,Rudy Gobert,1610612750,MIN,69,33,36,2120.0,229,158,71,0.69,508,0.451,7,0.457,5.3,572,156,416,0.273,920,0.622,68,0.671,3.8,801,314,487,0.392,1381,0.58,75,0.613,4.3,2022-23,Regular%20Season
1629060,Rui Hachimura,1610612747,LAL,61,38,23,1430.0,53,25,27,0.472,141,0.376,7,0.396,8.0,230,58,172,0.252,356,0.646,32,0.71,5.8,283,83,199,0.293,470,0.602,39,0.657,6.2,2022-23,Regular%20Season
201566,Russell Westbrook,1610612746,LAC,72,36,36,2098.0,89,53,37,0.596,230,0.387,14,0.412,7.1,334,60,273,0.18,491,0.68,35,0.732,6.4,423,113,310,0.267,693,0.61,49,0.657,6.6,2022-23,Regular%20Season
1627853,Ryan Arcidiacono,1610612757,POR,6,1,5,100.0,0,0,0,0.0,6,0.0,1,0.0,0.0,15,2,13,0.133,22,0.682,1,0.714,7.1,15,2,13,0.133,28,0.536,2,0.577,7.1,2022-23,Regular%20Season
1631157,Ryan Rollins,1610612744,GSW,7,3,4,41.0,3,3,0,1.0,8,0.375,0,0.375,2.7,9,1,8,0.111,11,0.818,0,0.818,7.9,12,4,8,0.333,17,0.706,0,0.706,6.6,2022-23,Regular%20Season
1630240,Saben Lee,1610612756,PHX,18,10,8,329.0,13,9,4,0.692,30,0.433,1,0.448,8.5,32,4,28,0.125,56,0.571,4,0.615,7.7,45,13,32,0.289,86,0.523,5,0.556,7.9,2022-23,Regular%20Season
1630180,Saddiq Bey,1610612737,ATL,74,22,52,2057.0,95,36,58,0.379,200,0.475,4,0.485,9.7,258,38,218,0.147,389,0.663,31,0.721,7.7,353,74,276,0.21,567,0.623,35,0.664,8.2,2022-23,Regular%20Season
1630573,Sam Hauser,1610612738,BOS,69,48,21,1202.0,35,15,20,0.429,78,0.449,4,0.473,9.0,169,32,137,0.189,284,0.595,33,0.673,6.3,204,47,157,0.23,352,0.58,37,0.648,6.8,2022-23,Regular%20Season
1630241,Sam Merrill,1610612739,CLE,3,2,1,50.0,0,0,0,0.0,1,0.0,0,0.0,0.0,9,3,6,0.333,13,0.692,0,0.692,7.6,9,3,6,0.333,13,0.692,0,0.692,7.6,2022-23,Regular%20Season
1630572,Sandro Mamukelashvili,1610612759,SAS,33,18,15,581.0,63,42,21,0.667,118,0.534,1,0.538,6.0,109,29,80,0.266,178,0.612,16,0.673,4.6,172,71,101,0.413,286,0.601,17,0.639,5.1,2022-23,Regular%20Season
1630583,Santi Aldama,1610612763,MEM,73,47,26,1618.0,85,41,44,0.482,175,0.486,6,0.503,7.7,286,50,233,0.175,447,0.64,43,0.708,5.4,371,91,277,0.245,596,0.622,49,0.678,5.9,2022-23,Regular%20Season
1630567,Scottie Barnes,1610612761,TOR,77,38,39,2678.0,179,110,69,0.615,322,0.556,10,0.574,6.7,333,83,250,0.249,565,0.589,51,0.648,6.0,512,193,319,0.377,867,0.591,61,0.635,6.3,2022-23,Regular%20Season
1630590,Scotty Pippen Jr.,1610612747,LAL,2,0,2,21.0,2,1,1,0.5,3,0.667,0,0.667,17.1,2,0,2,0.0,4,0.5,0,0.5,12.2,4,1,3,0.25,7,0.571,0,0.571,14.6,2022-23,Regular%20Season
201586,Serge Ibaka,1610612749,MIL,13,9,4,164.0,15,12,3,0.8,37,0.405,1,0.417,4.9,29,10,19,0.345,44,0.659,2,0.69,3.7,44,22,22,0.5,78,0.564,3,0.587,4.1,2022-23,Regular%20Season
203552,Seth Curry,1610612751,BKN,43,28,15,978.0,13,1,12,0.077,29,0.448,3,0.5,17.5,87,7,80,0.08,144,0.604,7,0.635,9.6,100,8,92,0.08,173,0.578,10,0.613,10.6,2022-23,Regular%20Season
1631101,Shaedon Sharpe,1610612757,POR,77,31,46,1736.0,63,24,39,0.381,133,0.474,4,0.488,10.7,173,28,145,0.162,309,0.56,35,0.631,6.6,236,52,184,0.22,439,0.538,39,0.59,7.7,2022-23,Regular%20Season
1628983,Shai Gilgeous-Alexander,1610612760,OKC,67,33,34,2387.0,59,31,28,0.525,182,0.324,5,0.333,10.5,270,60,209,0.222,437,0.618,38,0.677,8.3,329,91,237,0.277,604,0.545,43,0.586,8.7,2022-23,Regular%20Season
1629003,Shake Milton,1610612755,PHI,66,46,20,1445.0,39,17,22,0.436,90,0.433,2,0.443,11.2,152,27,125,0.178,243,0.626,18,0.676,8.2,191,44,147,0.23,325,0.588,20,0.626,8.8,2022-23,Regular%20Season
1627885,Shaquille Harrison,1610612747,LAL,4,1,3,96.0,0,0,0,0.0,4,0.0,0,0.0,0.0,18,5,13,0.278,20,0.9,1,0.947,6.5,18,5,13,0.278,24,0.75,1,0.783,6.5,2022-23,Regular%20Season
1631323,Simone Fontecchio,1610612762,UTA,38,19,19,656.0,31,14,17,0.452,64,0.484,2,0.5,10.6,55,13,42,0.236,104,0.529,15,0.618,8.1,86,27,59,0.314,165,0.521,17,0.581,9.0,2022-23,Regular%20Season
1630219,Skylar Mays,1610612757,POR,4,1,3,137.0,2,0,2,0.0,8,0.25,0,0.25,27.9,15,1,14,0.067,23,0.652,1,0.682,5.7,17,1,16,0.059,31,0.548,1,0.567,8.3,2022-23,Regular%20Season
203915,Spencer Dinwiddie,1610612751,BKN,75,39,36,2603.0,28,15,13,0.536,101,0.277,6,0.295,11.7,242,31,211,0.128,393,0.616,29,0.665,8.8,270,46,224,0.17,489,0.552,35,0.595,9.1,2022-23,Regular%20Season
1626169,Stanley Johnson,1610612759,SAS,27,5,22,448.0,22,4,18,0.182,54,0.407,2,0.423,10.3,72,17,55,0.236,122,0.59,7,0.626,5.4,94,21,73,0.223,166,0.566,9,0.599,6.5,2022-23,Regular%20Season
201939,Stephen Curry,1610612744,GSW,55,29,26,1918.0,39,17,22,0.436,95,0.411,3,0.424,12.9,298,55,243,0.185,491,0.607,42,0.664,7.6,337,72,265,0.214,582,0.579,45,0.628,8.2,2022-23,Regular%20Season
1628425,Sterling Brown,1610612747,LAL,2,1,1,21.0,3,1,2,0.333,4,0.75,0,0.75,4.6,5,0,5,0.0,6,0.833,1,1.0,8.0,8,1,7,0.125,10,0.8,1,0.889,6.7,2022-23,Regular%20Season
203500,Steven Adams,1610612763,MEM,42,28,14,1133.0,214,154,59,0.72,410,0.522,3,0.526,4.2,271,97,173,0.358,433,0.626,27,0.667,4.3,485,251,232,0.518,823,0.589,30,0.612,4.2,2022-23,Regular%20Season
1629004,Svi Mykhailiuk,1610612766,CHA,21,11,10,407.0,15,5,10,0.333,29,0.517,0,0.517,11.8,38,11,27,0.289,57,0.667,7,0.76,7.1,53,16,37,0.302,84,0.631,7,0.688,8.4,2022-23,Regular%20Season
204456,T.J. McConnell,1610612754,IND,70,28,42,1444.0,45,13,32,0.289,101,0.446,2,0.455,13.8,189,17,172,0.09,307,0.616,24,0.668,9.4,234,30,204,0.128,395,0.592,26,0.634,10.2,2022-23,Regular%20Season
203933,T.J. Warren,1610612756,PHX,40,25,15,673.0,26,17,9,0.654,66,0.394,3,0.413,5.7,95,30,65,0.316,152,0.625,13,0.683,6.2,121,47,74,0.388,206,0.587,16,0.637,6.1,2022-23,Regular%20Season
201959,Taj Gibson,1610612764,WAS,35,18,17,416.0,32,24,8,0.75,54,0.593,0,0.593,5.2,61,25,36,0.41,105,0.581,10,0.642,5.8,93,49,44,0.527,156,0.596,10,0.637,5.6,2022-23,Regular%20Season
1629659,Talen Horton-Tucker,1610612762,UTA,58,25,33,1256.0,41,24,17,0.585,103,0.398,2,0.406,8.2,169,37,132,0.219,290,0.583,22,0.631,7.2,210,61,149,0.29,384,0.547,24,0.583,7.4,2022-23,Regular%20Season
1631106,Tari Eason,1610612745,HOU,82,22,60,1767.0,195,121,74,0.621,394,0.495,14,0.513,6.2,301,81,220,0.269,441,0.683,30,0.732,6.5,496,202,294,0.407,810,0.612,44,0.648,6.4,2022-23,Regular%20Season
1627752,Taurean Prince,1610612750,MIN,47,27,20,1051.0,14,3,11,0.214,48,0.292,0,0.292,14.0,114,25,89,0.219,192,0.594,18,0.655,7.5,128,28,100,0.219,229,0.559,18,0.607,8.2,2022-23,Regular%20Season
1629611,Terance Mann,1610612746,LAC,77,43,34,1802.0,77,45,32,0.584,163,0.472,3,0.481,7.5,199,44,155,0.221,348,0.572,35,0.636,6.1,276,89,187,0.322,500,0.552,38,0.597,6.5,2022-23,Regular%20Season
1629056,Terence Davis,1610612758,SAC,46,25,21,713.0,20,8,12,0.4,53,0.377,4,0.408,8.6,119,12,107,0.101,179,0.665,17,0.735,6.9,139,20,119,0.144,221,0.629,21,0.695,7.1,2022-23,Regular%20Season
203082,Terrence Ross,1610612756,PHX,57,25,32,1244.0,22,4,18,0.182,36,0.611,2,0.647,20.6,132,17,115,0.129,184,0.717,11,0.763,8.4,154,21,133,0.136,218,0.706,13,0.751,10.2,2022-23,Regular%20Season
1626179,Terry Rozier,1610612766,CHA,61,18,43,2154.0,51,20,29,0.392,142,0.359,2,0.364,10.8,208,25,182,0.12,332,0.627,21,0.669,9.1,259,45,211,0.174,472,0.549,23,0.577,9.4,2022-23,Regular%20Season
1630678,Terry Taylor,1610612741,CHI,18,6,12,226.0,27,14,12,0.519,58,0.466,4,0.5,6.1,20,3,17,0.15,45,0.444,3,0.476,7.6,47,17,29,0.362,99,0.475,7,0.511,6.8,2022-23,Regular%20Season
201152,Thaddeus Young,1610612761,TOR,45,20,25,737.0,71,53,18,0.746,150,0.473,4,0.486,6.1,95,19,76,0.2,158,0.601,15,0.664,5.8,166,72,94,0.434,304,0.546,19,0.582,5.9,2022-23,Regular%20Season
203648,Thanasis Antetokounmpo,1610612749,MIL,19,12,7,165.0,15,8,7,0.533,31,0.484,0,0.484,6.1,29,12,16,0.414,34,0.853,1,0.879,6.6,44,20,23,0.455,63,0.698,1,0.71,6.4,2022-23,Regular%20Season
1630177,Theo Maledon,1610612766,CHA,38,11,27,757.0,14,3,11,0.214,34,0.412,2,0.438,13.3,109,17,91,0.156,178,0.612,12,0.657,7.9,123,20,102,0.163,211,0.583,14,0.624,8.5,2022-23,Regular%20Season
1629033,Theo Pinson,1610612742,DAL,27,15,12,290.0,10,6,5,0.6,32,0.313,3,0.345,10.1,53,11,42,0.208,86,0.616,10,0.697,6.9,63,17,47,0.27,113,0.558,13,0.63,7.5,2022-23,Regular%20Season
1628418,Thomas Bryant,1610612743,DEN,55,30,25,1059.0,86,57,28,0.663,197,0.437,8,0.455,5.4,253,96,156,0.379,392,0.645,35,0.709,4.6,339,153,184,0.451,580,0.584,43,0.631,4.8,2022-23,Regular%20Season
203501,Tim Hardaway Jr.,1610612742,DAL,70,37,33,2131.0,21,7,14,0.333,77,0.273,2,0.28,15.8,230,46,185,0.2,401,0.574,35,0.628,6.4,251,53,199,0.211,461,0.544,37,0.592,7.2,2022-23,Regular%20Season
202699,Tobias Harris,1610612755,PHI,73,47,26,2398.0,67,36,32,0.537,170,0.394,11,0.421,9.6,357,70,286,0.196,534,0.669,37,0.718,6.3,424,106,318,0.25,686,0.618,48,0.665,6.8,2022-23,Regular%20Season
1628396,Tony Bradley,1610612741,CHI,8,2,6,23.0,1,0,1,0.0,1,1.0,0,1.0,5.5,10,2,8,0.2,12,0.833,1,0.909,4.6,11,2,9,0.182,12,0.917,1,1.0,4.7,2022-23,Regular%20Season
1628470,Torrey Craig,1610612756,PHX,78,43,35,1935.0,145,90,54,0.621,331,0.438,14,0.457,7.0,281,49,231,0.174,445,0.631,30,0.677,5.9,426,139,285,0.326,737,0.578,44,0.615,6.2,2022-23,Regular%20Season
1629027,Trae Young,1610612737,ATL,67,36,31,2332.0,56,14,42,0.25,160,0.35,8,0.368,14.0,161,9,152,0.056,253,0.636,21,0.694,11.5,217,23,194,0.106,412,0.527,29,0.567,12.2,2022-23,Regular%20Season
1630200,Tre Jones,1610612759,SAS,62,19,43,1827.0,52,9,42,0.173,136,0.382,4,0.394,13.3,178,22,156,0.124,294,0.605,34,0.685,8.6,230,31,198,0.135,423,0.544,38,0.597,9.6,2022-23,Regular%20Season
1630544,Tre Mann,1610612760,OKC,55,25,30,1087.0,27,9,18,0.333,58,0.466,2,0.482,12.6,128,18,109,0.141,220,0.582,19,0.637,6.8,155,27,127,0.174,275,0.564,21,0.61,7.8,2022-23,Regular%20Season
1630570,Trendon Watford,1610612757,POR,57,24,33,1141.0,41,23,16,0.561,118,0.347,3,0.357,7.6,191,50,141,0.262,307,0.622,25,0.677,5.3,232,73,157,0.315,397,0.584,28,0.629,5.7,2022-23,Regular%20Season
1630235,Trent Forrest,1610612737,ATL,15,5,10,238.0,5,1,4,0.2,12,0.417,0,0.417,6.8,32,2,30,0.063,46,0.696,2,0.727,7.4,37,3,34,0.081,57,0.649,2,0.673,7.3,2022-23,Regular%20Season
1630243,Trevelin Queen,1610612754,IND,7,2,5,70.0,8,6,2,0.75,14,0.571,0,0.571,8.4,9,3,6,0.333,11,0.818,1,0.9,5.4,17,9,8,0.529,25,0.68,1,0.708,6.8,2022-23,Regular%20Season
1631211,Trevor Keels,1610612752,NYK,2,2,0,4.0,0,0,0,0.0,0,0.0,0,0.0,0.0,2,0,2,0.0,2,1.0,0,1.0,10.7,2,0,2,0.0,2,1.0,0,1.0,10.7,2022-23,Regular%20Season
1626168,Trey Lyles,1610612758,SAC,69,39,30,1201.0,68,52,16,0.765,192,0.354,8,0.37,5.0,232,56,176,0.241,367,0.632,32,0.693,5.2,300,108,192,0.36,539,0.557,40,0.601,5.2,2022-23,Regular%20Season
1630530,Trey Murphy III,1610612740,NOP,75,38,37,2357.0,59,23,36,0.39,164,0.36,8,0.378,9.8,222,57,165,0.257,354,0.627,25,0.675,7.2,281,80,201,0.285,491,0.572,33,0.614,7.7,2022-23,Regular%20Season
1628972,Troy Brown Jr.,1610612747,LAL,72,39,33,1810.0,62,25,36,0.403,146,0.425,6,0.443,11.4,246,47,197,0.191,408,0.603,51,0.689,6.3,308,72,233,0.234,523,0.589,57,0.661,7.3,2022-23,Regular%20Season
1629660,Ty Jerome,1610612744,GSW,34,16,18,676.0,7,2,5,0.286,24,0.292,1,0.304,13.7,71,9,62,0.127,120,0.592,11,0.651,8.6,78,11,67,0.141,142,0.549,12,0.6,9.0,2022-23,Regular%20Season
1631102,TyTy Washington Jr.,1610612745,HOU,21,5,16,352.0,2,2,0,1.0,8,0.25,0,0.25,4.8,43,3,40,0.07,68,0.632,2,0.652,9.4,45,5,40,0.111,76,0.592,2,0.608,9.2,2022-23,Regular%20Season
1628416,Tyler Dorsey,1610612742,DAL,1,1,0,4.0,1,0,1,0.0,1,1.0,0,1.0,14.9,1,0,1,0.0,1,1.0,0,1.0,4.3,2,0,2,0.0,2,1.0,0,1.0,9.6,2022-23,Regular%20Season
1629639,Tyler Herro,1610612748,MIA,67,37,30,2335.0,27,9,19,0.333,113,0.239,3,0.245,13.8,333,41,292,0.123,507,0.657,41,0.715,7.3,360,50,311,0.139,593,0.607,44,0.656,7.8,2022-23,Regular%20Season
1630169,Tyrese Haliburton,1610612754,IND,55,28,27,1848.0,33,11,22,0.333,94,0.351,1,0.355,14.1,172,12,160,0.07,261,0.659,14,0.696,10.0,205,23,182,0.112,351,0.584,15,0.61,10.6,2022-23,Regular%20Season
1631213,Tyrese Martin,1610612737,ATL,5,2,3,29.0,5,2,3,0.4,7,0.714,0,0.714,11.8,7,2,5,0.286,8,0.875,1,1.0,6.4,12,4,8,0.333,15,0.8,1,0.857,8.6,2022-23,Regular%20Season
1630178,Tyrese Maxey,1610612755,PHI,56,35,21,1877.0,23,7,16,0.304,70,0.329,5,0.354,13.3,153,13,140,0.085,249,0.614,21,0.671,8.8,176,20,156,0.114,317,0.555,26,0.605,9.4,2022-23,Regular%20Season
1626145,Tyus Jones,1610612763,MEM,71,44,27,1775.0,28,5,23,0.179,63,0.444,1,0.452,18.2,172,10,162,0.058,268,0.642,14,0.677,8.2,200,15,185,0.075,317,0.631,15,0.662,9.6,2022-23,Regular%20Season
1628962,Udoka Azubuike,1610612762,UTA,31,13,18,347.0,31,25,6,0.806,66,0.47,3,0.492,4.3,88,14,74,0.159,133,0.662,14,0.739,4.7,119,39,80,0.328,190,0.626,17,0.688,4.6,2022-23,Regular%20Season
2617,Udonis Haslem,1610612748,MIA,7,4,3,72.0,4,2,2,0.5,15,0.267,0,0.267,11.2,7,1,6,0.143,20,0.35,1,0.368,4.3,11,3,8,0.273,34,0.324,1,0.333,6.8,2022-23,Regular%20Season
1630586,Usman Garuba,1610612745,HOU,70,19,51,953.0,120,81,39,0.675,274,0.438,12,0.458,4.9,187,62,125,0.332,322,0.581,35,0.652,4.9,307,143,164,0.466,579,0.53,47,0.577,4.9,2022-23,Regular%20Season
1630176,Vernon Carey Jr.,1610612762,UTA,6,5,1,20.0,3,3,0,1.0,5,0.6,0,0.6,1.4,8,4,4,0.5,9,0.889,1,1.0,5.6,11,7,4,0.636,14,0.786,1,0.846,4.5,2022-23,Regular%20Season
203506,Victor Oladipo,1610612748,MIA,38,22,16,1007.0,16,3,13,0.188,40,0.4,1,0.41,16.7,112,19,93,0.17,204,0.549,16,0.596,7.6,128,22,106,0.172,244,0.525,17,0.564,8.7,2022-23,Regular%20Season
1631246,Vince Williams Jr.,1610612763,MEM,4,1,3,71.0,4,1,3,0.25,11,0.364,1,0.4,12.1,11,2,9,0.182,16,0.688,0,0.688,6.9,15,3,12,0.2,27,0.556,1,0.577,8.3,2022-23,Regular%20Season
1630249,Vit Krejci,1610612737,ATL,16,8,8,130.0,6,4,3,0.667,11,0.545,0,0.545,9.5,20,2,18,0.1,26,0.769,4,0.909,7.1,26,6,21,0.231,36,0.722,4,0.813,7.7,2022-23,Regular%20Season
1628427,Vlatko Cancar,1610612743,DEN,42,28,14,772.0,24,14,10,0.583,64,0.375,4,0.4,7.3,104,14,90,0.135,151,0.689,10,0.738,7.0,128,28,100,0.219,206,0.621,14,0.667,7.1,2022-23,Regular%20Season
1631117,Walker Kessler,1610612762,UTA,73,34,39,1699.0,231,180,51,0.779,487,0.474,14,0.488,4.0,389,140,250,0.36,670,0.581,70,0.648,4.2,620,320,301,0.516,1123,0.552,84,0.597,4.1,2022-23,Regular%20Season
1628976,Wendell Carter Jr.,1610612753,ORL,57,26,31,1690.0,120,92,28,0.767,281,0.427,7,0.438,4.7,377,124,252,0.329,611,0.617,71,0.698,4.7,497,216,280,0.435,861,0.577,78,0.635,4.7,2022-23,Regular%20Season
1631111,Wendell Moore Jr.,1610612750,MIN,13,4,9,92.0,4,3,1,0.75,7,0.571,0,0.571,3.1,14,4,10,0.286,23,0.609,2,0.667,6.9,18,7,11,0.389,29,0.621,2,0.667,6.0,2022-23,Regular%20Season
1629117,Wenyen Gabriel,1610612747,LAL,60,32,28,960.0,116,88,25,0.759,234,0.496,6,0.509,4.7,170,91,77,0.535,311,0.547,34,0.614,4.9,286,179,102,0.626,528,0.542,40,0.586,4.8,2022-23,Regular%20Season
202083,Wesley Matthews,1610612749,MIL,42,34,8,704.0,34,14,20,0.412,59,0.576,2,0.596,10.9,79,23,57,0.291,147,0.537,18,0.612,7.8,113,37,77,0.327,201,0.562,20,0.624,8.7,2022-23,Regular%20Season
203115,Will Barton,1610612761,TOR,50,24,26,960.0,15,5,9,0.333,37,0.405,0,0.405,10.4,122,18,103,0.148,193,0.632,15,0.685,6.0,137,23,112,0.168,226,0.606,15,0.649,6.5,2022-23,Regular%20Season
1626195,Willy Hernangomez,1610612740,NOP,35,20,15,455.0,58,43,15,0.741,136,0.426,6,0.446,4.2,122,38,84,0.311,200,0.61,28,0.709,4.7,180,81,99,0.45,321,0.561,34,0.627,4.5,2022-23,Regular%20Season
1641645,Xavier Cooks,1610612764,WAS,9,1,8,124.0,16,10,6,0.625,28,0.571,0,0.571,5.2,22,11,11,0.5,38,0.579,2,0.611,4.7,38,21,17,0.553,61,0.623,2,0.644,4.9,2022-23,Regular%20Season
1629875,Xavier Moon,1610612746,LAC,3,1,2,18.0,0,0,0,0.0,2,0.0,0,0.0,0.0,3,1,2,0.333,3,1.0,0,1.0,6.1,3,1,2,0.333,5,0.6,0,0.6,6.1,2022-23,Regular%20Season
1630270,Xavier Sneed,1610612766,CHA,4,0,4,48.0,0,0,0,0.0,1,0.0,0,0.0,0.0,5,0,5,0.0,7,0.714,1,0.833,6.8,5,0,5,0.0,8,0.625,1,0.714,6.8,2022-23,Regular%20Season
1630214,Xavier Tillman,1610612763,MEM,57,37,20,1168.0,121,76,45,0.628,272,0.445,8,0.458,5.6,186,56,129,0.301,314,0.592,22,0.637,6.0,307,132,174,0.43,574,0.535,30,0.564,5.9,2022-23,Regular%20Season
1629139,Yuta Watanabe,1610612751,BKN,44,24,20,810.0,30,18,12,0.6,60,0.5,3,0.526,8.8,111,21,88,0.189,204,0.544,18,0.597,6.1,141,39,100,0.277,259,0.544,21,0.592,6.7,2022-23,Regular%20Season
1628380,Zach Collins,1610612759,SAS,60,19,41,1386.0,112,81,31,0.723,323,0.347,9,0.357,4.6,276,98,178,0.355,512,0.539,50,0.597,4.9,388,179,209,0.461,812,0.478,59,0.515,4.8,2022-23,Regular%20Season
203897,Zach LaVine,1610612741,CHI,75,37,38,2698.0,41,14,28,0.341,140,0.293,5,0.304,11.5,299,34,266,0.114,501,0.597,44,0.654,6.8,340,48,294,0.141,626,0.543,49,0.589,7.4,2022-23,Regular%20Season
1630192,Zeke Nnaji,1610612743,DEN,41,25,16,642.0,65,44,21,0.677,135,0.481,3,0.492,5.6,73,15,58,0.205,137,0.533,14,0.593,5.7,138,59,79,0.428,262,0.527,17,0.563,5.7,2022-23,Regular%20Season
1630533,Ziaire Williams,1610612763,MEM,28,14,14,492.0,16,9,7,0.563,38,0.421,1,0.432,9.5,63,10,53,0.159,105,0.6,9,0.656,6.4,79,19,60,0.241,138,0.572,10,0.617,7.0,2022-23,Regular%20Season
1629627,Zion Williamson,1610612740,NOP,29,17,12,956.0,58,38,19,0.655,137,0.423,5,0.439,6.1,144,42,103,0.292,212,0.679,17,0.738,5.2,202,80,122,0.396,322,0.627,22,0.673,5.5,2022-23,Regular%20Season
203932,Aaron Gordon,1610612743,DEN,20,16,4,713.0,49,36,13,0.735,89,0.551,4,0.576,5.2,71,21,50,0.296,112,0.634,14,0.724,7.4,120,57,63,0.475,200,0.6,18,0.659,6.5,2022-23,Playoffs
201143,Al Horford,1610612738,BOS,20,11,9,617.0,30,19,11,0.633,55,0.545,1,0.556,7.7,113,27,86,0.239,192,0.589,21,0.661,5.6,143,46,97,0.322,244,0.586,22,0.644,6.0,2022-23,Playoffs
203458,Alex Len,1610612758,SAC,6,2,4,54.0,7,3,4,0.429,14,0.5,1,0.538,6.7,13,4,9,0.308,23,0.565,3,0.65,4.9,20,7,13,0.35,36,0.556,4,0.625,5.6,2022-23,Playoffs
203952,Andrew Wiggins,1610612744,GSW,13,6,7,442.0,24,14,10,0.583,58,0.414,1,0.421,7.2,49,18,31,0.367,96,0.51,11,0.576,5.8,73,32,41,0.438,152,0.48,12,0.521,6.3,2022-23,Playoffs
203076,Anthony Davis,1610612747,LAL,16,8,8,608.0,38,32,6,0.842,103,0.369,0,0.369,4.0,187,83,104,0.444,268,0.698,21,0.757,4.2,225,115,110,0.511,367,0.613,21,0.65,4.2,2022-23,Playoffs
1630162,Anthony Edwards,1610612750,MIN,5,1,4,199.0,3,0,3,0.0,11,0.273,0,0.273,19.4,22,5,17,0.227,40,0.55,4,0.611,6.6,25,5,20,0.2,51,0.49,4,0.532,8.1,2022-23,Playoffs
1630237,Anthony Lamb,1610612744,GSW,3,1,2,16.0,1,1,0,1.0,2,0.5,0,0.5,9.4,5,2,3,0.4,6,0.833,1,1.0,6.4,6,3,3,0.5,7,0.857,1,1.0,6.9,2022-23,Playoffs
1630559,Austin Reaves,1610612747,LAL,16,8,8,579.0,20,8,12,0.4,44,0.455,1,0.465,11.3,51,4,47,0.078,90,0.567,6,0.607,10.2,71,12,59,0.169,131,0.542,7,0.573,10.5,2022-23,Playoffs
203085,Austin Rivers,1610612750,MIN,3,1,2,41.0,1,1,0,1.0,2,0.5,0,0.5,7.1,4,1,3,0.25,9,0.444,2,0.571,6.6,5,2,3,0.4,11,0.455,2,0.556,6.7,2022-23,Playoffs
1628389,Bam Adebayo,1610612748,MIA,23,13,10,850.0,63,42,21,0.667,147,0.429,0,0.429,4.5,164,38,125,0.232,236,0.695,20,0.759,5.9,227,80,146,0.352,371,0.612,20,0.647,5.5,2022-23,Playoffs
202687,Bismack Biyombo,1610612756,PHX,7,4,3,72.0,10,5,5,0.5,20,0.5,0,0.5,4.6,17,7,10,0.412,30,0.567,2,0.607,3.9,27,12,15,0.444,46,0.587,2,0.614,4.2,2022-23,Playoffs
201933,Blake Griffin,1610612738,BOS,1,0,1,6.0,1,0,1,0.0,2,0.5,0,0.5,2.1,1,0,1,0.0,5,0.2,0,0.2,5.1,2,0,2,0.0,6,0.333,0,0.333,3.6,2022-23,Playoffs
1626171,Bobby Portis,1610612749,MIL,5,1,4,107.0,10,5,5,0.5,19,0.526,0,0.526,10.3,31,8,23,0.258,36,0.861,0,0.861,4.7,41,13,28,0.317,53,0.774,0,0.774,6.1,2022-23,Playoffs
203992,Bogdan Bogdanovic,1610612737,ATL,5,2,3,137.0,2,1,1,0.5,7,0.286,0,0.286,2.5,16,2,14,0.125,27,0.593,2,0.64,7.0,18,3,15,0.167,30,0.6,2,0.643,6.5,2022-23,Playoffs
1630538,Bones Hyland,1610612746,LAC,3,1,2,49.0,1,0,1,0.0,5,0.2,0,0.2,4.1,3,0,3,0.0,10,0.3,0,0.3,8.8,4,0,4,0.0,15,0.267,0,0.267,7.7,2022-23,Playoffs
201572,Brook Lopez,1610612749,MIL,5,1,4,182.0,14,11,3,0.786,25,0.56,0,0.56,5.4,18,6,12,0.333,37,0.486,2,0.514,7.5,32,17,15,0.531,59,0.542,2,0.561,6.6,2022-23,Playoffs
1628971,Bruce Brown,1610612743,DEN,20,16,4,532.0,15,7,8,0.467,42,0.357,2,0.375,8.1,65,8,57,0.123,115,0.565,11,0.625,8.6,80,15,65,0.188,157,0.51,13,0.556,8.5,2022-23,Playoffs
1628997,Caleb Martin,1610612748,MIA,23,13,10,694.0,27,12,15,0.444,63,0.429,2,0.443,11.7,98,18,80,0.184,177,0.554,20,0.624,6.3,125,30,95,0.24,230,0.543,22,0.601,7.5,2022-23,Playoffs
1630560,Cam Thomas,1610612751,BKN,1,0,1,11.0,0,0,0,0.0,0,0.0,0,0.0,0.0,1,0,1,0.0,4,0.25,1,0.333,18.5,1,0,1,0.0,4,0.25,1,0.333,18.5,2022-23,Playoffs
1629661,Cameron Johnson,1610612751,BKN,4,0,4,152.0,3,2,1,0.667,9,0.333,0,0.333,6.6,20,7,13,0.35,36,0.556,2,0.588,6.3,23,9,14,0.391,45,0.511,2,0.535,6.4,2022-23,Playoffs
1626166,Cameron Payne,1610612756,PHX,5,1,4,119.0,0,0,0,0.0,0,0.0,0,0.0,0.0,14,4,10,0.286,17,0.824,0,0.824,9.5,14,4,10,0.286,17,0.824,0,0.824,9.5,2022-23,Playoffs
1627747,Caris LeVert,1610612739,CLE,5,1,4,170.0,4,3,1,0.75,10,0.4,0,0.4,13.5,19,3,16,0.158,37,0.514,2,0.543,5.3,23,6,17,0.261,46,0.5,2,0.523,6.8,2022-23,Playoffs
1626224,Cedi Osman,1610612739,CLE,5,1,4,93.0,1,1,0,1.0,4,0.25,0,0.25,6.1,14,2,12,0.143,19,0.737,1,0.778,6.6,15,3,12,0.2,22,0.682,1,0.714,6.6,2022-23,Playoffs
1629002,Chimezie Metu,1610612758,SAC,1,0,1,3.0,1,0,1,0.0,2,0.5,0,0.5,4.1,0,0,0,0.0,0,0.0,0,0.0,0.0,1,0,1,0.0,2,0.5,0,0.5,4.1,2022-23,Playoffs
101108,Chris Paul,1610612756,PHX,6,4,2,218.0,5,4,1,0.8,13,0.385,0,0.385,6.8,30,8,22,0.267,51,0.588,3,0.625,7.2,35,12,23,0.343,64,0.547,3,0.574,7.1,2022-23,Playoffs
1631128,Christian Braun,1610612743,DEN,18,14,4,233.0,12,6,6,0.5,42,0.286,3,0.308,8.9,27,5,22,0.185,47,0.574,6,0.659,7.1,39,11,28,0.282,86,0.453,9,0.506,7.6,2022-23,Playoffs
203991,Clint Capela,1610612737,ATL,6,2,4,151.0,15,10,5,0.667,31,0.484,1,0.5,5.0,35,9,26,0.257,57,0.614,5,0.673,4.9,50,19,31,0.38,86,0.581,6,0.625,4.9,2022-23,Playoffs
203469,Cody Zeller,1610612748,MIA,18,10,8,158.0,11,6,5,0.545,38,0.289,2,0.306,4.4,37,14,23,0.378,62,0.597,7,0.673,5.2,48,20,28,0.417,98,0.49,9,0.539,5.0,2022-23,Playoffs
1626156,D'Angelo Russell,1610612747,LAL,15,8,7,446.0,10,2,8,0.2,18,0.556,0,0.556,16.6,37,6,31,0.162,64,0.578,6,0.638,8.4,47,8,39,0.17,80,0.588,6,0.635,10.1,2022-23,Playoffs
1627814,Damion Lee,1610612756,PHX,6,2,4,74.0,4,1,3,0.25,7,0.571,0,0.571,10.1,7,3,4,0.429,11,0.636,1,0.7,5.7,11,4,7,0.364,17,0.647,1,0.688,7.3,2022-23,Playoffs
201980,Danny Green,1610612739,CLE,3,1,2,36.0,2,1,1,0.5,7,0.286,0,0.286,5.1,5,0,5,0.0,9,0.556,1,0.625,5.6,7,1,6,0.143,14,0.5,1,0.538,5.5,2022-23,Playoffs
1627863,Danuel House Jr.,1610612755,PHI,6,3,3,42.0,0,0,0,0.0,3,0.0,0,0.0,0.0,12,1,11,0.083,20,0.6,1,0.632,8.0,12,1,11,0.083,21,0.571,1,0.6,8.0,2022-23,Playoffs
1629636,Darius Garland,1610612739,CLE,4,1,3,145.0,0,0,0,0.0,6,0.0,2,0.0,0.0,9,2,7,0.222,20,0.45,4,0.563,10.0,9,2,7,0.222,25,0.36,6,0.474,10.0,2022-23,Playoffs
1631223,David Roddy,1610612763,MEM,5,1,4,74.0,4,1,3,0.25,10,0.4,0,0.4,15.7,13,4,9,0.308,20,0.65,0,0.65,5.0,17,5,12,0.294,30,0.567,0,0.567,7.6,2022-23,Playoffs
1630558,Davion Mitchell,1610612758,SAC,6,3,3,131.0,3,1,2,0.333,8,0.375,1,0.429,12.2,6,0,6,0.0,12,0.5,1,0.545,7.7,9,1,8,0.111,20,0.45,2,0.5,9.2,2022-23,Playoffs
1630549,Day'Ron Sharpe,1610612751,BKN,1,0,1,17.0,2,2,0,1.0,7,0.286,0,0.286,4.3,4,1,3,0.25,7,0.571,0,0.571,2.5,6,3,3,0.5,14,0.429,0,0.429,3.1,2022-23,Playoffs
1628368,De'Aaron Fox,1610612758,SAC,7,3,4,270.0,12,2,10,0.167,22,0.545,0,0.545,16.8,26,5,21,0.192,45,0.578,2,0.605,7.8,38,7,31,0.184,64,0.594,2,0.613,10.6,2022-23,Playoffs
1629631,De'Andre Hunter,1610612737,ATL,6,2,4,224.0,7,1,6,0.143,15,0.467,1,0.5,9.2,27,3,24,0.111,45,0.6,4,0.659,7.3,34,4,30,0.118,59,0.576,5,0.63,7.7,2022-23,Playoffs
1629001,De'Anthony Melton,1610612755,PHI,11,7,4,274.0,14,5,9,0.357,36,0.389,2,0.412,12.0,22,3,19,0.136,43,0.512,6,0.595,7.7,36,8,28,0.222,78,0.462,8,0.514,9.3,2022-23,Playoffs
201599,DeAndre Jordan,1610612743,DEN,1,0,1,4.0,0,0,0,0.0,2,0.0,0,0.0,0.0,4,3,1,0.75,5,0.8,0,0.8,2.5,4,3,1,0.75,6,0.667,0,0.667,2.5,2022-23,Playoffs
1629731,Dean Wade,1610612739,CLE,2,0,2,11.0,0,0,0,0.0,0,0.0,0,0.0,0.0,3,1,2,0.333,4,0.75,1,1.0,4.4,3,1,2,0.333,4,0.75,1,1.0,4.4,2022-23,Playoffs
1629028,Deandre Ayton,1610612756,PHX,10,6,4,319.0,29,23,6,0.793,58,0.5,0,0.5,5.5,68,18,50,0.265,98,0.694,7,0.747,5.0,97,41,56,0.423,149,0.651,7,0.683,5.1,2022-23,Playoffs
1627749,Dejounte Murray,1610612737,ATL,5,1,4,190.0,9,3,6,0.333,18,0.5,0,0.5,18.0,27,4,23,0.148,42,0.643,5,0.73,7.2,36,7,29,0.194,60,0.6,5,0.655,9.9,2022-23,Playoffs
203471,Dennis Schroder,1610612747,LAL,13,6,7,342.0,3,0,3,0.0,9,0.333,0,0.333,22.0,28,3,25,0.107,51,0.549,7,0.636,10.9,31,3,28,0.097,60,0.517,7,0.585,12.0,2022-23,Playoffs
1628401,Derrick White,1610612738,BOS,19,10,9,581.0,13,9,4,0.692,33,0.394,1,0.406,7.1,46,10,36,0.217,87,0.529,5,0.561,8.2,59,19,40,0.322,118,0.5,6,0.527,8.0,2022-23,Playoffs
1630217,Desmond Bane,1610612763,MEM,6,2,4,231.0,7,3,4,0.429,24,0.292,1,0.304,9.0,29,3,26,0.103,41,0.707,4,0.784,6.5,36,6,30,0.167,61,0.59,5,0.643,7.0,2022-23,Playoffs
1626164,Devin Booker,1610612756,PHX,11,6,5,459.0,12,5,7,0.417,37,0.324,2,0.343,5.7,41,9,32,0.22,76,0.539,9,0.612,7.5,53,14,39,0.264,112,0.473,11,0.525,7.1,2022-23,Playoffs
203473,Dewayne Dedmon,1610612755,PHI,1,0,1,5.0,0,0,0,0.0,0,0.0,0,0.0,0.0,1,1,0,1.0,1,1.0,0,1.0,10.3,1,1,0,1.0,1,1.0,0,1.0,10.3,2022-23,Playoffs
1628415,Dillon Brooks,1610612763,MEM,6,2,4,167.0,3,1,2,0.333,11,0.273,1,0.3,9.7,15,2,13,0.133,26,0.577,3,0.652,6.8,18,3,15,0.167,36,0.5,4,0.563,7.3,2022-23,Playoffs
1627734,Domantas Sabonis,1610612758,SAC,7,3,4,243.0,31,22,9,0.71,76,0.408,0,0.408,4.9,46,16,30,0.348,94,0.489,8,0.535,4.3,77,38,39,0.494,168,0.458,8,0.481,4.5,2022-23,Playoffs
1628378,Donovan Mitchell,1610612739,CLE,5,1,4,207.0,3,2,1,0.667,5,0.6,0,0.6,14.5,22,7,15,0.318,37,0.595,3,0.647,10.0,25,9,16,0.36,42,0.595,3,0.641,10.5,2022-23,Playoffs
1628978,Donte DiVincenzo,1610612744,GSW,12,5,7,218.0,11,7,4,0.636,24,0.458,1,0.478,7.0,28,2,26,0.071,47,0.596,3,0.636,6.9,39,9,30,0.231,70,0.557,4,0.591,6.9,2022-23,Playoffs
1627827,Dorian Finney-Smith,1610612751,BKN,4,0,4,101.0,6,3,3,0.5,12,0.5,0,0.5,5.2,12,4,7,0.333,22,0.545,2,0.6,5.2,18,7,10,0.389,33,0.545,2,0.581,5.2,2022-23,Playoffs
203110,Draymond Green,1610612744,GSW,12,5,7,367.0,19,10,9,0.526,44,0.432,2,0.452,7.3,64,22,42,0.344,111,0.577,10,0.634,5.7,83,32,51,0.386,151,0.55,12,0.597,6.1,2022-23,Playoffs
1629130,Duncan Robinson,1610612748,MIA,19,9,10,368.0,1,0,2,0.0,5,0.2,1,0.25,13.0,33,8,25,0.242,61,0.541,4,0.579,8.0,34,8,27,0.235,65,0.523,5,0.567,8.6,2022-23,Playoffs
201569,Eric Gordon,1610612746,LAC,4,1,3,128.0,1,0,1,0.0,4,0.25,0,0.25,41.4,6,1,5,0.167,10,0.6,1,0.667,8.2,7,1,6,0.143,14,0.5,1,0.538,12.9,2022-23,Playoffs
1630596,Evan Mobley,1610612739,CLE,5,1,4,188.0,15,5,10,0.333,37,0.405,1,0.417,6.2,35,10,25,0.286,63,0.556,4,0.593,4.5,50,15,35,0.3,95,0.526,5,0.556,5.0,2022-23,Playoffs
1627788,Furkan Korkmaz,1610612755,PHI,1,0,1,4.0,0,0,0,0.0,1,0.0,0,0.0,0.0,1,0,1,0.0,1,1.0,0,1.0,9.6,1,0,1,0.0,2,0.5,0,0.5,9.6,2022-23,Playoffs
1629216,Gabe Vincent,1610612748,MIA,14,9,5,453.0,8,1,7,0.125,19,0.421,1,0.444,20.7,23,3,20,0.13,49,0.469,2,0.489,9.9,31,4,27,0.129,67,0.463,3,0.484,12.7,2022-23,Playoffs
1627780,Gary Payton II,1610612744,GSW,11,4,7,184.0,22,11,11,0.5,38,0.579,1,0.595,5.5,22,7,15,0.318,41,0.537,5,0.611,7.5,44,18,26,0.409,77,0.571,6,0.62,6.5,2022-23,Playoffs
1627777,Georges Niang,1610612755,PHI,3,3,0,46.0,0,0,0,0.0,0,0.0,0,0.0,0.0,4,0,4,0.0,7,0.571,1,0.667,4.3,4,0,4,0.0,7,0.571,1,0.667,4.3,2022-23,Playoffs
203507,Giannis Antetokounmpo,1610612749,MIL,3,0,3,91.0,8,6,2,0.75,16,0.5,0,0.5,8.4,25,4,21,0.16,36,0.694,4,0.781,5.0,33,10,23,0.303,47,0.702,4,0.767,5.8,2022-23,Playoffs
1629684,Grant Williams,1610612738,BOS,12,7,5,251.0,11,3,8,0.273,24,0.458,1,0.478,12.8,22,7,15,0.318,40,0.55,7,0.667,7.5,33,10,23,0.303,63,0.524,8,0.6,9.3,2022-23,Playoffs
1628960,Grayson Allen,1610612749,MIL,4,1,3,116.0,1,1,0,1.0,7,0.143,0,0.143,29.9,11,2,9,0.182,14,0.786,0,0.786,6.1,12,3,9,0.25,20,0.6,0,0.6,8.1,2022-23,Playoffs
203084,Harrison Barnes,1610612758,SAC,6,3,3,183.0,10,6,4,0.6,23,0.435,3,0.5,6.4,14,3,11,0.214,19,0.737,1,0.778,8.1,24,9,15,0.375,42,0.571,4,0.632,7.4,2022-23,Playoffs
1629312,Haywood Highsmith,1610612748,MIA,11,6,5,141.0,10,3,7,0.3,20,0.5,0,0.5,9.3,14,6,8,0.429,27,0.519,1,0.538,8.3,24,9,15,0.375,46,0.522,1,0.533,8.7,2022-23,Playoffs
1630193,Immanuel Quickley,1610612752,NYK,8,5,3,175.0,2,0,2,0.0,8,0.25,0,0.25,13.0,11,2,9,0.182,21,0.524,1,0.55,8.1,13,2,11,0.154,28,0.464,1,0.481,8.9,2022-23,Playoffs
1630171,Isaac Okoro,1610612739,CLE,4,1,3,57.0,3,2,1,0.667,7,0.429,0,0.429,4.6,4,0,4,0.0,7,0.571,0,0.571,10.4,7,2,5,0.286,14,0.5,0,0.5,7.9,2022-23,Playoffs
1628392,Isaiah Hartenstein,1610612752,NYK,11,6,5,220.0,23,15,8,0.652,51,0.451,3,0.479,6.6,28,8,20,0.286,61,0.459,7,0.519,5.9,51,23,28,0.451,109,0.468,10,0.515,6.2,2022-23,Playoffs
202397,Ish Smith,1610612743,DEN,1,1,0,4.0,0,0,0,0.0,1,0.0,1,0.0,0.0,1,0,1,0.0,2,0.5,1,1.0,10.6,1,0,1,0.0,3,0.333,2,1.0,10.6,2022-23,Playoffs
1630688,Ish Wainright,1610612756,PHX,1,0,1,7.0,0,0,0,0.0,0,0.0,0,0.0,0.0,1,0,1,0.0,1,1.0,0,1.0,10.3,1,0,1,0.0,1,1.0,0,1.0,10.3,2022-23,Playoffs
1627826,Ivica Zubac,1610612746,LAC,5,1,4,130.0,16,14,2,0.875,42,0.381,3,0.41,4.1,32,11,21,0.344,50,0.64,2,0.667,3.6,48,25,23,0.521,91,0.527,5,0.558,3.8,2022-23,Playoffs
1629630,Ja Morant,1610612763,MEM,5,1,4,187.0,8,4,4,0.5,14,0.571,0,0.571,7.7,26,10,16,0.385,41,0.634,3,0.684,6.7,34,14,20,0.412,55,0.618,3,0.654,6.9,2022-23,Playoffs
203210,JaMychal Green,1610612744,GSW,3,2,1,26.0,0,0,0,0.0,3,0.0,0,0.0,0.0,5,3,2,0.6,6,0.833,0,0.833,4.8,5,3,2,0.6,9,0.556,0,0.556,4.8,2022-23,Playoffs
203109,Jae Crowder,1610612749,MIL,2,1,1,29.0,1,1,0,1.0,3,0.333,0,0.333,9.8,3,1,2,0.333,4,0.75,0,0.75,6.4,4,2,2,0.5,6,0.667,0,0.667,7.3,2022-23,Playoffs
1628973,Jalen Brunson,1610612752,NYK,11,6,5,443.0,9,2,7,0.222,19,0.474,0,0.474,20.4,45,3,42,0.067,77,0.584,11,0.682,9.8,54,5,49,0.093,93,0.581,11,0.659,11.6,2022-23,Playoffs
1630552,Jalen Johnson,1610612737,ATL,5,2,3,51.0,2,0,1,0.0,9,0.222,1,0.25,7.0,13,0,13,0.0,16,0.813,2,0.929,3.9,15,0,14,0.0,22,0.682,3,0.789,4.2,2022-23,Playoffs
1629667,Jalen McDaniels,1610612755,PHI,7,5,2,101.0,3,1,2,0.333,9,0.333,1,0.375,7.5,13,1,12,0.077,20,0.65,3,0.765,5.4,16,2,14,0.125,28,0.571,4,0.667,5.8,2022-23,Playoffs
1627750,Jamal Murray,1610612743,DEN,20,16,4,799.0,15,9,6,0.6,38,0.395,1,0.405,7.0,98,17,81,0.173,130,0.754,8,0.803,7.7,113,26,87,0.23,168,0.673,9,0.711,7.7,2022-23,Playoffs
201935,James Harden,1610612755,PHI,11,7,4,427.0,6,3,3,0.5,33,0.182,1,0.188,10.2,62,9,53,0.145,98,0.633,6,0.674,7.0,68,12,56,0.176,127,0.535,7,0.567,7.3,2022-23,Playoffs
1628991,Jaren Jackson Jr.,1610612763,MEM,6,2,4,220.0,20,14,6,0.7,41,0.488,2,0.513,6.9,27,4,23,0.148,47,0.574,4,0.628,5.9,47,18,29,0.383,85,0.553,6,0.595,6.3,2022-23,Playoffs
1629020,Jarred Vanderbilt,1610612747,LAL,14,7,7,243.0,19,14,5,0.737,40,0.475,2,0.5,6.5,29,6,23,0.207,54,0.537,8,0.63,6.1,48,20,28,0.417,91,0.527,10,0.593,6.2,2022-23,Playoffs
1628386,Jarrett Allen,1610612739,CLE,5,1,4,191.0,15,11,4,0.733,34,0.441,1,0.455,5.8,22,11,11,0.5,53,0.415,8,0.489,4.4,37,22,15,0.595,86,0.43,9,0.481,5.0,2022-23,Playoffs
1627759,Jaylen Brown,1610612738,BOS,20,11,9,751.0,25,13,12,0.52,58,0.431,1,0.439,9.0,87,15,71,0.172,145,0.6,13,0.659,6.9,112,28,83,0.25,196,0.571,14,0.615,7.4,2022-23,Playoffs
1629669,Jaylen Nowell,1610612750,MIN,3,1,2,38.0,4,3,1,0.75,5,0.8,0,0.8,2.7,1,0,1,0.0,3,0.333,0,0.333,22.7,5,3,2,0.6,8,0.625,0,0.625,6.7,2022-23,Playoffs
1628369,Jayson Tatum,1610612738,BOS,20,11,9,799.0,26,15,10,0.577,54,0.481,0,0.481,8.7,184,34,151,0.185,259,0.71,12,0.745,5.7,210,49,161,0.233,308,0.682,12,0.709,6.1,2022-23,Playoffs
201145,Jeff Green,1610612743,DEN,16,12,4,279.0,6,1,5,0.167,14,0.429,0,0.429,10.6,25,4,21,0.16,41,0.61,2,0.641,6.7,31,5,26,0.161,54,0.574,2,0.596,7.5,2022-23,Playoffs
1628975,Jevon Carter,1610612749,MIL,2,1,1,37.0,0,0,0,0.0,0,0.0,0,0.0,0.0,4,0,4,0.0,4,1.0,0,1.0,8.0,4,0,4,0.0,4,1.0,0,1.0,8.0,2022-23,Playoffs
202710,Jimmy Butler,1610612748,MIA,22,13,9,874.0,47,25,22,0.532,128,0.367,7,0.388,7.2,95,21,74,0.221,164,0.579,18,0.651,6.9,142,46,96,0.324,285,0.498,25,0.546,7.0,2022-23,Playoffs
1629111,Jock Landale,1610612756,PHX,7,2,5,113.0,10,7,3,0.7,36,0.278,1,0.286,4.3,18,3,15,0.167,36,0.5,5,0.581,5.3,28,10,18,0.357,71,0.394,6,0.431,5.0,2022-23,Playoffs
203925,Joe Harris,1610612751,BKN,3,0,3,40.0,0,0,0,0.0,0,0.0,0,0.0,0.0,5,1,4,0.2,12,0.417,2,0.5,5.0,5,1,4,0.2,12,0.417,2,0.5,5.0,2022-23,Playoffs
204060,Joe Ingles,1610612749,MIL,2,1,1,43.0,1,0,1,0.0,2,0.5,1,1.0,6.6,5,0,5,0.0,6,0.833,0,0.833,5.9,6,0,6,0.0,8,0.75,1,0.857,6.0,2022-23,Playoffs
203954,Joel Embiid,1610612755,PHI,9,5,4,336.0,16,10,6,0.625,41,0.39,1,0.4,5.1,72,24,48,0.333,113,0.637,16,0.742,5.1,88,34,54,0.386,151,0.583,17,0.657,5.1,2022-23,Playoffs
1628381,John Collins,1610612737,ATL,6,2,4,164.0,7,4,3,0.571,18,0.389,1,0.412,6.5,19,4,15,0.211,38,0.5,2,0.528,4.1,26,8,18,0.308,55,0.473,3,0.5,4.7,2022-23,Playoffs
1629723,John Konchar,1610612763,MEM,4,2,2,48.0,4,1,3,0.25,9,0.444,1,0.5,8.2,6,0,6,0.0,7,0.857,0,0.857,4.9,10,1,9,0.1,15,0.667,1,0.714,6.2,2022-23,Playoffs
1630228,Jonathan Kuminga,1610612744,GSW,7,4,3,45.0,4,3,1,0.75,7,0.571,0,0.571,5.9,5,1,4,0.2,9,0.556,0,0.556,5.2,9,4,5,0.444,15,0.6,0,0.6,5.5,2022-23,Playoffs
1629162,Jordan McLaughlin,1610612750,MIN,1,0,1,10.0,0,0,0,0.0,1,0.0,0,0.0,0.0,2,0,2,0.0,3,0.667,1,1.0,5.9,2,0,2,0.0,4,0.5,1,0.667,5.9,2022-23,Playoffs
1629673,Jordan Poole,1610612744,GSW,10,6,4,205.0,4,1,3,0.25,11,0.364,0,0.364,17.7,24,1,23,0.042,33,0.727,1,0.75,7.2,28,2,26,0.071,42,0.667,1,0.683,8.7,2022-23,Playoffs
1628404,Josh Hart,1610612752,NYK,11,6,5,353.0,18,11,7,0.611,42,0.429,3,0.462,9.3,63,20,43,0.317,105,0.6,9,0.656,5.8,81,31,50,0.383,146,0.555,12,0.604,6.6,2022-23,Playoffs
1629006,Josh Okogie,1610612756,PHX,8,6,2,145.0,12,9,3,0.75,25,0.48,0,0.48,6.8,9,0,9,0.0,22,0.409,1,0.429,6.5,21,9,12,0.429,47,0.447,1,0.457,6.7,2022-23,Playoffs
201950,Jrue Holiday,1610612749,MIL,5,1,4,191.0,4,1,3,0.25,18,0.222,1,0.235,12.4,29,8,21,0.276,47,0.617,6,0.707,7.2,33,9,24,0.273,63,0.524,7,0.589,7.9,2022-23,Playoffs
203944,Julius Randle,1610612752,NYK,10,6,4,330.0,17,7,10,0.412,51,0.333,0,0.333,7.6,66,15,51,0.227,99,0.667,9,0.733,4.1,83,22,61,0.265,137,0.606,9,0.648,4.8,2022-23,Playoffs
1626157,Karl-Anthony Towns,1610612750,MIN,5,1,4,180.0,6,4,2,0.667,19,0.316,1,0.333,7.2,45,8,37,0.178,59,0.763,1,0.776,6.0,51,12,39,0.235,74,0.689,2,0.708,6.1,2022-23,Playoffs
202695,Kawhi Leonard,1610612746,LAC,2,1,1,80.0,3,2,1,0.667,6,0.5,1,0.6,13.4,10,4,6,0.4,16,0.625,2,0.714,5.8,13,6,7,0.462,21,0.619,3,0.722,7.5,2022-23,Playoffs
1631099,Keegan Murray,1610612758,SAC,7,3,4,194.0,15,6,9,0.4,26,0.577,2,0.625,9.6,29,7,22,0.241,45,0.644,2,0.674,5.8,44,13,31,0.295,70,0.629,4,0.667,7.1,2022-23,Playoffs
1631254,Kenneth Lofton Jr.,1610612763,MEM,1,0,1,10.0,1,1,0,1.0,3,0.333,0,0.333,3.2,2,0,2,0.0,3,0.667,1,1.0,6.0,3,1,2,0.333,6,0.5,1,0.6,5.0,2022-23,Playoffs
203484,Kentavious Caldwell-Pope,1610612743,DEN,20,16,4,671.0,14,4,10,0.286,33,0.424,2,0.452,11.8,51,4,47,0.078,87,0.586,8,0.646,9.9,65,8,57,0.123,118,0.551,10,0.602,10.4,2022-23,Playoffs
1630556,Kessler Edwards,1610612758,SAC,1,0,1,3.0,0,0,0,0.0,0,0.0,0,0.0,0.0,1,0,1,0.0,1,1.0,0,1.0,5.1,1,0,1,0.0,1,1.0,0,1.0,5.1,2022-23,Playoffs
201142,Kevin Durant,1610612756,PHX,11,6,5,466.0,7,3,4,0.429,19,0.368,0,0.368,13.6,89,31,58,0.348,124,0.718,5,0.748,5.8,96,34,62,0.354,140,0.686,5,0.711,6.4,2022-23,Playoffs
1628989,Kevin Huerter,1610612758,SAC,7,3,4,183.0,1,1,0,1.0,11,0.091,1,0.1,2.6,30,7,23,0.233,37,0.811,4,0.909,7.2,31,8,23,0.258,46,0.674,5,0.756,7.0,2022-23,Playoffs
201567,Kevin Love,1610612748,MIA,20,12,8,359.0,14,11,3,0.786,38,0.368,0,0.368,4.7,97,20,77,0.206,160,0.606,15,0.669,4.0,111,31,80,0.279,192,0.578,15,0.627,4.1,2022-23,Playoffs
1626172,Kevon Looney,1610612744,GSW,13,6,7,325.0,61,45,16,0.738,108,0.565,0,0.565,6.3,109,42,67,0.385,161,0.677,13,0.736,4.4,170,87,83,0.512,258,0.659,13,0.694,5.1,2022-23,Playoffs
203114,Khris Middleton,1610612749,MIL,5,1,4,173.0,7,5,2,0.714,14,0.5,0,0.5,8.7,25,8,17,0.32,34,0.735,1,0.758,8.8,32,13,19,0.406,48,0.667,1,0.681,8.8,2022-23,Playoffs
202691,Klay Thompson,1610612744,GSW,13,6,7,468.0,1,0,1,0.0,17,0.059,2,0.067,38.1,53,7,46,0.132,95,0.558,9,0.616,7.2,54,7,47,0.13,106,0.509,11,0.568,7.8,2022-23,Playoffs
203937,Kyle Anderson,1610612750,MIN,4,1,3,104.0,3,2,1,0.667,8,0.375,0,0.375,2.4,13,3,10,0.231,19,0.684,0,0.684,5.2,16,5,11,0.313,27,0.593,0,0.593,4.7,2022-23,Playoffs
200768,Kyle Lowry,1610612748,MIA,22,12,10,576.0,12,4,8,0.333,36,0.333,3,0.364,12.4,69,16,52,0.232,141,0.489,18,0.561,6.8,81,20,60,0.247,176,0.46,21,0.523,7.6,2022-23,Playoffs
1630205,Lamar Stevens,1610612739,CLE,1,0,1,4.0,0,0,0,0.0,1,0.0,0,0.0,0.0,3,0,3,0.0,6,0.5,1,0.6,9.1,3,0,3,0.0,6,0.5,1,0.6,9.1,2022-23,Playoffs
1629013,Landry Shamet,1610612756,PHX,6,3,3,117.0,3,2,1,0.667,6,0.5,0,0.5,13.0,14,3,11,0.214,24,0.583,2,0.636,7.4,17,5,12,0.294,30,0.567,2,0.607,8.4,2022-23,Playoffs
2544,LeBron James,1610612747,LAL,16,8,8,619.0,25,18,7,0.72,57,0.439,2,0.455,6.0,133,36,97,0.271,202,0.658,13,0.704,6.2,158,54,104,0.342,247,0.64,15,0.681,6.2,2022-23,Playoffs
1629022,Lonnie Walker IV,1610612747,LAL,6,3,3,112.0,1,0,1,0.0,1,1.0,0,1.0,20.2,11,1,10,0.091,13,0.846,0,0.846,8.2,12,1,11,0.083,14,0.857,0,0.857,9.2,2022-23,Playoffs
1628379,Luke Kennard,1610612763,MEM,5,2,3,107.0,5,2,3,0.4,10,0.5,0,0.5,13.4,15,3,12,0.2,27,0.556,1,0.577,6.6,20,5,15,0.25,36,0.556,1,0.571,8.3,2022-23,Playoffs
1628436,Luke Kornet,1610612738,BOS,3,2,1,21.0,5,4,1,0.8,8,0.625,0,0.625,5.7,5,1,4,0.2,6,0.833,1,1.0,4.0,10,5,5,0.5,13,0.769,1,0.833,4.9,2022-23,Playoffs
1627763,Malcolm Brogdon,1610612738,BOS,17,9,8,458.0,13,6,7,0.462,29,0.448,1,0.464,13.6,53,13,40,0.245,90,0.589,11,0.671,7.6,66,19,47,0.288,118,0.559,12,0.623,8.8,2022-23,Playoffs
1627736,Malik Beasley,1610612747,LAL,6,4,2,62.0,3,1,2,0.333,5,0.6,0,0.6,12.5,5,1,4,0.2,12,0.417,1,0.455,8.1,8,2,6,0.25,17,0.471,1,0.5,9.8,2022-23,Playoffs
1628370,Malik Monk,1610612758,SAC,7,3,4,205.0,6,2,4,0.333,19,0.316,0,0.316,14.4,32,3,29,0.094,41,0.78,1,0.8,7.1,38,5,33,0.132,59,0.644,1,0.655,8.3,2022-23,Playoffs
1630699,MarJon Beauchamp,1610612749,MIL,1,0,1,4.0,0,0,0,0.0,0,0.0,0,0.0,0.0,1,0,1,0.0,1,1.0,0,1.0,5.4,1,0,1,0.0,1,1.0,0,1.0,5.4,2022-23,Playoffs
202694,Marcus Morris Sr.,1610612746,LAC,3,0,3,68.0,1,0,1,0.0,4,0.25,0,0.25,5.0,11,2,8,0.182,20,0.55,4,0.688,4.8,12,2,9,0.167,23,0.522,4,0.632,4.8,2022-23,Playoffs
203935,Marcus Smart,1610612738,BOS,20,11,9,679.0,21,10,11,0.476,44,0.477,7,0.568,10.1,59,12,47,0.203,96,0.615,6,0.656,9.5,80,22,58,0.275,138,0.58,13,0.64,9.6,2022-23,Playoffs
203486,Mason Plumlee,1610612746,LAC,5,1,4,91.0,16,9,7,0.563,28,0.571,1,0.593,5.0,18,6,12,0.333,32,0.563,1,0.581,4.8,34,15,19,0.441,57,0.596,2,0.618,4.9,2022-23,Playoffs
1631108,Max Christie,1610612747,LAL,4,2,2,25.0,1,0,1,0.0,1,1.0,0,1.0,15.2,6,1,5,0.167,11,0.545,3,0.75,10.1,7,1,6,0.143,12,0.583,3,0.778,10.9,2022-23,Playoffs
1629622,Max Strus,1610612748,MIA,20,11,9,582.0,14,6,8,0.429,41,0.341,0,0.341,13.9,69,12,57,0.174,105,0.657,9,0.719,7.2,83,18,65,0.217,137,0.606,9,0.648,8.4,2022-23,Playoffs
203086,Meyers Leonard,1610612749,MIL,1,0,1,4.0,0,0,0,0.0,0,0.0,0,0.0,0.0,1,1,0,1.0,2,0.5,1,1.0,2.3,1,1,0,1.0,2,0.5,1,1.0,2.3,2022-23,Playoffs
1629008,Michael Porter Jr.,1610612743,DEN,20,16,4,653.0,20,13,7,0.65,61,0.328,1,0.333,5.0,142,26,116,0.183,184,0.772,14,0.835,5.3,162,39,123,0.241,230,0.704,15,0.753,5.2,2022-23,Playoffs
1628969,Mikal Bridges,1610612751,BKN,4,0,4,157.0,2,1,1,0.5,8,0.25,1,0.286,7.1,19,4,15,0.211,26,0.731,2,0.792,7.9,21,5,16,0.238,34,0.618,3,0.677,7.8,2022-23,Playoffs
201144,Mike Conley,1610612750,MIN,5,1,4,183.0,2,0,2,0.0,9,0.222,1,0.25,23.6,11,2,9,0.182,23,0.478,3,0.55,10.7,13,2,11,0.154,32,0.406,4,0.464,12.6,2022-23,Playoffs
203488,Mike Muscala,1610612738,BOS,3,0,3,14.0,3,1,2,0.333,3,1.0,0,1.0,7.8,1,1,0,1.0,1,1.0,0,1.0,0.3,4,2,2,0.5,4,1.0,0,1.0,5.9,2022-23,Playoffs
1630540,Miles McBride,1610612752,NYK,2,2,0,9.0,0,0,0,0.0,1,0.0,0,0.0,0.0,2,0,2,0.0,3,0.667,0,0.667,12.3,2,0,2,0.0,3,0.667,0,0.667,12.3,2022-23,Playoffs
1629011,Mitchell Robinson,1610612752,NYK,11,6,5,298.0,55,43,12,0.782,102,0.539,1,0.545,4.2,47,18,29,0.383,77,0.61,6,0.662,5.6,102,61,41,0.598,177,0.576,7,0.6,4.9,2022-23,Playoffs
1628964,Mo Bamba,1610612747,LAL,1,1,0,9.0,0,0,0,0.0,0,0.0,0,0.0,0.0,3,0,3,0.0,3,1.0,0,1.0,3.6,3,0,3,0.0,3,1.0,0,1.0,3.6,2022-23,Playoffs
1626149,Montrezl Harrell,1610612755,PHI,1,1,0,5.0,0,0,0,0.0,0,0.0,0,0.0,0.0,1,1,0,1.0,1,1.0,0,1.0,3.3,1,1,0,1.0,1,1.0,0,1.0,3.3,2022-23,Playoffs
1630541,Moses Moody,1610612744,GSW,9,3,6,136.0,7,5,2,0.714,21,0.333,1,0.35,5.0,24,3,20,0.125,38,0.632,4,0.706,6.3,31,8,22,0.258,57,0.544,5,0.596,6.0,2022-23,Playoffs
1630233,Nathan Knight,1610612750,MIN,1,0,1,5.0,1,1,0,1.0,2,0.5,0,0.5,5.1,0,0,0,0.0,0,0.0,0,0.0,0.0,1,1,0,1.0,2,0.5,0,0.5,5.1,2022-23,Playoffs
1629651,Nic Claxton,1610612751,BKN,4,0,4,117.0,5,2,3,0.4,14,0.357,0,0.357,4.4,27,9,18,0.333,48,0.563,5,0.628,5.1,32,11,21,0.344,62,0.516,5,0.561,5.0,2022-23,Playoffs
1629638,Nickeil Alexander-Walker,1610612750,MIN,5,1,4,148.0,1,0,1,0.0,5,0.2,0,0.2,21.0,9,1,8,0.111,16,0.563,2,0.643,12.0,10,1,9,0.1,21,0.476,2,0.526,12.9,2022-23,Playoffs
201587,Nicolas Batum,1610612746,LAC,4,1,3,86.0,1,0,1,0.0,5,0.2,0,0.2,3.0,10,3,7,0.3,13,0.769,0,0.769,7.7,11,3,8,0.273,18,0.611,0,0.611,7.3,2022-23,Playoffs
203999,Nikola Jokic,1610612743,DEN,20,16,4,789.0,69,44,25,0.638,123,0.561,6,0.59,4.7,200,72,128,0.36,330,0.606,32,0.671,4.0,269,116,153,0.431,446,0.603,38,0.659,4.2,2022-23,Playoffs
1631107,Nikola Jovic,1610612748,MIA,3,1,2,6.0,1,1,0,1.0,4,0.25,0,0.25,1.4,4,0,4,0.0,4,1.0,0,1.0,6.9,5,1,4,0.2,6,0.833,0,0.833,5.8,2022-23,Playoffs
1626181,Norman Powell,1610612746,LAC,4,0,4,144.0,4,0,4,0.0,5,0.8,0,0.8,12.0,11,3,8,0.273,20,0.55,3,0.647,8.9,15,3,12,0.2,25,0.6,3,0.682,9.7,2022-23,Playoffs
1630167,Obi Toppin,1610612752,NYK,10,6,4,160.0,10,4,6,0.4,16,0.625,1,0.667,13.3,29,6,23,0.207,38,0.763,1,0.784,5.8,39,10,29,0.256,53,0.736,2,0.765,7.7,2022-23,Playoffs
1630209,Omer Yurtseven,1610612748,MIA,4,1,3,6.0,3,2,1,0.667,4,0.75,0,0.75,6.2,2,0,2,0.0,3,0.667,0,0.667,6.7,5,2,3,0.4,7,0.714,0,0.714,6.4,2022-23,Playoffs
1630168,Onyeka Okongwu,1610612737,ATL,6,2,4,131.0,19,12,7,0.632,29,0.655,0,0.655,5.5,19,5,15,0.263,33,0.576,2,0.613,3.9,38,17,22,0.447,62,0.613,2,0.633,4.9,2022-23,Playoffs
200782,P.J. Tucker,1610612755,PHI,11,7,4,294.0,18,9,9,0.5,46,0.391,3,0.419,8.3,32,7,25,0.219,51,0.627,3,0.667,7.5,50,16,34,0.32,94,0.532,6,0.568,7.8,2022-23,Playoffs
1628408,PJ Dozier,1610612758,SAC,1,0,1,3.0,1,0,1,0.0,1,1.0,0,1.0,6.9,1,0,1,0.0,1,1.0,0,1.0,3.0,2,0,2,0.0,2,1.0,0,1.0,5.0,2022-23,Playoffs
1626192,Pat Connaughton,1610612749,MIL,4,1,3,88.0,4,1,2,0.25,10,0.4,0,0.4,11.6,16,2,14,0.125,20,0.8,1,0.842,3.8,20,3,16,0.15,29,0.69,1,0.714,5.0,2022-23,Playoffs
1631116,Patrick Baldwin Jr.,1610612744,GSW,2,1,1,6.0,0,0,0,0.0,0,0.0,0,0.0,0.0,3,2,1,0.667,3,1.0,0,1.0,7.1,3,2,1,0.667,3,1.0,0,1.0,7.1,2022-23,Playoffs
1630194,Paul Reed,1610612755,PHI,10,6,4,150.0,27,19,8,0.704,50,0.54,1,0.551,4.5,33,9,24,0.273,53,0.623,3,0.66,5.1,60,28,32,0.467,101,0.594,4,0.619,4.8,2022-23,Playoffs
1630202,Payton Pritchard,1610612738,BOS,4,2,2,38.0,0,0,0,0.0,3,0.0,0,0.0,0.0,6,1,5,0.167,9,0.667,0,0.667,6.6,6,1,5,0.167,12,0.5,0,0.5,6.6,2022-23,Playoffs
1631212,Peyton Watson,1610612743,DEN,3,3,0,10.0,1,0,1,0.0,2,0.5,0,0.5,33.5,3,0,3,0.0,5,0.6,1,0.75,2.0,4,0,4,0.0,7,0.571,1,0.667,9.9,2022-23,Playoffs
1629656,Quentin Grimes,1610612752,NYK,8,4,4,231.0,3,0,3,0.0,9,0.333,0,0.333,11.3,22,5,17,0.227,46,0.478,2,0.5,8.0,25,5,20,0.2,54,0.463,2,0.481,8.4,2022-23,Playoffs
1629628,RJ Barrett,1610612752,NYK,11,6,5,377.0,5,2,3,0.4,21,0.238,1,0.25,11.2,44,7,37,0.159,76,0.579,4,0.611,6.1,49,9,40,0.184,95,0.516,5,0.544,6.6,2022-23,Playoffs
202704,Reggie Jackson,1610612743,DEN,2,2,0,5.0,0,0,0,0.0,0,0.0,0,0.0,0.0,2,0,2,0.0,3,0.667,0,0.667,15.1,2,0,2,0.0,3,0.667,0,0.667,15.1,2022-23,Playoffs
201937,Ricky Rubio,1610612739,CLE,3,0,3,17.0,2,1,1,0.5,2,1.0,0,1.0,13.3,4,0,4,0.0,7,0.571,0,0.571,5.8,6,1,5,0.167,9,0.667,0,0.667,8.3,2022-23,Playoffs
203496,Robert Covington,1610612746,LAC,2,0,2,12.0,0,0,0,0.0,1,0.0,0,0.0,0.0,2,0,2,0.0,3,0.667,0,0.667,6.1,2,0,2,0.0,4,0.5,0,0.5,6.1,2022-23,Playoffs
1629057,Robert Williams III,1610612738,BOS,20,11,9,417.0,36,29,7,0.806,89,0.404,1,0.409,5.1,83,30,53,0.361,132,0.629,11,0.686,5.1,119,59,60,0.496,217,0.548,12,0.58,5.1,2022-23,Playoffs
201577,Robin Lopez,1610612739,CLE,1,0,1,4.0,1,0,1,0.0,1,1.0,0,1.0,15.4,0,0,0,0.0,2,0.0,1,0.0,0.0,1,0,1,0.0,3,0.333,1,0.5,15.4,2022-23,Playoffs
1626220,Royce O'Neale,1610612751,BKN,4,0,4,118.0,4,2,2,0.5,10,0.4,0,0.4,11.1,13,4,9,0.308,22,0.591,1,0.619,4.8,17,6,11,0.353,31,0.548,1,0.567,6.3,2022-23,Playoffs
203497,Rudy Gobert,1610612750,MIN,5,1,4,177.0,18,12,6,0.667,46,0.391,1,0.4,5.3,43,16,27,0.372,70,0.614,6,0.672,3.1,61,28,33,0.459,109,0.56,7,0.598,3.8,2022-23,Playoffs
1629060,Rui Hachimura,1610612747,LAL,15,8,7,360.0,9,5,4,0.556,25,0.36,1,0.375,7.6,49,8,41,0.163,81,0.605,9,0.681,6.5,58,13,45,0.224,104,0.558,10,0.617,6.7,2022-23,Playoffs
201566,Russell Westbrook,1610612746,LAC,5,1,4,192.0,9,5,4,0.556,23,0.391,0,0.391,7.8,29,7,22,0.241,43,0.674,2,0.707,7.7,38,12,26,0.316,63,0.603,2,0.623,7.8,2022-23,Playoffs
1630180,Saddiq Bey,1610612737,ATL,6,2,4,133.0,7,4,2,0.571,20,0.35,0,0.35,8.6,17,3,14,0.176,28,0.607,1,0.63,9.7,24,7,16,0.292,47,0.511,1,0.522,9.4,2022-23,Playoffs
1630573,Sam Hauser,1610612738,BOS,8,4,4,78.0,5,2,3,0.4,8,0.625,0,0.625,9.3,12,8,4,0.667,20,0.6,2,0.667,5.7,17,10,7,0.588,28,0.607,2,0.654,6.8,2022-23,Playoffs
1630583,Santi Aldama,1610612763,MEM,6,2,4,101.0,7,4,3,0.571,11,0.636,1,0.7,6.7,19,4,15,0.211,33,0.576,3,0.633,5.9,26,8,18,0.308,43,0.605,4,0.667,6.1,2022-23,Playoffs
203552,Seth Curry,1610612751,BKN,1,0,1,22.0,0,0,0,0.0,1,0.0,0,0.0,0.0,3,0,3,0.0,5,0.6,1,0.75,8.5,3,0,3,0.0,6,0.5,1,0.6,8.5,2022-23,Playoffs
1629003,Shake Milton,1610612755,PHI,2,1,1,13.0,0,0,0,0.0,1,0.0,0,0.0,0.0,3,2,1,0.667,3,1.0,0,1.0,7.5,3,2,1,0.667,4,0.75,0,0.75,7.5,2022-23,Playoffs
1627885,Shaquille Harrison,1610612747,LAL,3,0,3,13.0,0,0,0,0.0,2,0.0,1,0.0,0.0,3,0,3,0.0,4,0.75,0,0.75,8.2,3,0,3,0.0,6,0.5,1,0.6,8.2,2022-23,Playoffs
203915,Spencer Dinwiddie,1610612751,BKN,4,0,4,159.0,1,0,1,0.0,2,0.5,0,0.5,11.0,12,1,11,0.083,22,0.545,0,0.545,12.6,13,1,12,0.077,24,0.542,0,0.542,12.5,2022-23,Playoffs
201939,Stephen Curry,1610612744,GSW,13,6,7,493.0,9,5,4,0.556,34,0.265,5,0.31,11.8,58,14,44,0.241,106,0.547,11,0.611,7.2,67,19,48,0.284,139,0.482,16,0.545,7.8,2022-23,Playoffs
203933,T.J. Warren,1610612756,PHX,4,2,2,75.0,2,2,0,1.0,5,0.4,0,0.4,8.3,5,2,3,0.4,9,0.556,1,0.625,7.4,7,4,3,0.571,14,0.5,1,0.538,7.7,2022-23,Playoffs
1627752,Taurean Prince,1610612750,MIN,3,1,2,56.0,3,3,0,1.0,4,0.75,0,0.75,2.5,4,1,3,0.25,5,0.8,1,1.0,5.1,7,4,3,0.571,9,0.778,1,0.875,4.0,2022-23,Playoffs
1629611,Terance Mann,1610612746,LAC,5,1,4,133.0,7,2,5,0.286,15,0.467,1,0.5,11.5,9,2,7,0.222,18,0.5,2,0.563,6.1,16,4,12,0.25,32,0.5,3,0.552,8.4,2022-23,Playoffs
1629056,Terence Davis,1610612758,SAC,3,1,2,56.0,2,0,2,0.0,3,0.667,0,0.667,20.7,7,1,6,0.143,15,0.467,1,0.5,6.7,9,1,8,0.111,18,0.5,1,0.529,9.8,2022-23,Playoffs
203082,Terrence Ross,1610612756,PHX,5,1,4,55.0,0,0,0,0.0,1,0.0,0,0.0,0.0,8,1,7,0.125,8,1.0,0,1.0,7.9,8,1,7,0.125,9,0.889,0,0.889,7.9,2022-23,Playoffs
202699,Tobias Harris,1610612755,PHI,11,7,4,392.0,17,11,6,0.647,35,0.486,0,0.486,9.7,63,15,48,0.238,96,0.656,5,0.692,5.0,80,26,54,0.325,128,0.625,5,0.65,6.0,2022-23,Playoffs
1628470,Torrey Craig,1610612756,PHX,8,5,3,166.0,7,5,2,0.714,21,0.333,1,0.35,5.9,18,1,17,0.056,31,0.581,1,0.6,5.9,25,6,19,0.24,49,0.51,2,0.532,5.9,2022-23,Playoffs
1629027,Trae Young,1610612737,ATL,6,2,4,230.0,5,2,3,0.4,18,0.278,2,0.313,6.8,17,2,15,0.118,27,0.63,1,0.654,11.3,22,4,18,0.182,45,0.489,3,0.524,10.2,2022-23,Playoffs
1626168,Trey Lyles,1610612758,SAC,7,3,4,118.0,9,7,2,0.778,19,0.474,1,0.5,5.5,31,7,24,0.226,40,0.775,3,0.838,5.5,40,14,26,0.35,53,0.755,4,0.816,5.5,2022-23,Playoffs
202684,Tristan Thompson,1610612747,LAL,4,2,2,31.0,4,4,0,1.0,9,0.444,0,0.444,2.9,6,1,5,0.167,11,0.545,1,0.6,5.8,10,5,5,0.5,20,0.5,1,0.526,4.7,2022-23,Playoffs
1628972,Troy Brown Jr.,1610612747,LAL,9,6,3,101.0,4,0,4,0.0,9,0.444,0,0.444,12.7,20,2,18,0.1,33,0.606,4,0.69,5.9,24,2,22,0.083,40,0.6,4,0.667,7.0,2022-23,Playoffs
1629639,Tyler Herro,1610612748,MIA,1,1,0,19.0,0,0,0,0.0,0,0.0,0,0.0,0.0,2,0,2,0.0,5,0.4,1,0.5,8.9,2,0,2,0.0,5,0.4,1,0.5,8.9,2022-23,Playoffs
1630178,Tyrese Maxey,1610612755,PHI,11,7,4,423.0,9,4,4,0.444,24,0.375,1,0.391,6.8,44,2,42,0.045,69,0.638,5,0.688,9.8,53,6,46,0.113,93,0.57,6,0.609,9.3,2022-23,Playoffs
1626145,Tyus Jones,1610612763,MEM,6,2,4,120.0,3,0,3,0.0,4,0.75,0,0.75,17.9,15,2,13,0.133,24,0.625,1,0.652,9.5,18,2,16,0.111,27,0.667,1,0.692,10.9,2022-23,Playoffs
2617,Udonis Haslem,1610612748,MIA,1,1,0,2.0,0,0,0,0.0,0,0.0,0,0.0,0.0,1,1,0,1.0,1,1.0,0,1.0,4.5,1,1,0,1.0,1,1.0,0,1.0,4.5,2022-23,Playoffs
203506,Victor Oladipo,1610612748,MIA,2,1,1,45.0,1,0,1,0.0,1,1.0,0,1.0,23.1,6,0,6,0.0,11,0.545,1,0.6,6.3,7,0,7,0.0,12,0.583,1,0.636,8.7,2022-23,Playoffs
1628427,Vlatko Cancar,1610612743,DEN,3,3,0,7.0,0,0,0,0.0,0,0.0,0,0.0,0.0,3,2,1,0.667,4,0.75,0,0.75,4.3,3,2,1,0.667,4,0.75,0,0.75,4.3,2022-23,Playoffs
1629117,Wenyen Gabriel,1610612747,LAL,4,2,2,25.0,8,6,2,0.75,16,0.5,1,0.533,11.8,1,2,0,2.0,2,0.5,0,0.5,0.4,9,8,2,0.889,18,0.5,1,0.529,11.9,2022-23,Playoffs
202083,Wesley Matthews,1610612749,MIL,1,0,1,18.0,1,0,1,0.0,1,1.0,0,1.0,11.6,2,0,2,0.0,2,1.0,0,1.0,14.7,3,0,3,0.0,3,1.0,0,1.0,13.7,2022-23,Playoffs
1630214,Xavier Tillman,1610612763,MEM,6,2,4,183.0,17,12,5,0.706,43,0.395,2,0.415,4.2,31,7,24,0.226,58,0.534,5,0.585,6.6,48,19,29,0.396,97,0.495,7,0.533,5.7,2022-23,Playoffs
1629139,Yuta Watanabe,1610612751,BKN,1,0,1,5.0,0,0,0,0.0,0,0.0,0,0.0,0.0,1,0,1,0.0,1,1.0,0,1.0,9.2,1,0,1,0.0,1,1.0,0,1.0,9.2,2022-23,Playoffs
1630192,Zeke Nnaji,1610612743,DEN,2,2,0,6.0,0,0,0,0.0,1,0.0,0,0.0,0.0,2,0,2,0.0,2,1.0,0,1.0,4.6,2,0,2,0.0,2,1.0,0,1.0,4.6,2022-23,Playoffs
1630533,Ziaire Williams,1610612763,MEM,1,0,1,10.0,0,0,0,0.0,0,0.0,0,0.0,0.0,2,0,2,0.0,2,1.0,0,1.0,2.6,2,0,2,0.0,2,1.0,0,1.0,2.6,2022-23,Playoffs
